"Serial"	"Date"	"Day"	"Time"	"Winning"	"One"	"Two"	"Three"	"WinningSum"
15752	2019-02-15	"Fri"	"Midday"	"958"	9	5	8	22
15751	2019-02-14	"Thu"	"Evening"	"357"	3	5	7	15
15750	2019-02-14	"Thu"	"Midday"	"766"	7	6	6	19
15749	2019-02-13	"Wed"	"Evening"	"551"	5	5	1	11
15748	2019-02-13	"Wed"	"Midday"	"067"	0	6	7	13
15747	2019-02-12	"Tue"	"Evening"	"962"	9	6	2	17
15746	2019-02-12	"Tue"	"Midday"	"359"	3	5	9	17
15745	2019-02-11	"Mon"	"Evening"	"547"	5	4	7	16
15744	2019-02-11	"Mon"	"Midday"	"870"	8	7	0	15
15743	2019-02-10	"Sun"	"Evening"	"537"	5	3	7	15
15742	2019-02-10	"Sun"	"Midday"	"278"	2	7	8	17
15741	2019-02-09	"Sat"	"Evening"	"448"	4	4	8	16
15740	2019-02-09	"Sat"	"Midday"	"348"	3	4	8	15
15739	2019-02-08	"Fri"	"Evening"	"299"	2	9	9	20
15738	2019-02-08	"Fri"	"Midday"	"489"	4	8	9	21
15737	2019-02-07	"Thu"	"Evening"	"250"	2	5	0	7
15736	2019-02-07	"Thu"	"Midday"	"369"	3	6	9	18
15735	2019-02-06	"Wed"	"Evening"	"094"	0	9	4	13
15734	2019-02-06	"Wed"	"Midday"	"962"	9	6	2	17
15733	2019-02-05	"Tue"	"Evening"	"299"	2	9	9	20
15732	2019-02-05	"Tue"	"Midday"	"998"	9	9	8	26
15731	2019-02-04	"Mon"	"Evening"	"144"	1	4	4	9
15730	2019-02-04	"Mon"	"Midday"	"442"	4	4	2	10
15729	2019-02-03	"Sun"	"Evening"	"132"	1	3	2	6
15728	2019-02-03	"Sun"	"Midday"	"770"	7	7	0	14
15727	2019-02-02	"Sat"	"Evening"	"779"	7	7	9	23
15726	2019-02-02	"Sat"	"Midday"	"189"	1	8	9	18
15725	2019-02-01	"Fri"	"Evening"	"361"	3	6	1	10
15724	2019-02-01	"Fri"	"Midday"	"372"	3	7	2	12
15723	2019-01-31	"Thu"	"Evening"	"046"	0	4	6	10
15722	2019-01-31	"Thu"	"Midday"	"716"	7	1	6	14
15721	2019-01-30	"Wed"	"Evening"	"768"	7	6	8	21
15720	2019-01-30	"Wed"	"Midday"	"504"	5	0	4	9
15719	2019-01-29	"Tue"	"Evening"	"462"	4	6	2	12
15718	2019-01-29	"Tue"	"Midday"	"345"	3	4	5	12
15717	2019-01-28	"Mon"	"Evening"	"595"	5	9	5	19
15716	2019-01-28	"Mon"	"Midday"	"561"	5	6	1	12
15715	2019-01-27	"Sun"	"Evening"	"081"	0	8	1	9
15714	2019-01-27	"Sun"	"Midday"	"024"	0	2	4	6
15713	2019-01-26	"Sat"	"Evening"	"518"	5	1	8	14
15712	2019-01-26	"Sat"	"Midday"	"222"	2	2	2	6
15711	2019-01-25	"Fri"	"Evening"	"437"	4	3	7	14
15710	2019-01-25	"Fri"	"Midday"	"805"	8	0	5	13
15709	2019-01-24	"Thu"	"Evening"	"367"	3	6	7	16
15708	2019-01-24	"Thu"	"Midday"	"342"	3	4	2	9
15707	2019-01-23	"Wed"	"Evening"	"490"	4	9	0	13
15706	2019-01-23	"Wed"	"Midday"	"527"	5	2	7	14
15705	2019-01-22	"Tue"	"Evening"	"464"	4	6	4	14
15704	2019-01-22	"Tue"	"Midday"	"654"	6	5	4	15
15703	2019-01-21	"Mon"	"Evening"	"716"	7	1	6	14
15702	2019-01-21	"Mon"	"Midday"	"727"	7	2	7	16
15701	2019-01-20	"Sun"	"Evening"	"585"	5	8	5	18
15700	2019-01-20	"Sun"	"Midday"	"202"	2	0	2	4
15699	2019-01-19	"Sat"	"Evening"	"820"	8	2	0	10
15698	2019-01-19	"Sat"	"Midday"	"220"	2	2	0	4
15697	2019-01-18	"Fri"	"Evening"	"687"	6	8	7	21
15696	2019-01-18	"Fri"	"Midday"	"048"	0	4	8	12
15695	2019-01-17	"Thu"	"Evening"	"807"	8	0	7	15
15694	2019-01-17	"Thu"	"Midday"	"846"	8	4	6	18
15693	2019-01-16	"Wed"	"Evening"	"603"	6	0	3	9
15692	2019-01-16	"Wed"	"Midday"	"759"	7	5	9	21
15691	2019-01-15	"Tue"	"Evening"	"531"	5	3	1	9
15690	2019-01-15	"Tue"	"Midday"	"445"	4	4	5	13
15689	2019-01-14	"Mon"	"Evening"	"889"	8	8	9	25
15688	2019-01-14	"Mon"	"Midday"	"705"	7	0	5	12
15687	2019-01-13	"Sun"	"Evening"	"972"	9	7	2	18
15686	2019-01-13	"Sun"	"Midday"	"604"	6	0	4	10
15685	2019-01-12	"Sat"	"Evening"	"112"	1	1	2	4
15684	2019-01-12	"Sat"	"Midday"	"445"	4	4	5	13
15683	2019-01-11	"Fri"	"Evening"	"287"	2	8	7	17
15682	2019-01-11	"Fri"	"Midday"	"949"	9	4	9	22
15681	2019-01-10	"Thu"	"Evening"	"597"	5	9	7	21
15680	2019-01-10	"Thu"	"Midday"	"930"	9	3	0	12
15679	2019-01-09	"Wed"	"Evening"	"450"	4	5	0	9
15678	2019-01-09	"Wed"	"Midday"	"643"	6	4	3	13
15677	2019-01-08	"Tue"	"Evening"	"590"	5	9	0	14
15676	2019-01-08	"Tue"	"Midday"	"648"	6	4	8	18
15675	2019-01-07	"Mon"	"Evening"	"686"	6	8	6	20
15674	2019-01-07	"Mon"	"Midday"	"295"	2	9	5	16
15673	2019-01-06	"Sun"	"Evening"	"087"	0	8	7	15
15672	2019-01-06	"Sun"	"Midday"	"582"	5	8	2	15
15671	2019-01-05	"Sat"	"Evening"	"013"	0	1	3	4
15670	2019-01-05	"Sat"	"Midday"	"659"	6	5	9	20
15669	2019-01-04	"Fri"	"Evening"	"231"	2	3	1	6
15668	2019-01-04	"Fri"	"Midday"	"259"	2	5	9	16
15667	2019-01-03	"Thu"	"Evening"	"477"	4	7	7	18
15666	2019-01-03	"Thu"	"Midday"	"727"	7	2	7	16
15665	2019-01-02	"Wed"	"Evening"	"492"	4	9	2	15
15664	2019-01-02	"Wed"	"Midday"	"610"	6	1	0	7
15663	2019-01-01	"Tue"	"Evening"	"983"	9	8	3	20
15662	2019-01-01	"Tue"	"Midday"	"931"	9	3	1	13
15661	2018-12-31	"Mon"	"Evening"	"938"	9	3	8	20
15660	2018-12-31	"Mon"	"Midday"	"947"	9	4	7	20
15659	2018-12-30	"Sun"	"Evening"	"601"	6	0	1	7
15658	2018-12-30	"Sun"	"Midday"	"534"	5	3	4	12
15657	2018-12-29	"Sat"	"Evening"	"004"	0	0	4	4
15656	2018-12-29	"Sat"	"Midday"	"764"	7	6	4	17
15655	2018-12-28	"Fri"	"Evening"	"077"	0	7	7	14
15654	2018-12-28	"Fri"	"Midday"	"817"	8	1	7	16
15653	2018-12-27	"Thu"	"Evening"	"108"	1	0	8	9
15652	2018-12-27	"Thu"	"Midday"	"772"	7	7	2	16
15651	2018-12-26	"Wed"	"Evening"	"970"	9	7	0	16
15650	2018-12-26	"Wed"	"Midday"	"466"	4	6	6	16
15649	2018-12-25	"Tue"	"Evening"	"851"	8	5	1	14
15648	2018-12-25	"Tue"	"Midday"	"298"	2	9	8	19
15647	2018-12-24	"Mon"	"Evening"	"346"	3	4	6	13
15646	2018-12-24	"Mon"	"Midday"	"807"	8	0	7	15
15645	2018-12-23	"Sun"	"Evening"	"746"	7	4	6	17
15644	2018-12-23	"Sun"	"Midday"	"975"	9	7	5	21
15643	2018-12-22	"Sat"	"Evening"	"547"	5	4	7	16
15642	2018-12-22	"Sat"	"Midday"	"273"	2	7	3	12
15641	2018-12-21	"Fri"	"Evening"	"601"	6	0	1	7
15640	2018-12-21	"Fri"	"Midday"	"808"	8	0	8	16
15639	2018-12-20	"Thu"	"Evening"	"734"	7	3	4	14
15638	2018-12-20	"Thu"	"Midday"	"170"	1	7	0	8
15637	2018-12-19	"Wed"	"Evening"	"087"	0	8	7	15
15636	2018-12-19	"Wed"	"Midday"	"953"	9	5	3	17
15635	2018-12-18	"Tue"	"Evening"	"153"	1	5	3	9
15634	2018-12-18	"Tue"	"Midday"	"765"	7	6	5	18
15633	2018-12-17	"Mon"	"Evening"	"937"	9	3	7	19
15632	2018-12-17	"Mon"	"Midday"	"332"	3	3	2	8
15631	2018-12-16	"Sun"	"Evening"	"029"	0	2	9	11
15630	2018-12-16	"Sun"	"Midday"	"256"	2	5	6	13
15629	2018-12-15	"Sat"	"Evening"	"348"	3	4	8	15
15628	2018-12-15	"Sat"	"Midday"	"430"	4	3	0	7
15627	2018-12-14	"Fri"	"Evening"	"472"	4	7	2	13
15626	2018-12-14	"Fri"	"Midday"	"847"	8	4	7	19
15625	2018-12-13	"Thu"	"Evening"	"131"	1	3	1	5
15624	2018-12-13	"Thu"	"Midday"	"943"	9	4	3	16
15623	2018-12-12	"Wed"	"Evening"	"498"	4	9	8	21
15622	2018-12-12	"Wed"	"Midday"	"083"	0	8	3	11
15621	2018-12-11	"Tue"	"Evening"	"709"	7	0	9	16
15620	2018-12-11	"Tue"	"Midday"	"808"	8	0	8	16
15619	2018-12-10	"Mon"	"Evening"	"164"	1	6	4	11
15618	2018-12-10	"Mon"	"Midday"	"966"	9	6	6	21
15617	2018-12-09	"Sun"	"Evening"	"306"	3	0	6	9
15616	2018-12-09	"Sun"	"Midday"	"093"	0	9	3	12
15615	2018-12-08	"Sat"	"Evening"	"831"	8	3	1	12
15614	2018-12-08	"Sat"	"Midday"	"852"	8	5	2	15
15613	2018-12-07	"Fri"	"Evening"	"746"	7	4	6	17
15612	2018-12-07	"Fri"	"Midday"	"934"	9	3	4	16
15611	2018-12-06	"Thu"	"Evening"	"803"	8	0	3	11
15610	2018-12-06	"Thu"	"Midday"	"502"	5	0	2	7
15609	2018-12-05	"Wed"	"Evening"	"797"	7	9	7	23
15608	2018-12-05	"Wed"	"Midday"	"645"	6	4	5	15
15607	2018-12-04	"Tue"	"Evening"	"181"	1	8	1	10
15606	2018-12-04	"Tue"	"Midday"	"810"	8	1	0	9
15605	2018-12-03	"Mon"	"Evening"	"331"	3	3	1	7
15604	2018-12-03	"Mon"	"Midday"	"234"	2	3	4	9
15603	2018-12-02	"Sun"	"Evening"	"846"	8	4	6	18
15602	2018-12-02	"Sun"	"Midday"	"575"	5	7	5	17
15601	2018-12-01	"Sat"	"Evening"	"169"	1	6	9	16
15600	2018-12-01	"Sat"	"Midday"	"996"	9	9	6	24
15599	2018-11-30	"Fri"	"Evening"	"926"	9	2	6	17
15598	2018-11-30	"Fri"	"Midday"	"642"	6	4	2	12
15597	2018-11-29	"Thu"	"Evening"	"474"	4	7	4	15
15596	2018-11-29	"Thu"	"Midday"	"785"	7	8	5	20
15595	2018-11-28	"Wed"	"Evening"	"861"	8	6	1	15
15594	2018-11-28	"Wed"	"Midday"	"955"	9	5	5	19
15593	2018-11-27	"Tue"	"Evening"	"184"	1	8	4	13
15592	2018-11-27	"Tue"	"Midday"	"502"	5	0	2	7
15591	2018-11-26	"Mon"	"Evening"	"748"	7	4	8	19
15590	2018-11-26	"Mon"	"Midday"	"226"	2	2	6	10
15589	2018-11-25	"Sun"	"Evening"	"734"	7	3	4	14
15588	2018-11-25	"Sun"	"Midday"	"369"	3	6	9	18
15587	2018-11-24	"Sat"	"Evening"	"206"	2	0	6	8
15586	2018-11-24	"Sat"	"Midday"	"138"	1	3	8	12
15585	2018-11-23	"Fri"	"Evening"	"044"	0	4	4	8
15584	2018-11-23	"Fri"	"Midday"	"328"	3	2	8	13
15583	2018-11-22	"Thu"	"Evening"	"157"	1	5	7	13
15582	2018-11-22	"Thu"	"Midday"	"639"	6	3	9	18
15581	2018-11-21	"Wed"	"Evening"	"593"	5	9	3	17
15580	2018-11-21	"Wed"	"Midday"	"603"	6	0	3	9
15579	2018-11-20	"Tue"	"Evening"	"783"	7	8	3	18
15578	2018-11-20	"Tue"	"Midday"	"844"	8	4	4	16
15577	2018-11-19	"Mon"	"Evening"	"033"	0	3	3	6
15576	2018-11-19	"Mon"	"Midday"	"353"	3	5	3	11
15575	2018-11-18	"Sun"	"Evening"	"967"	9	6	7	22
15574	2018-11-18	"Sun"	"Midday"	"787"	7	8	7	22
15573	2018-11-17	"Sat"	"Evening"	"369"	3	6	9	18
15572	2018-11-17	"Sat"	"Midday"	"467"	4	6	7	17
15571	2018-11-16	"Fri"	"Evening"	"909"	9	0	9	18
15570	2018-11-16	"Fri"	"Midday"	"546"	5	4	6	15
15569	2018-11-15	"Thu"	"Evening"	"020"	0	2	0	2
15568	2018-11-15	"Thu"	"Midday"	"944"	9	4	4	17
15567	2018-11-14	"Wed"	"Evening"	"288"	2	8	8	18
15566	2018-11-14	"Wed"	"Midday"	"908"	9	0	8	17
15565	2018-11-13	"Tue"	"Evening"	"771"	7	7	1	15
15564	2018-11-13	"Tue"	"Midday"	"985"	9	8	5	22
15563	2018-11-12	"Mon"	"Evening"	"853"	8	5	3	16
15562	2018-11-12	"Mon"	"Midday"	"977"	9	7	7	23
15561	2018-11-11	"Sun"	"Evening"	"213"	2	1	3	6
15560	2018-11-11	"Sun"	"Midday"	"653"	6	5	3	14
15559	2018-11-10	"Sat"	"Evening"	"994"	9	9	4	22
15558	2018-11-10	"Sat"	"Midday"	"917"	9	1	7	17
15557	2018-11-09	"Fri"	"Evening"	"594"	5	9	4	18
15556	2018-11-09	"Fri"	"Midday"	"909"	9	0	9	18
15555	2018-11-08	"Thu"	"Evening"	"781"	7	8	1	16
15554	2018-11-08	"Thu"	"Midday"	"265"	2	6	5	13
15553	2018-11-07	"Wed"	"Evening"	"038"	0	3	8	11
15552	2018-11-07	"Wed"	"Midday"	"029"	0	2	9	11
15551	2018-11-06	"Tue"	"Evening"	"617"	6	1	7	14
15550	2018-11-06	"Tue"	"Midday"	"581"	5	8	1	14
15549	2018-11-05	"Mon"	"Evening"	"313"	3	1	3	7
15548	2018-11-05	"Mon"	"Midday"	"170"	1	7	0	8
15547	2018-11-04	"Sun"	"Evening"	"125"	1	2	5	8
15546	2018-11-04	"Sun"	"Midday"	"818"	8	1	8	17
15545	2018-11-03	"Sat"	"Evening"	"043"	0	4	3	7
15544	2018-11-03	"Sat"	"Midday"	"166"	1	6	6	13
15543	2018-11-02	"Fri"	"Evening"	"248"	2	4	8	14
15542	2018-11-02	"Fri"	"Midday"	"613"	6	1	3	10
15541	2018-11-01	"Thu"	"Evening"	"040"	0	4	0	4
15540	2018-11-01	"Thu"	"Midday"	"803"	8	0	3	11
15539	2018-10-31	"Wed"	"Evening"	"430"	4	3	0	7
15538	2018-10-31	"Wed"	"Midday"	"042"	0	4	2	6
15537	2018-10-30	"Tue"	"Evening"	"003"	0	0	3	3
15536	2018-10-30	"Tue"	"Midday"	"428"	4	2	8	14
15535	2018-10-29	"Mon"	"Evening"	"377"	3	7	7	17
15534	2018-10-29	"Mon"	"Midday"	"840"	8	4	0	12
15533	2018-10-28	"Sun"	"Evening"	"437"	4	3	7	14
15532	2018-10-28	"Sun"	"Midday"	"899"	8	9	9	26
15531	2018-10-27	"Sat"	"Evening"	"098"	0	9	8	17
15530	2018-10-27	"Sat"	"Midday"	"615"	6	1	5	12
15529	2018-10-26	"Fri"	"Evening"	"596"	5	9	6	20
15528	2018-10-26	"Fri"	"Midday"	"818"	8	1	8	17
15527	2018-10-25	"Thu"	"Evening"	"817"	8	1	7	16
15526	2018-10-25	"Thu"	"Midday"	"286"	2	8	6	16
15525	2018-10-24	"Wed"	"Evening"	"152"	1	5	2	8
15524	2018-10-24	"Wed"	"Midday"	"946"	9	4	6	19
15523	2018-10-23	"Tue"	"Evening"	"917"	9	1	7	17
15522	2018-10-23	"Tue"	"Midday"	"067"	0	6	7	13
15521	2018-10-22	"Mon"	"Evening"	"304"	3	0	4	7
15520	2018-10-22	"Mon"	"Midday"	"922"	9	2	2	13
15519	2018-10-21	"Sun"	"Evening"	"397"	3	9	7	19
15518	2018-10-21	"Sun"	"Midday"	"231"	2	3	1	6
15517	2018-10-20	"Sat"	"Evening"	"243"	2	4	3	9
15516	2018-10-20	"Sat"	"Midday"	"653"	6	5	3	14
15515	2018-10-19	"Fri"	"Evening"	"561"	5	6	1	12
15514	2018-10-19	"Fri"	"Midday"	"313"	3	1	3	7
15513	2018-10-18	"Thu"	"Evening"	"429"	4	2	9	15
15512	2018-10-18	"Thu"	"Midday"	"231"	2	3	1	6
15511	2018-10-17	"Wed"	"Evening"	"580"	5	8	0	13
15510	2018-10-17	"Wed"	"Midday"	"203"	2	0	3	5
15509	2018-10-16	"Tue"	"Evening"	"972"	9	7	2	18
15508	2018-10-16	"Tue"	"Midday"	"352"	3	5	2	10
15507	2018-10-15	"Mon"	"Evening"	"348"	3	4	8	15
15506	2018-10-15	"Mon"	"Midday"	"489"	4	8	9	21
15505	2018-10-14	"Sun"	"Evening"	"457"	4	5	7	16
15504	2018-10-14	"Sun"	"Midday"	"587"	5	8	7	20
15503	2018-10-13	"Sat"	"Evening"	"118"	1	1	8	10
15502	2018-10-13	"Sat"	"Midday"	"758"	7	5	8	20
15501	2018-10-12	"Fri"	"Evening"	"864"	8	6	4	18
15500	2018-10-12	"Fri"	"Midday"	"652"	6	5	2	13
15499	2018-10-11	"Thu"	"Evening"	"163"	1	6	3	10
15498	2018-10-11	"Thu"	"Midday"	"536"	5	3	6	14
15497	2018-10-10	"Wed"	"Evening"	"534"	5	3	4	12
15496	2018-10-10	"Wed"	"Midday"	"819"	8	1	9	18
15495	2018-10-09	"Tue"	"Evening"	"711"	7	1	1	9
15494	2018-10-09	"Tue"	"Midday"	"105"	1	0	5	6
15493	2018-10-08	"Mon"	"Evening"	"836"	8	3	6	17
15492	2018-10-08	"Mon"	"Midday"	"078"	0	7	8	15
15491	2018-10-07	"Sun"	"Evening"	"093"	0	9	3	12
15490	2018-10-07	"Sun"	"Midday"	"122"	1	2	2	5
15489	2018-10-06	"Sat"	"Evening"	"446"	4	4	6	14
15488	2018-10-06	"Sat"	"Midday"	"732"	7	3	2	12
15487	2018-10-05	"Fri"	"Evening"	"251"	2	5	1	8
15486	2018-10-05	"Fri"	"Midday"	"955"	9	5	5	19
15485	2018-10-04	"Thu"	"Evening"	"887"	8	8	7	23
15484	2018-10-04	"Thu"	"Midday"	"944"	9	4	4	17
15483	2018-10-03	"Wed"	"Evening"	"098"	0	9	8	17
15482	2018-10-03	"Wed"	"Midday"	"728"	7	2	8	17
15481	2018-10-02	"Tue"	"Evening"	"434"	4	3	4	11
15480	2018-10-02	"Tue"	"Midday"	"871"	8	7	1	16
15479	2018-10-01	"Mon"	"Evening"	"116"	1	1	6	8
15478	2018-10-01	"Mon"	"Midday"	"263"	2	6	3	11
15477	2018-09-30	"Sun"	"Evening"	"841"	8	4	1	13
15476	2018-09-30	"Sun"	"Midday"	"696"	6	9	6	21
15475	2018-09-29	"Sat"	"Evening"	"642"	6	4	2	12
15474	2018-09-29	"Sat"	"Midday"	"806"	8	0	6	14
15473	2018-09-28	"Fri"	"Evening"	"223"	2	2	3	7
15472	2018-09-28	"Fri"	"Midday"	"850"	8	5	0	13
15471	2018-09-27	"Thu"	"Evening"	"313"	3	1	3	7
15470	2018-09-27	"Thu"	"Midday"	"106"	1	0	6	7
15469	2018-09-26	"Wed"	"Evening"	"884"	8	8	4	20
15468	2018-09-26	"Wed"	"Midday"	"655"	6	5	5	16
15467	2018-09-25	"Tue"	"Evening"	"942"	9	4	2	15
15466	2018-09-25	"Tue"	"Midday"	"202"	2	0	2	4
15465	2018-09-24	"Mon"	"Evening"	"487"	4	8	7	19
15464	2018-09-24	"Mon"	"Midday"	"251"	2	5	1	8
15463	2018-09-23	"Sun"	"Evening"	"422"	4	2	2	8
15462	2018-09-23	"Sun"	"Midday"	"950"	9	5	0	14
15461	2018-09-22	"Sat"	"Evening"	"389"	3	8	9	20
15460	2018-09-22	"Sat"	"Midday"	"071"	0	7	1	8
15459	2018-09-21	"Fri"	"Evening"	"197"	1	9	7	17
15458	2018-09-21	"Fri"	"Midday"	"436"	4	3	6	13
15457	2018-09-20	"Thu"	"Evening"	"508"	5	0	8	13
15456	2018-09-20	"Thu"	"Midday"	"210"	2	1	0	3
15455	2018-09-19	"Wed"	"Evening"	"363"	3	6	3	12
15454	2018-09-19	"Wed"	"Midday"	"429"	4	2	9	15
15453	2018-09-18	"Tue"	"Evening"	"565"	5	6	5	16
15452	2018-09-18	"Tue"	"Midday"	"981"	9	8	1	18
15451	2018-09-17	"Mon"	"Evening"	"553"	5	5	3	13
15450	2018-09-17	"Mon"	"Midday"	"181"	1	8	1	10
15449	2018-09-16	"Sun"	"Evening"	"803"	8	0	3	11
15448	2018-09-16	"Sun"	"Midday"	"283"	2	8	3	13
15447	2018-09-15	"Sat"	"Evening"	"784"	7	8	4	19
15446	2018-09-15	"Sat"	"Midday"	"554"	5	5	4	14
15445	2018-09-14	"Fri"	"Evening"	"400"	4	0	0	4
15444	2018-09-14	"Fri"	"Midday"	"565"	5	6	5	16
15443	2018-09-13	"Thu"	"Evening"	"010"	0	1	0	1
15442	2018-09-13	"Thu"	"Midday"	"207"	2	0	7	9
15441	2018-09-12	"Wed"	"Evening"	"451"	4	5	1	10
15440	2018-09-12	"Wed"	"Midday"	"221"	2	2	1	5
15439	2018-09-11	"Tue"	"Evening"	"493"	4	9	3	16
15438	2018-09-11	"Tue"	"Midday"	"511"	5	1	1	7
15437	2018-09-10	"Mon"	"Evening"	"824"	8	2	4	14
15436	2018-09-10	"Mon"	"Midday"	"249"	2	4	9	15
15435	2018-09-09	"Sun"	"Evening"	"514"	5	1	4	10
15434	2018-09-09	"Sun"	"Midday"	"521"	5	2	1	8
15433	2018-09-08	"Sat"	"Evening"	"205"	2	0	5	7
15432	2018-09-08	"Sat"	"Midday"	"046"	0	4	6	10
15431	2018-09-07	"Fri"	"Evening"	"287"	2	8	7	17
15430	2018-09-07	"Fri"	"Midday"	"028"	0	2	8	10
15429	2018-09-06	"Thu"	"Evening"	"811"	8	1	1	10
15428	2018-09-06	"Thu"	"Midday"	"153"	1	5	3	9
15427	2018-09-05	"Wed"	"Evening"	"514"	5	1	4	10
15426	2018-09-05	"Wed"	"Midday"	"025"	0	2	5	7
15425	2018-09-04	"Tue"	"Evening"	"640"	6	4	0	10
15424	2018-09-04	"Tue"	"Midday"	"780"	7	8	0	15
15423	2018-09-03	"Mon"	"Evening"	"047"	0	4	7	11
15422	2018-09-03	"Mon"	"Midday"	"188"	1	8	8	17
15421	2018-09-02	"Sun"	"Evening"	"931"	9	3	1	13
15420	2018-09-02	"Sun"	"Midday"	"880"	8	8	0	16
15419	2018-09-01	"Sat"	"Evening"	"047"	0	4	7	11
15418	2018-09-01	"Sat"	"Midday"	"619"	6	1	9	16
15417	2018-08-31	"Fri"	"Evening"	"411"	4	1	1	6
15416	2018-08-31	"Fri"	"Midday"	"257"	2	5	7	14
15415	2018-08-30	"Thu"	"Evening"	"552"	5	5	2	12
15414	2018-08-30	"Thu"	"Midday"	"235"	2	3	5	10
15413	2018-08-29	"Wed"	"Evening"	"539"	5	3	9	17
15412	2018-08-29	"Wed"	"Midday"	"899"	8	9	9	26
15411	2018-08-28	"Tue"	"Evening"	"854"	8	5	4	17
15410	2018-08-28	"Tue"	"Midday"	"774"	7	7	4	18
15409	2018-08-27	"Mon"	"Evening"	"492"	4	9	2	15
15408	2018-08-27	"Mon"	"Midday"	"086"	0	8	6	14
15407	2018-08-26	"Sun"	"Evening"	"141"	1	4	1	6
15406	2018-08-26	"Sun"	"Midday"	"916"	9	1	6	16
15405	2018-08-25	"Sat"	"Evening"	"245"	2	4	5	11
15404	2018-08-25	"Sat"	"Midday"	"348"	3	4	8	15
15403	2018-08-24	"Fri"	"Evening"	"556"	5	5	6	16
15402	2018-08-24	"Fri"	"Midday"	"238"	2	3	8	13
15401	2018-08-23	"Thu"	"Evening"	"923"	9	2	3	14
15400	2018-08-23	"Thu"	"Midday"	"000"	0	0	0	0
15399	2018-08-22	"Wed"	"Evening"	"370"	3	7	0	10
15398	2018-08-22	"Wed"	"Midday"	"060"	0	6	0	6
15397	2018-08-21	"Tue"	"Evening"	"557"	5	5	7	17
15396	2018-08-21	"Tue"	"Midday"	"464"	4	6	4	14
15395	2018-08-20	"Mon"	"Evening"	"206"	2	0	6	8
15394	2018-08-20	"Mon"	"Midday"	"223"	2	2	3	7
15393	2018-08-19	"Sun"	"Evening"	"948"	9	4	8	21
15392	2018-08-19	"Sun"	"Midday"	"972"	9	7	2	18
15391	2018-08-18	"Sat"	"Evening"	"694"	6	9	4	19
15390	2018-08-18	"Sat"	"Midday"	"024"	0	2	4	6
15389	2018-08-17	"Fri"	"Evening"	"006"	0	0	6	6
15388	2018-08-17	"Fri"	"Midday"	"310"	3	1	0	4
15387	2018-08-16	"Thu"	"Evening"	"109"	1	0	9	10
15386	2018-08-16	"Thu"	"Midday"	"073"	0	7	3	10
15385	2018-08-15	"Wed"	"Evening"	"994"	9	9	4	22
15384	2018-08-15	"Wed"	"Midday"	"468"	4	6	8	18
15383	2018-08-14	"Tue"	"Evening"	"318"	3	1	8	12
15382	2018-08-14	"Tue"	"Midday"	"109"	1	0	9	10
15381	2018-08-13	"Mon"	"Evening"	"116"	1	1	6	8
15380	2018-08-13	"Mon"	"Midday"	"639"	6	3	9	18
15379	2018-08-12	"Sun"	"Evening"	"205"	2	0	5	7
15378	2018-08-12	"Sun"	"Midday"	"829"	8	2	9	19
15377	2018-08-11	"Sat"	"Evening"	"691"	6	9	1	16
15376	2018-08-11	"Sat"	"Midday"	"707"	7	0	7	14
15375	2018-08-10	"Fri"	"Evening"	"233"	2	3	3	8
15374	2018-08-10	"Fri"	"Midday"	"754"	7	5	4	16
15373	2018-08-09	"Thu"	"Evening"	"630"	6	3	0	9
15372	2018-08-09	"Thu"	"Midday"	"867"	8	6	7	21
15371	2018-08-08	"Wed"	"Evening"	"117"	1	1	7	9
15370	2018-08-08	"Wed"	"Midday"	"850"	8	5	0	13
15369	2018-08-07	"Tue"	"Evening"	"626"	6	2	6	14
15368	2018-08-07	"Tue"	"Midday"	"065"	0	6	5	11
15367	2018-08-06	"Mon"	"Evening"	"023"	0	2	3	5
15366	2018-08-06	"Mon"	"Midday"	"077"	0	7	7	14
15365	2018-08-05	"Sun"	"Evening"	"954"	9	5	4	18
15364	2018-08-05	"Sun"	"Midday"	"499"	4	9	9	22
15363	2018-08-04	"Sat"	"Evening"	"993"	9	9	3	21
15362	2018-08-04	"Sat"	"Midday"	"415"	4	1	5	10
15361	2018-08-03	"Fri"	"Evening"	"770"	7	7	0	14
15360	2018-08-03	"Fri"	"Midday"	"646"	6	4	6	16
15359	2018-08-02	"Thu"	"Evening"	"695"	6	9	5	20
15358	2018-08-02	"Thu"	"Midday"	"735"	7	3	5	15
15357	2018-08-01	"Wed"	"Evening"	"665"	6	6	5	17
15356	2018-08-01	"Wed"	"Midday"	"417"	4	1	7	12
15355	2018-07-31	"Tue"	"Evening"	"101"	1	0	1	2
15354	2018-07-31	"Tue"	"Midday"	"785"	7	8	5	20
15353	2018-07-30	"Mon"	"Evening"	"380"	3	8	0	11
15352	2018-07-30	"Mon"	"Midday"	"507"	5	0	7	12
15351	2018-07-29	"Sun"	"Evening"	"719"	7	1	9	17
15350	2018-07-29	"Sun"	"Midday"	"047"	0	4	7	11
15349	2018-07-28	"Sat"	"Evening"	"545"	5	4	5	14
15348	2018-07-28	"Sat"	"Midday"	"573"	5	7	3	15
15347	2018-07-27	"Fri"	"Evening"	"043"	0	4	3	7
15346	2018-07-27	"Fri"	"Midday"	"475"	4	7	5	16
15345	2018-07-26	"Thu"	"Evening"	"890"	8	9	0	17
15344	2018-07-26	"Thu"	"Midday"	"858"	8	5	8	21
15343	2018-07-25	"Wed"	"Evening"	"036"	0	3	6	9
15342	2018-07-25	"Wed"	"Midday"	"828"	8	2	8	18
15341	2018-07-24	"Tue"	"Evening"	"775"	7	7	5	19
15340	2018-07-24	"Tue"	"Midday"	"456"	4	5	6	15
15339	2018-07-23	"Mon"	"Evening"	"972"	9	7	2	18
15338	2018-07-23	"Mon"	"Midday"	"703"	7	0	3	10
15337	2018-07-22	"Sun"	"Evening"	"876"	8	7	6	21
15336	2018-07-22	"Sun"	"Midday"	"257"	2	5	7	14
15335	2018-07-21	"Sat"	"Evening"	"743"	7	4	3	14
15334	2018-07-21	"Sat"	"Midday"	"681"	6	8	1	15
15333	2018-07-20	"Fri"	"Evening"	"812"	8	1	2	11
15332	2018-07-20	"Fri"	"Midday"	"810"	8	1	0	9
15331	2018-07-19	"Thu"	"Evening"	"849"	8	4	9	21
15330	2018-07-19	"Thu"	"Midday"	"284"	2	8	4	14
15329	2018-07-18	"Wed"	"Evening"	"894"	8	9	4	21
15328	2018-07-18	"Wed"	"Midday"	"082"	0	8	2	10
15327	2018-07-17	"Tue"	"Evening"	"013"	0	1	3	4
15326	2018-07-17	"Tue"	"Midday"	"302"	3	0	2	5
15325	2018-07-16	"Mon"	"Evening"	"270"	2	7	0	9
15324	2018-07-16	"Mon"	"Midday"	"881"	8	8	1	17
15323	2018-07-15	"Sun"	"Evening"	"286"	2	8	6	16
15322	2018-07-15	"Sun"	"Midday"	"497"	4	9	7	20
15321	2018-07-14	"Sat"	"Evening"	"105"	1	0	5	6
15320	2018-07-14	"Sat"	"Midday"	"686"	6	8	6	20
15319	2018-07-13	"Fri"	"Evening"	"498"	4	9	8	21
15318	2018-07-13	"Fri"	"Midday"	"804"	8	0	4	12
15317	2018-07-12	"Thu"	"Evening"	"216"	2	1	6	9
15316	2018-07-12	"Thu"	"Midday"	"130"	1	3	0	4
15315	2018-07-11	"Wed"	"Evening"	"329"	3	2	9	14
15314	2018-07-11	"Wed"	"Midday"	"387"	3	8	7	18
15313	2018-07-10	"Tue"	"Evening"	"182"	1	8	2	11
15312	2018-07-10	"Tue"	"Midday"	"401"	4	0	1	5
15311	2018-07-09	"Mon"	"Evening"	"509"	5	0	9	14
15310	2018-07-09	"Mon"	"Midday"	"536"	5	3	6	14
15309	2018-07-08	"Sun"	"Evening"	"995"	9	9	5	23
15308	2018-07-08	"Sun"	"Midday"	"381"	3	8	1	12
15307	2018-07-07	"Sat"	"Evening"	"842"	8	4	2	14
15306	2018-07-07	"Sat"	"Midday"	"396"	3	9	6	18
15305	2018-07-06	"Fri"	"Evening"	"300"	3	0	0	3
15304	2018-07-06	"Fri"	"Midday"	"279"	2	7	9	18
15303	2018-07-05	"Thu"	"Evening"	"388"	3	8	8	19
15302	2018-07-05	"Thu"	"Midday"	"292"	2	9	2	13
15301	2018-07-04	"Wed"	"Evening"	"679"	6	7	9	22
15300	2018-07-04	"Wed"	"Midday"	"360"	3	6	0	9
15299	2018-07-03	"Tue"	"Evening"	"115"	1	1	5	7
15298	2018-07-03	"Tue"	"Midday"	"124"	1	2	4	7
15297	2018-07-02	"Mon"	"Evening"	"278"	2	7	8	17
15296	2018-07-02	"Mon"	"Midday"	"369"	3	6	9	18
15295	2018-07-01	"Sun"	"Evening"	"749"	7	4	9	20
15294	2018-07-01	"Sun"	"Midday"	"990"	9	9	0	18
15293	2018-06-30	"Sat"	"Evening"	"487"	4	8	7	19
15292	2018-06-30	"Sat"	"Midday"	"054"	0	5	4	9
15291	2018-06-29	"Fri"	"Evening"	"046"	0	4	6	10
15290	2018-06-29	"Fri"	"Midday"	"440"	4	4	0	8
15289	2018-06-28	"Thu"	"Evening"	"154"	1	5	4	10
15288	2018-06-28	"Thu"	"Midday"	"796"	7	9	6	22
15287	2018-06-27	"Wed"	"Evening"	"971"	9	7	1	17
15286	2018-06-27	"Wed"	"Midday"	"812"	8	1	2	11
15285	2018-06-26	"Tue"	"Evening"	"852"	8	5	2	15
15284	2018-06-26	"Tue"	"Midday"	"658"	6	5	8	19
15283	2018-06-25	"Mon"	"Evening"	"617"	6	1	7	14
15282	2018-06-25	"Mon"	"Midday"	"517"	5	1	7	13
15281	2018-06-24	"Sun"	"Evening"	"109"	1	0	9	10
15280	2018-06-24	"Sun"	"Midday"	"231"	2	3	1	6
15279	2018-06-23	"Sat"	"Evening"	"231"	2	3	1	6
15278	2018-06-23	"Sat"	"Midday"	"415"	4	1	5	10
15277	2018-06-22	"Fri"	"Evening"	"161"	1	6	1	8
15276	2018-06-22	"Fri"	"Midday"	"239"	2	3	9	14
15275	2018-06-21	"Thu"	"Evening"	"088"	0	8	8	16
15274	2018-06-21	"Thu"	"Midday"	"215"	2	1	5	8
15273	2018-06-20	"Wed"	"Evening"	"743"	7	4	3	14
15272	2018-06-20	"Wed"	"Midday"	"794"	7	9	4	20
15271	2018-06-19	"Tue"	"Evening"	"206"	2	0	6	8
15270	2018-06-19	"Tue"	"Midday"	"788"	7	8	8	23
15269	2018-06-18	"Mon"	"Evening"	"493"	4	9	3	16
15268	2018-06-18	"Mon"	"Midday"	"935"	9	3	5	17
15267	2018-06-17	"Sun"	"Evening"	"052"	0	5	2	7
15266	2018-06-17	"Sun"	"Midday"	"910"	9	1	0	10
15265	2018-06-16	"Sat"	"Evening"	"636"	6	3	6	15
15264	2018-06-16	"Sat"	"Midday"	"583"	5	8	3	16
15263	2018-06-15	"Fri"	"Evening"	"712"	7	1	2	10
15262	2018-06-15	"Fri"	"Midday"	"459"	4	5	9	18
15261	2018-06-14	"Thu"	"Evening"	"952"	9	5	2	16
15260	2018-06-14	"Thu"	"Midday"	"217"	2	1	7	10
15259	2018-06-13	"Wed"	"Evening"	"962"	9	6	2	17
15258	2018-06-13	"Wed"	"Midday"	"631"	6	3	1	10
15257	2018-06-12	"Tue"	"Evening"	"020"	0	2	0	2
15256	2018-06-12	"Tue"	"Midday"	"891"	8	9	1	18
15255	2018-06-11	"Mon"	"Evening"	"642"	6	4	2	12
15254	2018-06-11	"Mon"	"Midday"	"376"	3	7	6	16
15253	2018-06-10	"Sun"	"Evening"	"027"	0	2	7	9
15252	2018-06-10	"Sun"	"Midday"	"522"	5	2	2	9
15251	2018-06-09	"Sat"	"Evening"	"907"	9	0	7	16
15250	2018-06-09	"Sat"	"Midday"	"956"	9	5	6	20
15249	2018-06-08	"Fri"	"Evening"	"347"	3	4	7	14
15248	2018-06-08	"Fri"	"Midday"	"122"	1	2	2	5
15247	2018-06-07	"Thu"	"Evening"	"465"	4	6	5	15
15246	2018-06-07	"Thu"	"Midday"	"295"	2	9	5	16
15245	2018-06-06	"Wed"	"Evening"	"529"	5	2	9	16
15244	2018-06-06	"Wed"	"Midday"	"314"	3	1	4	8
15243	2018-06-05	"Tue"	"Evening"	"831"	8	3	1	12
15242	2018-06-05	"Tue"	"Midday"	"147"	1	4	7	12
15241	2018-06-04	"Mon"	"Evening"	"447"	4	4	7	15
15240	2018-06-04	"Mon"	"Midday"	"067"	0	6	7	13
15239	2018-06-03	"Sun"	"Evening"	"898"	8	9	8	25
15238	2018-06-03	"Sun"	"Midday"	"662"	6	6	2	14
15237	2018-06-02	"Sat"	"Evening"	"457"	4	5	7	16
15236	2018-06-02	"Sat"	"Midday"	"468"	4	6	8	18
15235	2018-06-01	"Fri"	"Evening"	"295"	2	9	5	16
15234	2018-06-01	"Fri"	"Midday"	"937"	9	3	7	19
15233	2018-05-31	"Thu"	"Evening"	"231"	2	3	1	6
15232	2018-05-31	"Thu"	"Midday"	"797"	7	9	7	23
15231	2018-05-30	"Wed"	"Evening"	"124"	1	2	4	7
15230	2018-05-30	"Wed"	"Midday"	"211"	2	1	1	4
15229	2018-05-29	"Tue"	"Evening"	"857"	8	5	7	20
15228	2018-05-29	"Tue"	"Midday"	"803"	8	0	3	11
15227	2018-05-28	"Mon"	"Evening"	"396"	3	9	6	18
15226	2018-05-28	"Mon"	"Midday"	"003"	0	0	3	3
15225	2018-05-27	"Sun"	"Evening"	"195"	1	9	5	15
15224	2018-05-27	"Sun"	"Midday"	"934"	9	3	4	16
15223	2018-05-26	"Sat"	"Evening"	"294"	2	9	4	15
15222	2018-05-26	"Sat"	"Midday"	"494"	4	9	4	17
15221	2018-05-25	"Fri"	"Evening"	"780"	7	8	0	15
15220	2018-05-25	"Fri"	"Midday"	"209"	2	0	9	11
15219	2018-05-24	"Thu"	"Evening"	"430"	4	3	0	7
15218	2018-05-24	"Thu"	"Midday"	"455"	4	5	5	14
15217	2018-05-23	"Wed"	"Evening"	"022"	0	2	2	4
15216	2018-05-23	"Wed"	"Midday"	"206"	2	0	6	8
15215	2018-05-22	"Tue"	"Evening"	"393"	3	9	3	15
15214	2018-05-22	"Tue"	"Midday"	"952"	9	5	2	16
15213	2018-05-21	"Mon"	"Evening"	"579"	5	7	9	21
15212	2018-05-21	"Mon"	"Midday"	"443"	4	4	3	11
15211	2018-05-20	"Sun"	"Evening"	"410"	4	1	0	5
15210	2018-05-20	"Sun"	"Midday"	"968"	9	6	8	23
15209	2018-05-19	"Sat"	"Evening"	"510"	5	1	0	6
15208	2018-05-19	"Sat"	"Midday"	"086"	0	8	6	14
15207	2018-05-18	"Fri"	"Evening"	"208"	2	0	8	10
15206	2018-05-18	"Fri"	"Midday"	"147"	1	4	7	12
15205	2018-05-17	"Thu"	"Evening"	"355"	3	5	5	13
15204	2018-05-17	"Thu"	"Midday"	"912"	9	1	2	12
15203	2018-05-16	"Wed"	"Evening"	"173"	1	7	3	11
15202	2018-05-16	"Wed"	"Midday"	"382"	3	8	2	13
15201	2018-05-15	"Tue"	"Evening"	"839"	8	3	9	20
15200	2018-05-15	"Tue"	"Midday"	"555"	5	5	5	15
15199	2018-05-14	"Mon"	"Evening"	"143"	1	4	3	8
15198	2018-05-14	"Mon"	"Midday"	"252"	2	5	2	9
15197	2018-05-13	"Sun"	"Evening"	"887"	8	8	7	23
15196	2018-05-13	"Sun"	"Midday"	"924"	9	2	4	15
15195	2018-05-12	"Sat"	"Evening"	"620"	6	2	0	8
15194	2018-05-12	"Sat"	"Midday"	"500"	5	0	0	5
15193	2018-05-11	"Fri"	"Evening"	"825"	8	2	5	15
15192	2018-05-11	"Fri"	"Midday"	"885"	8	8	5	21
15191	2018-05-10	"Thu"	"Evening"	"308"	3	0	8	11
15190	2018-05-10	"Thu"	"Midday"	"622"	6	2	2	10
15189	2018-05-09	"Wed"	"Evening"	"447"	4	4	7	15
15188	2018-05-09	"Wed"	"Midday"	"691"	6	9	1	16
15187	2018-05-08	"Tue"	"Evening"	"132"	1	3	2	6
15186	2018-05-08	"Tue"	"Midday"	"101"	1	0	1	2
15185	2018-05-07	"Mon"	"Evening"	"409"	4	0	9	13
15184	2018-05-07	"Mon"	"Midday"	"763"	7	6	3	16
15183	2018-05-06	"Sun"	"Evening"	"277"	2	7	7	16
15182	2018-05-06	"Sun"	"Midday"	"959"	9	5	9	23
15181	2018-05-05	"Sat"	"Evening"	"849"	8	4	9	21
15180	2018-05-05	"Sat"	"Midday"	"884"	8	8	4	20
15179	2018-05-04	"Fri"	"Evening"	"066"	0	6	6	12
15178	2018-05-04	"Fri"	"Midday"	"257"	2	5	7	14
15177	2018-05-03	"Thu"	"Evening"	"899"	8	9	9	26
15176	2018-05-03	"Thu"	"Midday"	"264"	2	6	4	12
15175	2018-05-02	"Wed"	"Evening"	"591"	5	9	1	15
15174	2018-05-02	"Wed"	"Midday"	"255"	2	5	5	12
15173	2018-05-01	"Tue"	"Evening"	"337"	3	3	7	13
15172	2018-05-01	"Tue"	"Midday"	"530"	5	3	0	8
15171	2018-04-30	"Mon"	"Evening"	"494"	4	9	4	17
15170	2018-04-30	"Mon"	"Midday"	"327"	3	2	7	12
15169	2018-04-29	"Sun"	"Evening"	"756"	7	5	6	18
15168	2018-04-29	"Sun"	"Midday"	"571"	5	7	1	13
15167	2018-04-28	"Sat"	"Evening"	"875"	8	7	5	20
15166	2018-04-28	"Sat"	"Midday"	"048"	0	4	8	12
15165	2018-04-27	"Fri"	"Evening"	"095"	0	9	5	14
15164	2018-04-27	"Fri"	"Midday"	"924"	9	2	4	15
15163	2018-04-26	"Thu"	"Evening"	"029"	0	2	9	11
15162	2018-04-26	"Thu"	"Midday"	"922"	9	2	2	13
15161	2018-04-25	"Wed"	"Evening"	"328"	3	2	8	13
15160	2018-04-25	"Wed"	"Midday"	"942"	9	4	2	15
15159	2018-04-24	"Tue"	"Evening"	"219"	2	1	9	12
15158	2018-04-24	"Tue"	"Midday"	"609"	6	0	9	15
15157	2018-04-23	"Mon"	"Evening"	"827"	8	2	7	17
15156	2018-04-23	"Mon"	"Midday"	"283"	2	8	3	13
15155	2018-04-22	"Sun"	"Evening"	"444"	4	4	4	12
15154	2018-04-22	"Sun"	"Midday"	"121"	1	2	1	4
15153	2018-04-21	"Sat"	"Evening"	"393"	3	9	3	15
15152	2018-04-21	"Sat"	"Midday"	"205"	2	0	5	7
15151	2018-04-20	"Fri"	"Evening"	"261"	2	6	1	9
15150	2018-04-20	"Fri"	"Midday"	"958"	9	5	8	22
15149	2018-04-19	"Thu"	"Evening"	"674"	6	7	4	17
15148	2018-04-19	"Thu"	"Midday"	"370"	3	7	0	10
15147	2018-04-18	"Wed"	"Evening"	"637"	6	3	7	16
15146	2018-04-18	"Wed"	"Midday"	"349"	3	4	9	16
15145	2018-04-17	"Tue"	"Evening"	"220"	2	2	0	4
15144	2018-04-17	"Tue"	"Midday"	"127"	1	2	7	10
15143	2018-04-16	"Mon"	"Evening"	"852"	8	5	2	15
15142	2018-04-16	"Mon"	"Midday"	"571"	5	7	1	13
15141	2018-04-15	"Sun"	"Evening"	"048"	0	4	8	12
15140	2018-04-15	"Sun"	"Midday"	"304"	3	0	4	7
15139	2018-04-14	"Sat"	"Evening"	"439"	4	3	9	16
15138	2018-04-14	"Sat"	"Midday"	"472"	4	7	2	13
15137	2018-04-13	"Fri"	"Evening"	"031"	0	3	1	4
15136	2018-04-13	"Fri"	"Midday"	"566"	5	6	6	17
15135	2018-04-12	"Thu"	"Evening"	"135"	1	3	5	9
15134	2018-04-12	"Thu"	"Midday"	"472"	4	7	2	13
15133	2018-04-11	"Wed"	"Evening"	"249"	2	4	9	15
15132	2018-04-11	"Wed"	"Midday"	"150"	1	5	0	6
15131	2018-04-10	"Tue"	"Evening"	"644"	6	4	4	14
15130	2018-04-10	"Tue"	"Midday"	"228"	2	2	8	12
15129	2018-04-09	"Mon"	"Evening"	"385"	3	8	5	16
15128	2018-04-09	"Mon"	"Midday"	"733"	7	3	3	13
15127	2018-04-08	"Sun"	"Evening"	"277"	2	7	7	16
15126	2018-04-08	"Sun"	"Midday"	"391"	3	9	1	13
15125	2018-04-07	"Sat"	"Evening"	"555"	5	5	5	15
15124	2018-04-07	"Sat"	"Midday"	"321"	3	2	1	6
15123	2018-04-06	"Fri"	"Evening"	"956"	9	5	6	20
15122	2018-04-06	"Fri"	"Midday"	"751"	7	5	1	13
15121	2018-04-05	"Thu"	"Evening"	"963"	9	6	3	18
15120	2018-04-05	"Thu"	"Midday"	"700"	7	0	0	7
15119	2018-04-04	"Wed"	"Evening"	"104"	1	0	4	5
15118	2018-04-04	"Wed"	"Midday"	"247"	2	4	7	13
15117	2018-04-03	"Tue"	"Evening"	"186"	1	8	6	15
15116	2018-04-03	"Tue"	"Midday"	"488"	4	8	8	20
15115	2018-04-02	"Mon"	"Evening"	"988"	9	8	8	25
15114	2018-04-02	"Mon"	"Midday"	"442"	4	4	2	10
15113	2018-04-01	"Sun"	"Evening"	"937"	9	3	7	19
15112	2018-04-01	"Sun"	"Midday"	"714"	7	1	4	12
15111	2018-03-31	"Sat"	"Evening"	"755"	7	5	5	17
15110	2018-03-31	"Sat"	"Midday"	"948"	9	4	8	21
15109	2018-03-30	"Fri"	"Evening"	"261"	2	6	1	9
15108	2018-03-30	"Fri"	"Midday"	"795"	7	9	5	21
15107	2018-03-29	"Thu"	"Evening"	"096"	0	9	6	15
15106	2018-03-29	"Thu"	"Midday"	"429"	4	2	9	15
15105	2018-03-28	"Wed"	"Evening"	"317"	3	1	7	11
15104	2018-03-28	"Wed"	"Midday"	"994"	9	9	4	22
15103	2018-03-27	"Tue"	"Evening"	"818"	8	1	8	17
15102	2018-03-27	"Tue"	"Midday"	"731"	7	3	1	11
15101	2018-03-26	"Mon"	"Evening"	"192"	1	9	2	12
15100	2018-03-26	"Mon"	"Midday"	"915"	9	1	5	15
15099	2018-03-25	"Sun"	"Evening"	"330"	3	3	0	6
15098	2018-03-25	"Sun"	"Midday"	"324"	3	2	4	9
15097	2018-03-24	"Sat"	"Evening"	"609"	6	0	9	15
15096	2018-03-24	"Sat"	"Midday"	"233"	2	3	3	8
15095	2018-03-23	"Fri"	"Evening"	"598"	5	9	8	22
15094	2018-03-23	"Fri"	"Midday"	"154"	1	5	4	10
15093	2018-03-22	"Thu"	"Evening"	"687"	6	8	7	21
15092	2018-03-22	"Thu"	"Midday"	"552"	5	5	2	12
15091	2018-03-21	"Wed"	"Evening"	"333"	3	3	3	9
15090	2018-03-21	"Wed"	"Midday"	"736"	7	3	6	16
15089	2018-03-20	"Tue"	"Evening"	"413"	4	1	3	8
15088	2018-03-20	"Tue"	"Midday"	"506"	5	0	6	11
15087	2018-03-19	"Mon"	"Evening"	"757"	7	5	7	19
15086	2018-03-19	"Mon"	"Midday"	"307"	3	0	7	10
15085	2018-03-18	"Sun"	"Evening"	"243"	2	4	3	9
15084	2018-03-18	"Sun"	"Midday"	"684"	6	8	4	18
15083	2018-03-17	"Sat"	"Evening"	"483"	4	8	3	15
15082	2018-03-17	"Sat"	"Midday"	"297"	2	9	7	18
15081	2018-03-16	"Fri"	"Evening"	"420"	4	2	0	6
15080	2018-03-16	"Fri"	"Midday"	"144"	1	4	4	9
15079	2018-03-15	"Thu"	"Evening"	"908"	9	0	8	17
15078	2018-03-15	"Thu"	"Midday"	"086"	0	8	6	14
15077	2018-03-14	"Wed"	"Evening"	"453"	4	5	3	12
15076	2018-03-14	"Wed"	"Midday"	"185"	1	8	5	14
15075	2018-03-13	"Tue"	"Evening"	"364"	3	6	4	13
15074	2018-03-13	"Tue"	"Midday"	"351"	3	5	1	9
15073	2018-03-12	"Mon"	"Evening"	"594"	5	9	4	18
15072	2018-03-12	"Mon"	"Midday"	"940"	9	4	0	13
15071	2018-03-11	"Sun"	"Evening"	"766"	7	6	6	19
15070	2018-03-11	"Sun"	"Midday"	"361"	3	6	1	10
15069	2018-03-10	"Sat"	"Evening"	"895"	8	9	5	22
15068	2018-03-10	"Sat"	"Midday"	"838"	8	3	8	19
15067	2018-03-09	"Fri"	"Evening"	"555"	5	5	5	15
15066	2018-03-09	"Fri"	"Midday"	"614"	6	1	4	11
15065	2018-03-08	"Thu"	"Evening"	"762"	7	6	2	15
15064	2018-03-08	"Thu"	"Midday"	"106"	1	0	6	7
15063	2018-03-07	"Wed"	"Evening"	"162"	1	6	2	9
15062	2018-03-07	"Wed"	"Midday"	"540"	5	4	0	9
15061	2018-03-06	"Tue"	"Evening"	"822"	8	2	2	12
15060	2018-03-06	"Tue"	"Midday"	"312"	3	1	2	6
15059	2018-03-05	"Mon"	"Evening"	"518"	5	1	8	14
15058	2018-03-05	"Mon"	"Midday"	"255"	2	5	5	12
15057	2018-03-04	"Sun"	"Evening"	"505"	5	0	5	10
15056	2018-03-04	"Sun"	"Midday"	"771"	7	7	1	15
15055	2018-03-03	"Sat"	"Evening"	"898"	8	9	8	25
15054	2018-03-03	"Sat"	"Midday"	"639"	6	3	9	18
15053	2018-03-02	"Fri"	"Evening"	"760"	7	6	0	13
15052	2018-03-02	"Fri"	"Midday"	"994"	9	9	4	22
15051	2018-03-01	"Thu"	"Evening"	"262"	2	6	2	10
15050	2018-03-01	"Thu"	"Midday"	"684"	6	8	4	18
15049	2018-02-28	"Wed"	"Evening"	"982"	9	8	2	19
15048	2018-02-28	"Wed"	"Midday"	"040"	0	4	0	4
15047	2018-02-27	"Tue"	"Evening"	"955"	9	5	5	19
15046	2018-02-27	"Tue"	"Midday"	"101"	1	0	1	2
15045	2018-02-26	"Mon"	"Evening"	"588"	5	8	8	21
15044	2018-02-26	"Mon"	"Midday"	"119"	1	1	9	11
15043	2018-02-25	"Sun"	"Evening"	"226"	2	2	6	10
15042	2018-02-25	"Sun"	"Midday"	"648"	6	4	8	18
15041	2018-02-24	"Sat"	"Evening"	"248"	2	4	8	14
15040	2018-02-24	"Sat"	"Midday"	"500"	5	0	0	5
15039	2018-02-23	"Fri"	"Evening"	"445"	4	4	5	13
15038	2018-02-23	"Fri"	"Midday"	"664"	6	6	4	16
15037	2018-02-22	"Thu"	"Evening"	"754"	7	5	4	16
15036	2018-02-22	"Thu"	"Midday"	"756"	7	5	6	18
15035	2018-02-21	"Wed"	"Evening"	"180"	1	8	0	9
15034	2018-02-21	"Wed"	"Midday"	"925"	9	2	5	16
15033	2018-02-20	"Tue"	"Evening"	"057"	0	5	7	12
15032	2018-02-20	"Tue"	"Midday"	"501"	5	0	1	6
15031	2018-02-19	"Mon"	"Evening"	"385"	3	8	5	16
15030	2018-02-19	"Mon"	"Midday"	"713"	7	1	3	11
15029	2018-02-18	"Sun"	"Evening"	"312"	3	1	2	6
15028	2018-02-18	"Sun"	"Midday"	"142"	1	4	2	7
15027	2018-02-17	"Sat"	"Evening"	"109"	1	0	9	10
15026	2018-02-17	"Sat"	"Midday"	"134"	1	3	4	8
15025	2018-02-16	"Fri"	"Evening"	"390"	3	9	0	12
15024	2018-02-16	"Fri"	"Midday"	"323"	3	2	3	8
15023	2018-02-15	"Thu"	"Evening"	"955"	9	5	5	19
15022	2018-02-15	"Thu"	"Midday"	"267"	2	6	7	15
15021	2018-02-14	"Wed"	"Evening"	"858"	8	5	8	21
15020	2018-02-14	"Wed"	"Midday"	"363"	3	6	3	12
15019	2018-02-13	"Tue"	"Evening"	"052"	0	5	2	7
15018	2018-02-13	"Tue"	"Midday"	"169"	1	6	9	16
15017	2018-02-12	"Mon"	"Evening"	"860"	8	6	0	14
15016	2018-02-12	"Mon"	"Midday"	"921"	9	2	1	12
15015	2018-02-11	"Sun"	"Evening"	"089"	0	8	9	17
15014	2018-02-11	"Sun"	"Midday"	"710"	7	1	0	8
15013	2018-02-10	"Sat"	"Evening"	"220"	2	2	0	4
15012	2018-02-10	"Sat"	"Midday"	"140"	1	4	0	5
15011	2018-02-09	"Fri"	"Evening"	"699"	6	9	9	24
15010	2018-02-09	"Fri"	"Midday"	"778"	7	7	8	22
15009	2018-02-08	"Thu"	"Evening"	"212"	2	1	2	5
15008	2018-02-08	"Thu"	"Midday"	"462"	4	6	2	12
15007	2018-02-07	"Wed"	"Evening"	"955"	9	5	5	19
15006	2018-02-07	"Wed"	"Midday"	"719"	7	1	9	17
15005	2018-02-06	"Tue"	"Evening"	"308"	3	0	8	11
15004	2018-02-06	"Tue"	"Midday"	"364"	3	6	4	13
15003	2018-02-05	"Mon"	"Evening"	"389"	3	8	9	20
15002	2018-02-05	"Mon"	"Midday"	"347"	3	4	7	14
15001	2018-02-04	"Sun"	"Evening"	"568"	5	6	8	19
15000	2018-02-04	"Sun"	"Midday"	"308"	3	0	8	11
14999	2018-02-03	"Sat"	"Evening"	"122"	1	2	2	5
14998	2018-02-03	"Sat"	"Midday"	"750"	7	5	0	12
14997	2018-02-02	"Fri"	"Evening"	"465"	4	6	5	15
14996	2018-02-02	"Fri"	"Midday"	"130"	1	3	0	4
14995	2018-02-01	"Thu"	"Evening"	"423"	4	2	3	9
14994	2018-02-01	"Thu"	"Midday"	"928"	9	2	8	19
14993	2018-01-31	"Wed"	"Evening"	"052"	0	5	2	7
14992	2018-01-31	"Wed"	"Midday"	"279"	2	7	9	18
14991	2018-01-30	"Tue"	"Evening"	"304"	3	0	4	7
14990	2018-01-30	"Tue"	"Midday"	"771"	7	7	1	15
14989	2018-01-29	"Mon"	"Evening"	"375"	3	7	5	15
14988	2018-01-29	"Mon"	"Midday"	"508"	5	0	8	13
14987	2018-01-28	"Sun"	"Evening"	"475"	4	7	5	16
14986	2018-01-28	"Sun"	"Midday"	"432"	4	3	2	9
14985	2018-01-27	"Sat"	"Evening"	"808"	8	0	8	16
14984	2018-01-27	"Sat"	"Midday"	"267"	2	6	7	15
14983	2018-01-26	"Fri"	"Evening"	"945"	9	4	5	18
14982	2018-01-26	"Fri"	"Midday"	"772"	7	7	2	16
14981	2018-01-25	"Thu"	"Evening"	"541"	5	4	1	10
14980	2018-01-25	"Thu"	"Midday"	"181"	1	8	1	10
14979	2018-01-24	"Wed"	"Evening"	"063"	0	6	3	9
14978	2018-01-24	"Wed"	"Midday"	"912"	9	1	2	12
14977	2018-01-23	"Tue"	"Evening"	"444"	4	4	4	12
14976	2018-01-23	"Tue"	"Midday"	"039"	0	3	9	12
14975	2018-01-22	"Mon"	"Evening"	"930"	9	3	0	12
14974	2018-01-22	"Mon"	"Midday"	"036"	0	3	6	9
14973	2018-01-21	"Sun"	"Evening"	"645"	6	4	5	15
14972	2018-01-21	"Sun"	"Midday"	"881"	8	8	1	17
14971	2018-01-20	"Sat"	"Evening"	"602"	6	0	2	8
14970	2018-01-20	"Sat"	"Midday"	"790"	7	9	0	16
14969	2018-01-19	"Fri"	"Evening"	"021"	0	2	1	3
14968	2018-01-19	"Fri"	"Midday"	"898"	8	9	8	25
14967	2018-01-18	"Thu"	"Evening"	"096"	0	9	6	15
14966	2018-01-18	"Thu"	"Midday"	"657"	6	5	7	18
14965	2018-01-17	"Wed"	"Evening"	"519"	5	1	9	15
14964	2018-01-17	"Wed"	"Midday"	"869"	8	6	9	23
14963	2018-01-16	"Tue"	"Evening"	"884"	8	8	4	20
14962	2018-01-16	"Tue"	"Midday"	"000"	0	0	0	0
14961	2018-01-15	"Mon"	"Evening"	"856"	8	5	6	19
14960	2018-01-15	"Mon"	"Midday"	"527"	5	2	7	14
14959	2018-01-14	"Sun"	"Evening"	"307"	3	0	7	10
14958	2018-01-14	"Sun"	"Midday"	"714"	7	1	4	12
14957	2018-01-13	"Sat"	"Evening"	"192"	1	9	2	12
14956	2018-01-13	"Sat"	"Midday"	"797"	7	9	7	23
14955	2018-01-12	"Fri"	"Evening"	"894"	8	9	4	21
14954	2018-01-12	"Fri"	"Midday"	"107"	1	0	7	8
14953	2018-01-11	"Thu"	"Evening"	"874"	8	7	4	19
14952	2018-01-11	"Thu"	"Midday"	"785"	7	8	5	20
14951	2018-01-10	"Wed"	"Evening"	"870"	8	7	0	15
14950	2018-01-10	"Wed"	"Midday"	"183"	1	8	3	12
14949	2018-01-09	"Tue"	"Evening"	"936"	9	3	6	18
14948	2018-01-09	"Tue"	"Midday"	"667"	6	6	7	19
14947	2018-01-08	"Mon"	"Evening"	"234"	2	3	4	9
14946	2018-01-08	"Mon"	"Midday"	"260"	2	6	0	8
14945	2018-01-07	"Sun"	"Evening"	"302"	3	0	2	5
14944	2018-01-07	"Sun"	"Midday"	"737"	7	3	7	17
14943	2018-01-06	"Sat"	"Evening"	"193"	1	9	3	13
14942	2018-01-06	"Sat"	"Midday"	"452"	4	5	2	11
14941	2018-01-05	"Fri"	"Evening"	"001"	0	0	1	1
14940	2018-01-05	"Fri"	"Midday"	"316"	3	1	6	10
14939	2018-01-04	"Thu"	"Evening"	"227"	2	2	7	11
14938	2018-01-04	"Thu"	"Midday"	"956"	9	5	6	20
14937	2018-01-03	"Wed"	"Evening"	"967"	9	6	7	22
14936	2018-01-03	"Wed"	"Midday"	"483"	4	8	3	15
14935	2018-01-02	"Tue"	"Evening"	"436"	4	3	6	13
14934	2018-01-02	"Tue"	"Midday"	"197"	1	9	7	17
14933	2018-01-01	"Mon"	"Evening"	"206"	2	0	6	8
14932	2018-01-01	"Mon"	"Midday"	"355"	3	5	5	13
14931	2017-12-31	"Sun"	"Evening"	"449"	4	4	9	17
14930	2017-12-31	"Sun"	"Midday"	"141"	1	4	1	6
14929	2017-12-30	"Sat"	"Evening"	"036"	0	3	6	9
14928	2017-12-30	"Sat"	"Midday"	"200"	2	0	0	2
14927	2017-12-29	"Fri"	"Evening"	"065"	0	6	5	11
14926	2017-12-29	"Fri"	"Midday"	"306"	3	0	6	9
14925	2017-12-28	"Thu"	"Evening"	"892"	8	9	2	19
14924	2017-12-28	"Thu"	"Midday"	"834"	8	3	4	15
14923	2017-12-27	"Wed"	"Evening"	"593"	5	9	3	17
14922	2017-12-27	"Wed"	"Midday"	"147"	1	4	7	12
14921	2017-12-26	"Tue"	"Evening"	"996"	9	9	6	24
14920	2017-12-26	"Tue"	"Midday"	"561"	5	6	1	12
14919	2017-12-25	"Mon"	"Evening"	"709"	7	0	9	16
14918	2017-12-25	"Mon"	"Midday"	"573"	5	7	3	15
14917	2017-12-24	"Sun"	"Evening"	"325"	3	2	5	10
14916	2017-12-24	"Sun"	"Midday"	"944"	9	4	4	17
14915	2017-12-23	"Sat"	"Evening"	"060"	0	6	0	6
14914	2017-12-23	"Sat"	"Midday"	"764"	7	6	4	17
14913	2017-12-22	"Fri"	"Evening"	"576"	5	7	6	18
14912	2017-12-22	"Fri"	"Midday"	"999"	9	9	9	27
14911	2017-12-21	"Thu"	"Evening"	"124"	1	2	4	7
14910	2017-12-21	"Thu"	"Midday"	"637"	6	3	7	16
14909	2017-12-20	"Wed"	"Evening"	"537"	5	3	7	15
14908	2017-12-20	"Wed"	"Midday"	"312"	3	1	2	6
14907	2017-12-19	"Tue"	"Evening"	"994"	9	9	4	22
14906	2017-12-19	"Tue"	"Midday"	"850"	8	5	0	13
14905	2017-12-18	"Mon"	"Evening"	"690"	6	9	0	15
14904	2017-12-18	"Mon"	"Midday"	"731"	7	3	1	11
14903	2017-12-17	"Sun"	"Evening"	"056"	0	5	6	11
14902	2017-12-17	"Sun"	"Midday"	"209"	2	0	9	11
14901	2017-12-16	"Sat"	"Evening"	"444"	4	4	4	12
14900	2017-12-16	"Sat"	"Midday"	"277"	2	7	7	16
14899	2017-12-15	"Fri"	"Evening"	"020"	0	2	0	2
14898	2017-12-15	"Fri"	"Midday"	"959"	9	5	9	23
14897	2017-12-14	"Thu"	"Evening"	"749"	7	4	9	20
14896	2017-12-14	"Thu"	"Midday"	"247"	2	4	7	13
14895	2017-12-13	"Wed"	"Evening"	"153"	1	5	3	9
14894	2017-12-13	"Wed"	"Midday"	"389"	3	8	9	20
14893	2017-12-12	"Tue"	"Evening"	"790"	7	9	0	16
14892	2017-12-12	"Tue"	"Midday"	"934"	9	3	4	16
14891	2017-12-11	"Mon"	"Evening"	"289"	2	8	9	19
14890	2017-12-11	"Mon"	"Midday"	"708"	7	0	8	15
14889	2017-12-10	"Sun"	"Evening"	"983"	9	8	3	20
14888	2017-12-10	"Sun"	"Midday"	"067"	0	6	7	13
14887	2017-12-09	"Sat"	"Evening"	"547"	5	4	7	16
14886	2017-12-09	"Sat"	"Midday"	"835"	8	3	5	16
14885	2017-12-08	"Fri"	"Evening"	"498"	4	9	8	21
14884	2017-12-08	"Fri"	"Midday"	"856"	8	5	6	19
14883	2017-12-07	"Thu"	"Evening"	"746"	7	4	6	17
14882	2017-12-07	"Thu"	"Midday"	"211"	2	1	1	4
14881	2017-12-06	"Wed"	"Evening"	"983"	9	8	3	20
14880	2017-12-06	"Wed"	"Midday"	"748"	7	4	8	19
14879	2017-12-05	"Tue"	"Evening"	"447"	4	4	7	15
14878	2017-12-05	"Tue"	"Midday"	"113"	1	1	3	5
14877	2017-12-04	"Mon"	"Evening"	"261"	2	6	1	9
14876	2017-12-04	"Mon"	"Midday"	"647"	6	4	7	17
14875	2017-12-03	"Sun"	"Evening"	"667"	6	6	7	19
14874	2017-12-03	"Sun"	"Midday"	"909"	9	0	9	18
14873	2017-12-02	"Sat"	"Evening"	"452"	4	5	2	11
14872	2017-12-02	"Sat"	"Midday"	"427"	4	2	7	13
14871	2017-12-01	"Fri"	"Evening"	"088"	0	8	8	16
14870	2017-12-01	"Fri"	"Midday"	"464"	4	6	4	14
14869	2017-11-30	"Thu"	"Evening"	"581"	5	8	1	14
14868	2017-11-30	"Thu"	"Midday"	"853"	8	5	3	16
14867	2017-11-29	"Wed"	"Evening"	"838"	8	3	8	19
14866	2017-11-29	"Wed"	"Midday"	"594"	5	9	4	18
14865	2017-11-28	"Tue"	"Evening"	"569"	5	6	9	20
14864	2017-11-28	"Tue"	"Midday"	"084"	0	8	4	12
14863	2017-11-27	"Mon"	"Evening"	"742"	7	4	2	13
14862	2017-11-27	"Mon"	"Midday"	"720"	7	2	0	9
14861	2017-11-26	"Sun"	"Evening"	"124"	1	2	4	7
14860	2017-11-26	"Sun"	"Midday"	"785"	7	8	5	20
14859	2017-11-25	"Sat"	"Evening"	"557"	5	5	7	17
14858	2017-11-25	"Sat"	"Midday"	"325"	3	2	5	10
14857	2017-11-24	"Fri"	"Evening"	"365"	3	6	5	14
14856	2017-11-24	"Fri"	"Midday"	"660"	6	6	0	12
14855	2017-11-23	"Thu"	"Evening"	"892"	8	9	2	19
14854	2017-11-23	"Thu"	"Midday"	"311"	3	1	1	5
14853	2017-11-22	"Wed"	"Evening"	"459"	4	5	9	18
14852	2017-11-22	"Wed"	"Midday"	"453"	4	5	3	12
14851	2017-11-21	"Tue"	"Evening"	"021"	0	2	1	3
14850	2017-11-21	"Tue"	"Midday"	"203"	2	0	3	5
14849	2017-11-20	"Mon"	"Evening"	"675"	6	7	5	18
14848	2017-11-20	"Mon"	"Midday"	"919"	9	1	9	19
14847	2017-11-19	"Sun"	"Evening"	"138"	1	3	8	12
14846	2017-11-19	"Sun"	"Midday"	"645"	6	4	5	15
14845	2017-11-18	"Sat"	"Evening"	"774"	7	7	4	18
14844	2017-11-18	"Sat"	"Midday"	"309"	3	0	9	12
14843	2017-11-17	"Fri"	"Evening"	"351"	3	5	1	9
14842	2017-11-17	"Fri"	"Midday"	"129"	1	2	9	12
14841	2017-11-16	"Thu"	"Evening"	"428"	4	2	8	14
14840	2017-11-16	"Thu"	"Midday"	"435"	4	3	5	12
14839	2017-11-15	"Wed"	"Evening"	"704"	7	0	4	11
14838	2017-11-15	"Wed"	"Midday"	"725"	7	2	5	14
14837	2017-11-14	"Tue"	"Evening"	"530"	5	3	0	8
14836	2017-11-14	"Tue"	"Midday"	"952"	9	5	2	16
14835	2017-11-13	"Mon"	"Evening"	"008"	0	0	8	8
14834	2017-11-13	"Mon"	"Midday"	"875"	8	7	5	20
14833	2017-11-12	"Sun"	"Evening"	"016"	0	1	6	7
14832	2017-11-12	"Sun"	"Midday"	"816"	8	1	6	15
14831	2017-11-11	"Sat"	"Evening"	"047"	0	4	7	11
14830	2017-11-11	"Sat"	"Midday"	"024"	0	2	4	6
14829	2017-11-10	"Fri"	"Evening"	"186"	1	8	6	15
14828	2017-11-10	"Fri"	"Midday"	"560"	5	6	0	11
14827	2017-11-09	"Thu"	"Evening"	"165"	1	6	5	12
14826	2017-11-09	"Thu"	"Midday"	"395"	3	9	5	17
14825	2017-11-08	"Wed"	"Evening"	"969"	9	6	9	24
14824	2017-11-08	"Wed"	"Midday"	"459"	4	5	9	18
14823	2017-11-07	"Tue"	"Evening"	"213"	2	1	3	6
14822	2017-11-07	"Tue"	"Midday"	"932"	9	3	2	14
14821	2017-11-06	"Mon"	"Evening"	"987"	9	8	7	24
14820	2017-11-06	"Mon"	"Midday"	"212"	2	1	2	5
14819	2017-11-05	"Sun"	"Evening"	"441"	4	4	1	9
14818	2017-11-05	"Sun"	"Midday"	"242"	2	4	2	8
14817	2017-11-04	"Sat"	"Evening"	"930"	9	3	0	12
14816	2017-11-04	"Sat"	"Midday"	"319"	3	1	9	13
14815	2017-11-03	"Fri"	"Evening"	"327"	3	2	7	12
14814	2017-11-03	"Fri"	"Midday"	"064"	0	6	4	10
14813	2017-11-02	"Thu"	"Evening"	"194"	1	9	4	14
14812	2017-11-02	"Thu"	"Midday"	"453"	4	5	3	12
14811	2017-11-01	"Wed"	"Evening"	"129"	1	2	9	12
14810	2017-11-01	"Wed"	"Midday"	"680"	6	8	0	14
14809	2017-10-31	"Tue"	"Evening"	"998"	9	9	8	26
14808	2017-10-31	"Tue"	"Midday"	"208"	2	0	8	10
14807	2017-10-30	"Mon"	"Evening"	"377"	3	7	7	17
14806	2017-10-30	"Mon"	"Midday"	"880"	8	8	0	16
14805	2017-10-29	"Sun"	"Evening"	"498"	4	9	8	21
14804	2017-10-29	"Sun"	"Midday"	"789"	7	8	9	24
14803	2017-10-28	"Sat"	"Evening"	"460"	4	6	0	10
14802	2017-10-28	"Sat"	"Midday"	"578"	5	7	8	20
14801	2017-10-27	"Fri"	"Evening"	"167"	1	6	7	14
14800	2017-10-27	"Fri"	"Midday"	"843"	8	4	3	15
14799	2017-10-26	"Thu"	"Evening"	"421"	4	2	1	7
14798	2017-10-26	"Thu"	"Midday"	"306"	3	0	6	9
14797	2017-10-25	"Wed"	"Evening"	"429"	4	2	9	15
14796	2017-10-25	"Wed"	"Midday"	"540"	5	4	0	9
14795	2017-10-24	"Tue"	"Evening"	"744"	7	4	4	15
14794	2017-10-24	"Tue"	"Midday"	"575"	5	7	5	17
14793	2017-10-23	"Mon"	"Evening"	"423"	4	2	3	9
14792	2017-10-23	"Mon"	"Midday"	"546"	5	4	6	15
14791	2017-10-22	"Sun"	"Evening"	"348"	3	4	8	15
14790	2017-10-22	"Sun"	"Midday"	"784"	7	8	4	19
14789	2017-10-21	"Sat"	"Evening"	"811"	8	1	1	10
14788	2017-10-21	"Sat"	"Midday"	"331"	3	3	1	7
14787	2017-10-20	"Fri"	"Evening"	"530"	5	3	0	8
14786	2017-10-20	"Fri"	"Midday"	"320"	3	2	0	5
14785	2017-10-19	"Thu"	"Evening"	"134"	1	3	4	8
14784	2017-10-19	"Thu"	"Midday"	"664"	6	6	4	16
14783	2017-10-18	"Wed"	"Evening"	"327"	3	2	7	12
14782	2017-10-18	"Wed"	"Midday"	"311"	3	1	1	5
14781	2017-10-17	"Tue"	"Evening"	"614"	6	1	4	11
14780	2017-10-17	"Tue"	"Midday"	"870"	8	7	0	15
14779	2017-10-16	"Mon"	"Evening"	"085"	0	8	5	13
14778	2017-10-16	"Mon"	"Midday"	"095"	0	9	5	14
14777	2017-10-15	"Sun"	"Evening"	"059"	0	5	9	14
14776	2017-10-15	"Sun"	"Midday"	"251"	2	5	1	8
14775	2017-10-14	"Sat"	"Evening"	"921"	9	2	1	12
14774	2017-10-14	"Sat"	"Midday"	"812"	8	1	2	11
14773	2017-10-13	"Fri"	"Evening"	"218"	2	1	8	11
14772	2017-10-13	"Fri"	"Midday"	"572"	5	7	2	14
14771	2017-10-12	"Thu"	"Evening"	"315"	3	1	5	9
14770	2017-10-12	"Thu"	"Midday"	"283"	2	8	3	13
14769	2017-10-11	"Wed"	"Evening"	"177"	1	7	7	15
14768	2017-10-11	"Wed"	"Midday"	"475"	4	7	5	16
14767	2017-10-10	"Tue"	"Evening"	"167"	1	6	7	14
14766	2017-10-10	"Tue"	"Midday"	"215"	2	1	5	8
14765	2017-10-09	"Mon"	"Evening"	"635"	6	3	5	14
14764	2017-10-09	"Mon"	"Midday"	"527"	5	2	7	14
14763	2017-10-08	"Sun"	"Evening"	"425"	4	2	5	11
14762	2017-10-08	"Sun"	"Midday"	"561"	5	6	1	12
14761	2017-10-07	"Sat"	"Evening"	"573"	5	7	3	15
14760	2017-10-07	"Sat"	"Midday"	"009"	0	0	9	9
14759	2017-10-06	"Fri"	"Evening"	"705"	7	0	5	12
14758	2017-10-06	"Fri"	"Midday"	"463"	4	6	3	13
14757	2017-10-05	"Thu"	"Evening"	"279"	2	7	9	18
14756	2017-10-05	"Thu"	"Midday"	"407"	4	0	7	11
14755	2017-10-04	"Wed"	"Evening"	"404"	4	0	4	8
14754	2017-10-04	"Wed"	"Midday"	"748"	7	4	8	19
14753	2017-10-03	"Tue"	"Evening"	"293"	2	9	3	14
14752	2017-10-03	"Tue"	"Midday"	"929"	9	2	9	20
14751	2017-10-02	"Mon"	"Evening"	"408"	4	0	8	12
14750	2017-10-02	"Mon"	"Midday"	"110"	1	1	0	2
14749	2017-10-01	"Sun"	"Evening"	"065"	0	6	5	11
14748	2017-10-01	"Sun"	"Midday"	"548"	5	4	8	17
14747	2017-09-30	"Sat"	"Evening"	"422"	4	2	2	8
14746	2017-09-30	"Sat"	"Midday"	"339"	3	3	9	15
14745	2017-09-29	"Fri"	"Evening"	"990"	9	9	0	18
14744	2017-09-29	"Fri"	"Midday"	"393"	3	9	3	15
14743	2017-09-28	"Thu"	"Evening"	"801"	8	0	1	9
14742	2017-09-28	"Thu"	"Midday"	"843"	8	4	3	15
14741	2017-09-27	"Wed"	"Evening"	"633"	6	3	3	12
14740	2017-09-27	"Wed"	"Midday"	"102"	1	0	2	3
14739	2017-09-26	"Tue"	"Evening"	"277"	2	7	7	16
14738	2017-09-26	"Tue"	"Midday"	"447"	4	4	7	15
14737	2017-09-25	"Mon"	"Evening"	"942"	9	4	2	15
14736	2017-09-25	"Mon"	"Midday"	"387"	3	8	7	18
14735	2017-09-24	"Sun"	"Evening"	"424"	4	2	4	10
14734	2017-09-24	"Sun"	"Midday"	"138"	1	3	8	12
14733	2017-09-23	"Sat"	"Evening"	"995"	9	9	5	23
14732	2017-09-23	"Sat"	"Midday"	"303"	3	0	3	6
14731	2017-09-22	"Fri"	"Evening"	"338"	3	3	8	14
14730	2017-09-22	"Fri"	"Midday"	"280"	2	8	0	10
14729	2017-09-21	"Thu"	"Evening"	"390"	3	9	0	12
14728	2017-09-21	"Thu"	"Midday"	"109"	1	0	9	10
14727	2017-09-20	"Wed"	"Evening"	"814"	8	1	4	13
14726	2017-09-20	"Wed"	"Midday"	"875"	8	7	5	20
14725	2017-09-19	"Tue"	"Evening"	"083"	0	8	3	11
14724	2017-09-19	"Tue"	"Midday"	"788"	7	8	8	23
14723	2017-09-18	"Mon"	"Evening"	"423"	4	2	3	9
14722	2017-09-18	"Mon"	"Midday"	"767"	7	6	7	20
14721	2017-09-17	"Sun"	"Evening"	"739"	7	3	9	19
14720	2017-09-17	"Sun"	"Midday"	"335"	3	3	5	11
14719	2017-09-16	"Sat"	"Evening"	"544"	5	4	4	13
14718	2017-09-16	"Sat"	"Midday"	"355"	3	5	5	13
14717	2017-09-15	"Fri"	"Evening"	"344"	3	4	4	11
14716	2017-09-15	"Fri"	"Midday"	"929"	9	2	9	20
14715	2017-09-14	"Thu"	"Evening"	"709"	7	0	9	16
14714	2017-09-14	"Thu"	"Midday"	"133"	1	3	3	7
14713	2017-09-13	"Wed"	"Evening"	"065"	0	6	5	11
14712	2017-09-13	"Wed"	"Midday"	"670"	6	7	0	13
14711	2017-09-12	"Tue"	"Evening"	"022"	0	2	2	4
14710	2017-09-12	"Tue"	"Midday"	"748"	7	4	8	19
14709	2017-09-11	"Mon"	"Evening"	"507"	5	0	7	12
14708	2017-09-11	"Mon"	"Midday"	"975"	9	7	5	21
14707	2017-09-10	"Sun"	"Evening"	"214"	2	1	4	7
14706	2017-09-10	"Sun"	"Midday"	"041"	0	4	1	5
14705	2017-09-09	"Sat"	"Evening"	"144"	1	4	4	9
14704	2017-09-09	"Sat"	"Midday"	"988"	9	8	8	25
14703	2017-09-08	"Fri"	"Evening"	"506"	5	0	6	11
14702	2017-09-08	"Fri"	"Midday"	"018"	0	1	8	9
14701	2017-09-07	"Thu"	"Evening"	"237"	2	3	7	12
14700	2017-09-07	"Thu"	"Midday"	"896"	8	9	6	23
14699	2017-09-06	"Wed"	"Evening"	"580"	5	8	0	13
14698	2017-09-06	"Wed"	"Midday"	"524"	5	2	4	11
14697	2017-09-05	"Tue"	"Evening"	"614"	6	1	4	11
14696	2017-09-05	"Tue"	"Midday"	"017"	0	1	7	8
14695	2017-09-04	"Mon"	"Evening"	"016"	0	1	6	7
14694	2017-09-04	"Mon"	"Midday"	"568"	5	6	8	19
14693	2017-09-03	"Sun"	"Evening"	"773"	7	7	3	17
14692	2017-09-03	"Sun"	"Midday"	"020"	0	2	0	2
14691	2017-09-02	"Sat"	"Evening"	"186"	1	8	6	15
14690	2017-09-02	"Sat"	"Midday"	"552"	5	5	2	12
14689	2017-09-01	"Fri"	"Evening"	"366"	3	6	6	15
14688	2017-09-01	"Fri"	"Midday"	"365"	3	6	5	14
14687	2017-08-31	"Thu"	"Evening"	"351"	3	5	1	9
14686	2017-08-31	"Thu"	"Midday"	"541"	5	4	1	10
14685	2017-08-30	"Wed"	"Evening"	"539"	5	3	9	17
14684	2017-08-30	"Wed"	"Midday"	"251"	2	5	1	8
14683	2017-08-29	"Tue"	"Evening"	"635"	6	3	5	14
14682	2017-08-29	"Tue"	"Midday"	"927"	9	2	7	18
14681	2017-08-28	"Mon"	"Evening"	"012"	0	1	2	3
14680	2017-08-28	"Mon"	"Midday"	"951"	9	5	1	15
14679	2017-08-27	"Sun"	"Evening"	"380"	3	8	0	11
14678	2017-08-27	"Sun"	"Midday"	"418"	4	1	8	13
14677	2017-08-26	"Sat"	"Evening"	"071"	0	7	1	8
14676	2017-08-26	"Sat"	"Midday"	"486"	4	8	6	18
14675	2017-08-25	"Fri"	"Evening"	"855"	8	5	5	18
14674	2017-08-25	"Fri"	"Midday"	"275"	2	7	5	14
14673	2017-08-24	"Thu"	"Evening"	"455"	4	5	5	14
14672	2017-08-24	"Thu"	"Midday"	"315"	3	1	5	9
14671	2017-08-23	"Wed"	"Evening"	"917"	9	1	7	17
14670	2017-08-23	"Wed"	"Midday"	"921"	9	2	1	12
14669	2017-08-22	"Tue"	"Evening"	"822"	8	2	2	12
14668	2017-08-22	"Tue"	"Midday"	"089"	0	8	9	17
14667	2017-08-21	"Mon"	"Evening"	"058"	0	5	8	13
14666	2017-08-21	"Mon"	"Midday"	"010"	0	1	0	1
14665	2017-08-20	"Sun"	"Evening"	"227"	2	2	7	11
14664	2017-08-20	"Sun"	"Midday"	"488"	4	8	8	20
14663	2017-08-19	"Sat"	"Evening"	"042"	0	4	2	6
14662	2017-08-19	"Sat"	"Midday"	"974"	9	7	4	20
14661	2017-08-18	"Fri"	"Evening"	"528"	5	2	8	15
14660	2017-08-18	"Fri"	"Midday"	"898"	8	9	8	25
14659	2017-08-17	"Thu"	"Evening"	"410"	4	1	0	5
14658	2017-08-17	"Thu"	"Midday"	"317"	3	1	7	11
14657	2017-08-16	"Wed"	"Evening"	"839"	8	3	9	20
14656	2017-08-16	"Wed"	"Midday"	"840"	8	4	0	12
14655	2017-08-15	"Tue"	"Evening"	"142"	1	4	2	7
14654	2017-08-15	"Tue"	"Midday"	"255"	2	5	5	12
14653	2017-08-14	"Mon"	"Evening"	"531"	5	3	1	9
14652	2017-08-14	"Mon"	"Midday"	"345"	3	4	5	12
14651	2017-08-13	"Sun"	"Evening"	"057"	0	5	7	12
14650	2017-08-13	"Sun"	"Midday"	"087"	0	8	7	15
14649	2017-08-12	"Sat"	"Evening"	"752"	7	5	2	14
14648	2017-08-12	"Sat"	"Midday"	"458"	4	5	8	17
14647	2017-08-11	"Fri"	"Evening"	"858"	8	5	8	21
14646	2017-08-11	"Fri"	"Midday"	"938"	9	3	8	20
14645	2017-08-10	"Thu"	"Evening"	"374"	3	7	4	14
14644	2017-08-10	"Thu"	"Midday"	"151"	1	5	1	7
14643	2017-08-09	"Wed"	"Evening"	"002"	0	0	2	2
14642	2017-08-09	"Wed"	"Midday"	"894"	8	9	4	21
14641	2017-08-08	"Tue"	"Evening"	"653"	6	5	3	14
14640	2017-08-08	"Tue"	"Midday"	"680"	6	8	0	14
14639	2017-08-07	"Mon"	"Evening"	"452"	4	5	2	11
14638	2017-08-07	"Mon"	"Midday"	"958"	9	5	8	22
14637	2017-08-06	"Sun"	"Evening"	"994"	9	9	4	22
14636	2017-08-06	"Sun"	"Midday"	"621"	6	2	1	9
14635	2017-08-05	"Sat"	"Evening"	"571"	5	7	1	13
14634	2017-08-05	"Sat"	"Midday"	"397"	3	9	7	19
14633	2017-08-04	"Fri"	"Evening"	"055"	0	5	5	10
14632	2017-08-04	"Fri"	"Midday"	"117"	1	1	7	9
14631	2017-08-03	"Thu"	"Evening"	"660"	6	6	0	12
14630	2017-08-03	"Thu"	"Midday"	"550"	5	5	0	10
14629	2017-08-02	"Wed"	"Evening"	"522"	5	2	2	9
14628	2017-08-02	"Wed"	"Midday"	"079"	0	7	9	16
14627	2017-08-01	"Tue"	"Evening"	"640"	6	4	0	10
14626	2017-08-01	"Tue"	"Midday"	"268"	2	6	8	16
14625	2017-07-31	"Mon"	"Evening"	"249"	2	4	9	15
14624	2017-07-31	"Mon"	"Midday"	"253"	2	5	3	10
14623	2017-07-30	"Sun"	"Evening"	"001"	0	0	1	1
14622	2017-07-30	"Sun"	"Midday"	"766"	7	6	6	19
14621	2017-07-29	"Sat"	"Evening"	"452"	4	5	2	11
14620	2017-07-29	"Sat"	"Midday"	"363"	3	6	3	12
14619	2017-07-28	"Fri"	"Evening"	"702"	7	0	2	9
14618	2017-07-28	"Fri"	"Midday"	"606"	6	0	6	12
14617	2017-07-27	"Thu"	"Evening"	"083"	0	8	3	11
14616	2017-07-27	"Thu"	"Midday"	"189"	1	8	9	18
14615	2017-07-26	"Wed"	"Evening"	"665"	6	6	5	17
14614	2017-07-26	"Wed"	"Midday"	"490"	4	9	0	13
14613	2017-07-25	"Tue"	"Evening"	"634"	6	3	4	13
14612	2017-07-25	"Tue"	"Midday"	"722"	7	2	2	11
14611	2017-07-24	"Mon"	"Evening"	"277"	2	7	7	16
14610	2017-07-24	"Mon"	"Midday"	"404"	4	0	4	8
14609	2017-07-23	"Sun"	"Evening"	"730"	7	3	0	10
14608	2017-07-23	"Sun"	"Midday"	"732"	7	3	2	12
14607	2017-07-22	"Sat"	"Evening"	"483"	4	8	3	15
14606	2017-07-22	"Sat"	"Midday"	"176"	1	7	6	14
14605	2017-07-21	"Fri"	"Evening"	"221"	2	2	1	5
14604	2017-07-21	"Fri"	"Midday"	"412"	4	1	2	7
14603	2017-07-20	"Thu"	"Evening"	"894"	8	9	4	21
14602	2017-07-20	"Thu"	"Midday"	"639"	6	3	9	18
14601	2017-07-19	"Wed"	"Evening"	"774"	7	7	4	18
14600	2017-07-19	"Wed"	"Midday"	"324"	3	2	4	9
14599	2017-07-18	"Tue"	"Evening"	"732"	7	3	2	12
14598	2017-07-18	"Tue"	"Midday"	"824"	8	2	4	14
14597	2017-07-17	"Mon"	"Evening"	"632"	6	3	2	11
14596	2017-07-17	"Mon"	"Midday"	"314"	3	1	4	8
14595	2017-07-16	"Sun"	"Evening"	"372"	3	7	2	12
14594	2017-07-16	"Sun"	"Midday"	"107"	1	0	7	8
14593	2017-07-15	"Sat"	"Evening"	"427"	4	2	7	13
14592	2017-07-15	"Sat"	"Midday"	"989"	9	8	9	26
14591	2017-07-14	"Fri"	"Evening"	"245"	2	4	5	11
14590	2017-07-14	"Fri"	"Midday"	"299"	2	9	9	20
14589	2017-07-13	"Thu"	"Evening"	"786"	7	8	6	21
14588	2017-07-13	"Thu"	"Midday"	"106"	1	0	6	7
14587	2017-07-12	"Wed"	"Evening"	"857"	8	5	7	20
14586	2017-07-12	"Wed"	"Midday"	"021"	0	2	1	3
14585	2017-07-11	"Tue"	"Evening"	"102"	1	0	2	3
14584	2017-07-11	"Tue"	"Midday"	"593"	5	9	3	17
14583	2017-07-10	"Mon"	"Evening"	"074"	0	7	4	11
14582	2017-07-10	"Mon"	"Midday"	"322"	3	2	2	7
14581	2017-07-09	"Sun"	"Evening"	"708"	7	0	8	15
14580	2017-07-09	"Sun"	"Midday"	"829"	8	2	9	19
14579	2017-07-08	"Sat"	"Evening"	"626"	6	2	6	14
14578	2017-07-08	"Sat"	"Midday"	"229"	2	2	9	13
14577	2017-07-07	"Fri"	"Evening"	"123"	1	2	3	6
14576	2017-07-07	"Fri"	"Midday"	"190"	1	9	0	10
14575	2017-07-06	"Thu"	"Evening"	"980"	9	8	0	17
14574	2017-07-06	"Thu"	"Midday"	"834"	8	3	4	15
14573	2017-07-05	"Wed"	"Evening"	"933"	9	3	3	15
14572	2017-07-05	"Wed"	"Midday"	"077"	0	7	7	14
14571	2017-07-04	"Tue"	"Evening"	"369"	3	6	9	18
14570	2017-07-04	"Tue"	"Midday"	"296"	2	9	6	17
14569	2017-07-03	"Mon"	"Evening"	"788"	7	8	8	23
14568	2017-07-03	"Mon"	"Midday"	"333"	3	3	3	9
14567	2017-07-02	"Sun"	"Evening"	"190"	1	9	0	10
14566	2017-07-02	"Sun"	"Midday"	"143"	1	4	3	8
14565	2017-07-01	"Sat"	"Evening"	"566"	5	6	6	17
14564	2017-07-01	"Sat"	"Midday"	"860"	8	6	0	14
14563	2017-06-30	"Fri"	"Evening"	"354"	3	5	4	12
14562	2017-06-30	"Fri"	"Midday"	"887"	8	8	7	23
14561	2017-06-29	"Thu"	"Evening"	"096"	0	9	6	15
14560	2017-06-29	"Thu"	"Midday"	"474"	4	7	4	15
14559	2017-06-28	"Wed"	"Evening"	"426"	4	2	6	12
14558	2017-06-28	"Wed"	"Midday"	"067"	0	6	7	13
14557	2017-06-27	"Tue"	"Evening"	"034"	0	3	4	7
14556	2017-06-27	"Tue"	"Midday"	"632"	6	3	2	11
14555	2017-06-26	"Mon"	"Evening"	"873"	8	7	3	18
14554	2017-06-26	"Mon"	"Midday"	"586"	5	8	6	19
14553	2017-06-25	"Sun"	"Evening"	"247"	2	4	7	13
14552	2017-06-25	"Sun"	"Midday"	"015"	0	1	5	6
14551	2017-06-24	"Sat"	"Evening"	"584"	5	8	4	17
14550	2017-06-24	"Sat"	"Midday"	"339"	3	3	9	15
14549	2017-06-23	"Fri"	"Evening"	"518"	5	1	8	14
14548	2017-06-23	"Fri"	"Midday"	"754"	7	5	4	16
14547	2017-06-22	"Thu"	"Evening"	"856"	8	5	6	19
14546	2017-06-22	"Thu"	"Midday"	"146"	1	4	6	11
14545	2017-06-21	"Wed"	"Evening"	"763"	7	6	3	16
14544	2017-06-21	"Wed"	"Midday"	"353"	3	5	3	11
14543	2017-06-20	"Tue"	"Evening"	"227"	2	2	7	11
14542	2017-06-20	"Tue"	"Midday"	"317"	3	1	7	11
14541	2017-06-19	"Mon"	"Evening"	"416"	4	1	6	11
14540	2017-06-19	"Mon"	"Midday"	"331"	3	3	1	7
14539	2017-06-18	"Sun"	"Evening"	"626"	6	2	6	14
14538	2017-06-18	"Sun"	"Midday"	"959"	9	5	9	23
14537	2017-06-17	"Sat"	"Evening"	"950"	9	5	0	14
14536	2017-06-17	"Sat"	"Midday"	"231"	2	3	1	6
14535	2017-06-16	"Fri"	"Evening"	"654"	6	5	4	15
14534	2017-06-16	"Fri"	"Midday"	"884"	8	8	4	20
14533	2017-06-15	"Thu"	"Evening"	"527"	5	2	7	14
14532	2017-06-15	"Thu"	"Midday"	"146"	1	4	6	11
14531	2017-06-14	"Wed"	"Evening"	"154"	1	5	4	10
14530	2017-06-14	"Wed"	"Midday"	"909"	9	0	9	18
14529	2017-06-13	"Tue"	"Evening"	"901"	9	0	1	10
14528	2017-06-13	"Tue"	"Midday"	"598"	5	9	8	22
14527	2017-06-12	"Mon"	"Evening"	"776"	7	7	6	20
14526	2017-06-12	"Mon"	"Midday"	"756"	7	5	6	18
14525	2017-06-11	"Sun"	"Evening"	"165"	1	6	5	12
14524	2017-06-11	"Sun"	"Midday"	"260"	2	6	0	8
14523	2017-06-10	"Sat"	"Evening"	"155"	1	5	5	11
14522	2017-06-10	"Sat"	"Midday"	"684"	6	8	4	18
14521	2017-06-09	"Fri"	"Evening"	"827"	8	2	7	17
14520	2017-06-09	"Fri"	"Midday"	"758"	7	5	8	20
14519	2017-06-08	"Thu"	"Evening"	"589"	5	8	9	22
14518	2017-06-08	"Thu"	"Midday"	"439"	4	3	9	16
14517	2017-06-07	"Wed"	"Evening"	"252"	2	5	2	9
14516	2017-06-07	"Wed"	"Midday"	"173"	1	7	3	11
14515	2017-06-06	"Tue"	"Evening"	"310"	3	1	0	4
14514	2017-06-06	"Tue"	"Midday"	"223"	2	2	3	7
14513	2017-06-05	"Mon"	"Evening"	"206"	2	0	6	8
14512	2017-06-05	"Mon"	"Midday"	"862"	8	6	2	16
14511	2017-06-04	"Sun"	"Evening"	"054"	0	5	4	9
14510	2017-06-04	"Sun"	"Midday"	"435"	4	3	5	12
14509	2017-06-03	"Sat"	"Evening"	"937"	9	3	7	19
14508	2017-06-03	"Sat"	"Midday"	"291"	2	9	1	12
14507	2017-06-02	"Fri"	"Evening"	"386"	3	8	6	17
14506	2017-06-02	"Fri"	"Midday"	"726"	7	2	6	15
14505	2017-06-01	"Thu"	"Evening"	"594"	5	9	4	18
14504	2017-06-01	"Thu"	"Midday"	"531"	5	3	1	9
14503	2017-05-31	"Wed"	"Evening"	"852"	8	5	2	15
14502	2017-05-31	"Wed"	"Midday"	"311"	3	1	1	5
14501	2017-05-30	"Tue"	"Evening"	"323"	3	2	3	8
14500	2017-05-30	"Tue"	"Midday"	"728"	7	2	8	17
14499	2017-05-29	"Mon"	"Evening"	"253"	2	5	3	10
14498	2017-05-29	"Mon"	"Midday"	"882"	8	8	2	18
14497	2017-05-28	"Sun"	"Evening"	"859"	8	5	9	22
14496	2017-05-28	"Sun"	"Midday"	"970"	9	7	0	16
14495	2017-05-27	"Sat"	"Evening"	"778"	7	7	8	22
14494	2017-05-27	"Sat"	"Midday"	"845"	8	4	5	17
14493	2017-05-26	"Fri"	"Evening"	"921"	9	2	1	12
14492	2017-05-26	"Fri"	"Midday"	"144"	1	4	4	9
14491	2017-05-25	"Thu"	"Evening"	"205"	2	0	5	7
14490	2017-05-25	"Thu"	"Midday"	"756"	7	5	6	18
14489	2017-05-24	"Wed"	"Evening"	"975"	9	7	5	21
14488	2017-05-24	"Wed"	"Midday"	"741"	7	4	1	12
14487	2017-05-23	"Tue"	"Evening"	"464"	4	6	4	14
14486	2017-05-23	"Tue"	"Midday"	"578"	5	7	8	20
14485	2017-05-22	"Mon"	"Evening"	"096"	0	9	6	15
14484	2017-05-22	"Mon"	"Midday"	"543"	5	4	3	12
14483	2017-05-21	"Sun"	"Evening"	"859"	8	5	9	22
14482	2017-05-21	"Sun"	"Midday"	"218"	2	1	8	11
14481	2017-05-20	"Sat"	"Evening"	"295"	2	9	5	16
14480	2017-05-20	"Sat"	"Midday"	"185"	1	8	5	14
14479	2017-05-19	"Fri"	"Evening"	"989"	9	8	9	26
14478	2017-05-19	"Fri"	"Midday"	"409"	4	0	9	13
14477	2017-05-18	"Thu"	"Evening"	"430"	4	3	0	7
14476	2017-05-18	"Thu"	"Midday"	"778"	7	7	8	22
14475	2017-05-17	"Wed"	"Evening"	"990"	9	9	0	18
14474	2017-05-17	"Wed"	"Midday"	"985"	9	8	5	22
14473	2017-05-16	"Tue"	"Evening"	"534"	5	3	4	12
14472	2017-05-16	"Tue"	"Midday"	"134"	1	3	4	8
14471	2017-05-15	"Mon"	"Evening"	"850"	8	5	0	13
14470	2017-05-15	"Mon"	"Midday"	"216"	2	1	6	9
14469	2017-05-14	"Sun"	"Evening"	"813"	8	1	3	12
14468	2017-05-14	"Sun"	"Midday"	"284"	2	8	4	14
14467	2017-05-13	"Sat"	"Evening"	"049"	0	4	9	13
14466	2017-05-13	"Sat"	"Midday"	"004"	0	0	4	4
14465	2017-05-12	"Fri"	"Evening"	"239"	2	3	9	14
14464	2017-05-12	"Fri"	"Midday"	"180"	1	8	0	9
14463	2017-05-11	"Thu"	"Evening"	"379"	3	7	9	19
14462	2017-05-11	"Thu"	"Midday"	"795"	7	9	5	21
14461	2017-05-10	"Wed"	"Evening"	"695"	6	9	5	20
14460	2017-05-10	"Wed"	"Midday"	"071"	0	7	1	8
14459	2017-05-09	"Tue"	"Evening"	"899"	8	9	9	26
14458	2017-05-09	"Tue"	"Midday"	"697"	6	9	7	22
14457	2017-05-08	"Mon"	"Evening"	"907"	9	0	7	16
14456	2017-05-08	"Mon"	"Midday"	"658"	6	5	8	19
14455	2017-05-07	"Sun"	"Evening"	"802"	8	0	2	10
14454	2017-05-07	"Sun"	"Midday"	"628"	6	2	8	16
14453	2017-05-06	"Sat"	"Evening"	"015"	0	1	5	6
14452	2017-05-06	"Sat"	"Midday"	"178"	1	7	8	16
14451	2017-05-05	"Fri"	"Evening"	"132"	1	3	2	6
14450	2017-05-05	"Fri"	"Midday"	"991"	9	9	1	19
14449	2017-05-04	"Thu"	"Evening"	"484"	4	8	4	16
14448	2017-05-04	"Thu"	"Midday"	"248"	2	4	8	14
14447	2017-05-03	"Wed"	"Evening"	"126"	1	2	6	9
14446	2017-05-03	"Wed"	"Midday"	"260"	2	6	0	8
14445	2017-05-02	"Tue"	"Evening"	"173"	1	7	3	11
14444	2017-05-02	"Tue"	"Midday"	"764"	7	6	4	17
14443	2017-05-01	"Mon"	"Evening"	"208"	2	0	8	10
14442	2017-05-01	"Mon"	"Midday"	"214"	2	1	4	7
14441	2017-04-30	"Sun"	"Evening"	"365"	3	6	5	14
14440	2017-04-30	"Sun"	"Midday"	"396"	3	9	6	18
14439	2017-04-29	"Sat"	"Evening"	"050"	0	5	0	5
14438	2017-04-29	"Sat"	"Midday"	"142"	1	4	2	7
14437	2017-04-28	"Fri"	"Evening"	"877"	8	7	7	22
14436	2017-04-28	"Fri"	"Midday"	"130"	1	3	0	4
14435	2017-04-27	"Thu"	"Evening"	"294"	2	9	4	15
14434	2017-04-27	"Thu"	"Midday"	"291"	2	9	1	12
14433	2017-04-26	"Wed"	"Evening"	"310"	3	1	0	4
14432	2017-04-26	"Wed"	"Midday"	"230"	2	3	0	5
14431	2017-04-25	"Tue"	"Evening"	"523"	5	2	3	10
14430	2017-04-25	"Tue"	"Midday"	"241"	2	4	1	7
14429	2017-04-24	"Mon"	"Evening"	"386"	3	8	6	17
14428	2017-04-24	"Mon"	"Midday"	"310"	3	1	0	4
14427	2017-04-23	"Sun"	"Evening"	"555"	5	5	5	15
14426	2017-04-23	"Sun"	"Midday"	"458"	4	5	8	17
14425	2017-04-22	"Sat"	"Evening"	"349"	3	4	9	16
14424	2017-04-22	"Sat"	"Midday"	"971"	9	7	1	17
14423	2017-04-21	"Fri"	"Evening"	"783"	7	8	3	18
14422	2017-04-21	"Fri"	"Midday"	"085"	0	8	5	13
14421	2017-04-20	"Thu"	"Evening"	"427"	4	2	7	13
14420	2017-04-20	"Thu"	"Midday"	"853"	8	5	3	16
14419	2017-04-19	"Wed"	"Evening"	"893"	8	9	3	20
14418	2017-04-19	"Wed"	"Midday"	"905"	9	0	5	14
14417	2017-04-18	"Tue"	"Evening"	"184"	1	8	4	13
14416	2017-04-18	"Tue"	"Midday"	"546"	5	4	6	15
14415	2017-04-17	"Mon"	"Evening"	"137"	1	3	7	11
14414	2017-04-17	"Mon"	"Midday"	"995"	9	9	5	23
14413	2017-04-16	"Sun"	"Evening"	"140"	1	4	0	5
14412	2017-04-16	"Sun"	"Midday"	"495"	4	9	5	18
14411	2017-04-15	"Sat"	"Evening"	"162"	1	6	2	9
14410	2017-04-15	"Sat"	"Midday"	"101"	1	0	1	2
14409	2017-04-14	"Fri"	"Evening"	"027"	0	2	7	9
14408	2017-04-14	"Fri"	"Midday"	"502"	5	0	2	7
14407	2017-04-13	"Thu"	"Evening"	"142"	1	4	2	7
14406	2017-04-13	"Thu"	"Midday"	"557"	5	5	7	17
14405	2017-04-12	"Wed"	"Evening"	"146"	1	4	6	11
14404	2017-04-12	"Wed"	"Midday"	"062"	0	6	2	8
14403	2017-04-11	"Tue"	"Evening"	"501"	5	0	1	6
14402	2017-04-11	"Tue"	"Midday"	"459"	4	5	9	18
14401	2017-04-10	"Mon"	"Evening"	"428"	4	2	8	14
14400	2017-04-10	"Mon"	"Midday"	"321"	3	2	1	6
14399	2017-04-09	"Sun"	"Evening"	"648"	6	4	8	18
14398	2017-04-09	"Sun"	"Midday"	"244"	2	4	4	10
14397	2017-04-08	"Sat"	"Evening"	"380"	3	8	0	11
14396	2017-04-08	"Sat"	"Midday"	"675"	6	7	5	18
14395	2017-04-07	"Fri"	"Evening"	"924"	9	2	4	15
14394	2017-04-07	"Fri"	"Midday"	"623"	6	2	3	11
14393	2017-04-06	"Thu"	"Evening"	"161"	1	6	1	8
14392	2017-04-06	"Thu"	"Midday"	"172"	1	7	2	10
14391	2017-04-05	"Wed"	"Evening"	"881"	8	8	1	17
14390	2017-04-05	"Wed"	"Midday"	"670"	6	7	0	13
14389	2017-04-04	"Tue"	"Evening"	"857"	8	5	7	20
14388	2017-04-04	"Tue"	"Midday"	"183"	1	8	3	12
14387	2017-04-03	"Mon"	"Evening"	"503"	5	0	3	8
14386	2017-04-03	"Mon"	"Midday"	"946"	9	4	6	19
14385	2017-04-02	"Sun"	"Evening"	"263"	2	6	3	11
14384	2017-04-02	"Sun"	"Midday"	"075"	0	7	5	12
14383	2017-04-01	"Sat"	"Evening"	"378"	3	7	8	18
14382	2017-04-01	"Sat"	"Midday"	"532"	5	3	2	10
14381	2017-03-31	"Fri"	"Evening"	"705"	7	0	5	12
14380	2017-03-31	"Fri"	"Midday"	"870"	8	7	0	15
14379	2017-03-30	"Thu"	"Evening"	"669"	6	6	9	21
14378	2017-03-30	"Thu"	"Midday"	"937"	9	3	7	19
14377	2017-03-29	"Wed"	"Evening"	"662"	6	6	2	14
14376	2017-03-29	"Wed"	"Midday"	"411"	4	1	1	6
14375	2017-03-28	"Tue"	"Evening"	"622"	6	2	2	10
14374	2017-03-28	"Tue"	"Midday"	"872"	8	7	2	17
14373	2017-03-27	"Mon"	"Evening"	"850"	8	5	0	13
14372	2017-03-27	"Mon"	"Midday"	"862"	8	6	2	16
14371	2017-03-26	"Sun"	"Evening"	"223"	2	2	3	7
14370	2017-03-26	"Sun"	"Midday"	"247"	2	4	7	13
14369	2017-03-25	"Sat"	"Evening"	"101"	1	0	1	2
14368	2017-03-25	"Sat"	"Midday"	"525"	5	2	5	12
14367	2017-03-24	"Fri"	"Evening"	"519"	5	1	9	15
14366	2017-03-24	"Fri"	"Midday"	"115"	1	1	5	7
14365	2017-03-23	"Thu"	"Evening"	"167"	1	6	7	14
14364	2017-03-23	"Thu"	"Midday"	"850"	8	5	0	13
14363	2017-03-22	"Wed"	"Evening"	"389"	3	8	9	20
14362	2017-03-22	"Wed"	"Midday"	"230"	2	3	0	5
14361	2017-03-21	"Tue"	"Evening"	"020"	0	2	0	2
14360	2017-03-21	"Tue"	"Midday"	"876"	8	7	6	21
14359	2017-03-20	"Mon"	"Evening"	"942"	9	4	2	15
14358	2017-03-20	"Mon"	"Midday"	"737"	7	3	7	17
14357	2017-03-19	"Sun"	"Evening"	"719"	7	1	9	17
14356	2017-03-19	"Sun"	"Midday"	"221"	2	2	1	5
14355	2017-03-18	"Sat"	"Evening"	"034"	0	3	4	7
14354	2017-03-18	"Sat"	"Midday"	"323"	3	2	3	8
14353	2017-03-17	"Fri"	"Evening"	"904"	9	0	4	13
14352	2017-03-17	"Fri"	"Midday"	"575"	5	7	5	17
14351	2017-03-16	"Thu"	"Evening"	"503"	5	0	3	8
14350	2017-03-16	"Thu"	"Midday"	"945"	9	4	5	18
14349	2017-03-15	"Wed"	"Evening"	"510"	5	1	0	6
14348	2017-03-15	"Wed"	"Midday"	"689"	6	8	9	23
14347	2017-03-14	"Tue"	"Evening"	"801"	8	0	1	9
14346	2017-03-14	"Tue"	"Midday"	"473"	4	7	3	14
14345	2017-03-13	"Mon"	"Evening"	"538"	5	3	8	16
14344	2017-03-13	"Mon"	"Midday"	"282"	2	8	2	12
14343	2017-03-12	"Sun"	"Evening"	"143"	1	4	3	8
14342	2017-03-12	"Sun"	"Midday"	"930"	9	3	0	12
14341	2017-03-11	"Sat"	"Evening"	"372"	3	7	2	12
14340	2017-03-11	"Sat"	"Midday"	"288"	2	8	8	18
14339	2017-03-10	"Fri"	"Evening"	"473"	4	7	3	14
14338	2017-03-10	"Fri"	"Midday"	"043"	0	4	3	7
14337	2017-03-09	"Thu"	"Evening"	"580"	5	8	0	13
14336	2017-03-09	"Thu"	"Midday"	"411"	4	1	1	6
14335	2017-03-08	"Wed"	"Evening"	"514"	5	1	4	10
14334	2017-03-08	"Wed"	"Midday"	"908"	9	0	8	17
14333	2017-03-07	"Tue"	"Evening"	"799"	7	9	9	25
14332	2017-03-07	"Tue"	"Midday"	"475"	4	7	5	16
14331	2017-03-06	"Mon"	"Evening"	"946"	9	4	6	19
14330	2017-03-06	"Mon"	"Midday"	"417"	4	1	7	12
14329	2017-03-05	"Sun"	"Evening"	"761"	7	6	1	14
14328	2017-03-05	"Sun"	"Midday"	"893"	8	9	3	20
14327	2017-03-04	"Sat"	"Evening"	"135"	1	3	5	9
14326	2017-03-04	"Sat"	"Midday"	"162"	1	6	2	9
14325	2017-03-03	"Fri"	"Evening"	"533"	5	3	3	11
14324	2017-03-03	"Fri"	"Midday"	"094"	0	9	4	13
14323	2017-03-02	"Thu"	"Evening"	"581"	5	8	1	14
14322	2017-03-02	"Thu"	"Midday"	"432"	4	3	2	9
14321	2017-03-01	"Wed"	"Evening"	"968"	9	6	8	23
14320	2017-03-01	"Wed"	"Midday"	"335"	3	3	5	11
14319	2017-02-28	"Tue"	"Evening"	"489"	4	8	9	21
14318	2017-02-28	"Tue"	"Midday"	"682"	6	8	2	16
14317	2017-02-27	"Mon"	"Evening"	"588"	5	8	8	21
14316	2017-02-27	"Mon"	"Midday"	"650"	6	5	0	11
14315	2017-02-26	"Sun"	"Evening"	"421"	4	2	1	7
14314	2017-02-26	"Sun"	"Midday"	"176"	1	7	6	14
14313	2017-02-25	"Sat"	"Evening"	"614"	6	1	4	11
14312	2017-02-25	"Sat"	"Midday"	"743"	7	4	3	14
14311	2017-02-24	"Fri"	"Evening"	"520"	5	2	0	7
14310	2017-02-24	"Fri"	"Midday"	"799"	7	9	9	25
14309	2017-02-23	"Thu"	"Evening"	"441"	4	4	1	9
14308	2017-02-23	"Thu"	"Midday"	"912"	9	1	2	12
14307	2017-02-22	"Wed"	"Evening"	"502"	5	0	2	7
14306	2017-02-22	"Wed"	"Midday"	"494"	4	9	4	17
14305	2017-02-21	"Tue"	"Evening"	"399"	3	9	9	21
14304	2017-02-21	"Tue"	"Midday"	"878"	8	7	8	23
14303	2017-02-20	"Mon"	"Evening"	"984"	9	8	4	21
14302	2017-02-20	"Mon"	"Midday"	"050"	0	5	0	5
14301	2017-02-19	"Sun"	"Evening"	"349"	3	4	9	16
14300	2017-02-19	"Sun"	"Midday"	"106"	1	0	6	7
14299	2017-02-18	"Sat"	"Evening"	"970"	9	7	0	16
14298	2017-02-18	"Sat"	"Midday"	"414"	4	1	4	9
14297	2017-02-17	"Fri"	"Evening"	"787"	7	8	7	22
14296	2017-02-17	"Fri"	"Midday"	"675"	6	7	5	18
14295	2017-02-16	"Thu"	"Evening"	"824"	8	2	4	14
14294	2017-02-16	"Thu"	"Midday"	"948"	9	4	8	21
14293	2017-02-15	"Wed"	"Evening"	"006"	0	0	6	6
14292	2017-02-15	"Wed"	"Midday"	"579"	5	7	9	21
14291	2017-02-14	"Tue"	"Evening"	"465"	4	6	5	15
14290	2017-02-14	"Tue"	"Midday"	"739"	7	3	9	19
14289	2017-02-13	"Mon"	"Evening"	"804"	8	0	4	12
14288	2017-02-13	"Mon"	"Midday"	"071"	0	7	1	8
14287	2017-02-12	"Sun"	"Evening"	"453"	4	5	3	12
14286	2017-02-12	"Sun"	"Midday"	"402"	4	0	2	6
14285	2017-02-11	"Sat"	"Evening"	"772"	7	7	2	16
14284	2017-02-11	"Sat"	"Midday"	"609"	6	0	9	15
14283	2017-02-10	"Fri"	"Evening"	"840"	8	4	0	12
14282	2017-02-10	"Fri"	"Midday"	"907"	9	0	7	16
14281	2017-02-09	"Thu"	"Evening"	"212"	2	1	2	5
14280	2017-02-09	"Thu"	"Midday"	"184"	1	8	4	13
14279	2017-02-08	"Wed"	"Evening"	"238"	2	3	8	13
14278	2017-02-08	"Wed"	"Midday"	"662"	6	6	2	14
14277	2017-02-07	"Tue"	"Evening"	"974"	9	7	4	20
14276	2017-02-07	"Tue"	"Midday"	"815"	8	1	5	14
14275	2017-02-06	"Mon"	"Evening"	"835"	8	3	5	16
14274	2017-02-06	"Mon"	"Midday"	"294"	2	9	4	15
14273	2017-02-05	"Sun"	"Evening"	"962"	9	6	2	17
14272	2017-02-05	"Sun"	"Midday"	"602"	6	0	2	8
14271	2017-02-04	"Sat"	"Evening"	"703"	7	0	3	10
14270	2017-02-04	"Sat"	"Midday"	"747"	7	4	7	18
14269	2017-02-03	"Fri"	"Evening"	"121"	1	2	1	4
14268	2017-02-03	"Fri"	"Midday"	"591"	5	9	1	15
14267	2017-02-02	"Thu"	"Evening"	"135"	1	3	5	9
14266	2017-02-02	"Thu"	"Midday"	"697"	6	9	7	22
14265	2017-02-01	"Wed"	"Evening"	"612"	6	1	2	9
14264	2017-02-01	"Wed"	"Midday"	"880"	8	8	0	16
14263	2017-01-31	"Tue"	"Evening"	"704"	7	0	4	11
14262	2017-01-31	"Tue"	"Midday"	"906"	9	0	6	15
14261	2017-01-30	"Mon"	"Evening"	"845"	8	4	5	17
14260	2017-01-30	"Mon"	"Midday"	"368"	3	6	8	17
14259	2017-01-29	"Sun"	"Evening"	"250"	2	5	0	7
14258	2017-01-29	"Sun"	"Midday"	"390"	3	9	0	12
14257	2017-01-28	"Sat"	"Evening"	"716"	7	1	6	14
14256	2017-01-28	"Sat"	"Midday"	"985"	9	8	5	22
14255	2017-01-27	"Fri"	"Evening"	"512"	5	1	2	8
14254	2017-01-27	"Fri"	"Midday"	"827"	8	2	7	17
14253	2017-01-26	"Thu"	"Evening"	"266"	2	6	6	14
14252	2017-01-26	"Thu"	"Midday"	"354"	3	5	4	12
14251	2017-01-25	"Wed"	"Evening"	"340"	3	4	0	7
14250	2017-01-25	"Wed"	"Midday"	"770"	7	7	0	14
14249	2017-01-24	"Tue"	"Evening"	"477"	4	7	7	18
14248	2017-01-24	"Tue"	"Midday"	"633"	6	3	3	12
14247	2017-01-23	"Mon"	"Evening"	"129"	1	2	9	12
14246	2017-01-23	"Mon"	"Midday"	"637"	6	3	7	16
14245	2017-01-22	"Sun"	"Evening"	"307"	3	0	7	10
14244	2017-01-22	"Sun"	"Midday"	"091"	0	9	1	10
14243	2017-01-21	"Sat"	"Evening"	"948"	9	4	8	21
14242	2017-01-21	"Sat"	"Midday"	"162"	1	6	2	9
14241	2017-01-20	"Fri"	"Evening"	"560"	5	6	0	11
14240	2017-01-20	"Fri"	"Midday"	"227"	2	2	7	11
14239	2017-01-19	"Thu"	"Evening"	"273"	2	7	3	12
14238	2017-01-19	"Thu"	"Midday"	"464"	4	6	4	14
14237	2017-01-18	"Wed"	"Evening"	"640"	6	4	0	10
14236	2017-01-18	"Wed"	"Midday"	"341"	3	4	1	8
14235	2017-01-17	"Tue"	"Evening"	"764"	7	6	4	17
14234	2017-01-17	"Tue"	"Midday"	"525"	5	2	5	12
14233	2017-01-16	"Mon"	"Evening"	"703"	7	0	3	10
14232	2017-01-16	"Mon"	"Midday"	"881"	8	8	1	17
14231	2017-01-15	"Sun"	"Evening"	"152"	1	5	2	8
14230	2017-01-15	"Sun"	"Midday"	"977"	9	7	7	23
14229	2017-01-14	"Sat"	"Evening"	"680"	6	8	0	14
14228	2017-01-14	"Sat"	"Midday"	"395"	3	9	5	17
14227	2017-01-13	"Fri"	"Evening"	"636"	6	3	6	15
14226	2017-01-13	"Fri"	"Midday"	"982"	9	8	2	19
14225	2017-01-12	"Thu"	"Evening"	"876"	8	7	6	21
14224	2017-01-12	"Thu"	"Midday"	"682"	6	8	2	16
14223	2017-01-11	"Wed"	"Evening"	"484"	4	8	4	16
14222	2017-01-11	"Wed"	"Midday"	"571"	5	7	1	13
14221	2017-01-10	"Tue"	"Evening"	"718"	7	1	8	16
14220	2017-01-10	"Tue"	"Midday"	"200"	2	0	0	2
14219	2017-01-09	"Mon"	"Evening"	"927"	9	2	7	18
14218	2017-01-09	"Mon"	"Midday"	"117"	1	1	7	9
14217	2017-01-08	"Sun"	"Evening"	"538"	5	3	8	16
14216	2017-01-08	"Sun"	"Midday"	"287"	2	8	7	17
14215	2017-01-07	"Sat"	"Evening"	"241"	2	4	1	7
14214	2017-01-07	"Sat"	"Midday"	"712"	7	1	2	10
14213	2017-01-06	"Fri"	"Evening"	"108"	1	0	8	9
14212	2017-01-06	"Fri"	"Midday"	"954"	9	5	4	18
14211	2017-01-05	"Thu"	"Evening"	"868"	8	6	8	22
14210	2017-01-05	"Thu"	"Midday"	"586"	5	8	6	19
14209	2017-01-04	"Wed"	"Evening"	"087"	0	8	7	15
14208	2017-01-04	"Wed"	"Midday"	"861"	8	6	1	15
14207	2017-01-03	"Tue"	"Evening"	"388"	3	8	8	19
14206	2017-01-03	"Tue"	"Midday"	"780"	7	8	0	15
14205	2017-01-02	"Mon"	"Evening"	"177"	1	7	7	15
14204	2017-01-02	"Mon"	"Midday"	"622"	6	2	2	10
14203	2017-01-01	"Sun"	"Evening"	"280"	2	8	0	10
14202	2017-01-01	"Sun"	"Midday"	"112"	1	1	2	4
14201	2016-12-31	"Sat"	"Evening"	"071"	0	7	1	8
14200	2016-12-31	"Sat"	"Midday"	"404"	4	0	4	8
14199	2016-12-30	"Fri"	"Evening"	"575"	5	7	5	17
14198	2016-12-30	"Fri"	"Midday"	"436"	4	3	6	13
14197	2016-12-29	"Thu"	"Evening"	"685"	6	8	5	19
14196	2016-12-29	"Thu"	"Midday"	"491"	4	9	1	14
14195	2016-12-28	"Wed"	"Evening"	"958"	9	5	8	22
14194	2016-12-28	"Wed"	"Midday"	"283"	2	8	3	13
14193	2016-12-27	"Tue"	"Evening"	"545"	5	4	5	14
14192	2016-12-27	"Tue"	"Midday"	"698"	6	9	8	23
14191	2016-12-26	"Mon"	"Evening"	"389"	3	8	9	20
14190	2016-12-26	"Mon"	"Midday"	"569"	5	6	9	20
14189	2016-12-25	"Sun"	"Evening"	"679"	6	7	9	22
14188	2016-12-25	"Sun"	"Midday"	"756"	7	5	6	18
14187	2016-12-24	"Sat"	"Evening"	"572"	5	7	2	14
14186	2016-12-24	"Sat"	"Midday"	"274"	2	7	4	13
14185	2016-12-23	"Fri"	"Evening"	"214"	2	1	4	7
14184	2016-12-23	"Fri"	"Midday"	"957"	9	5	7	21
14183	2016-12-22	"Thu"	"Evening"	"421"	4	2	1	7
14182	2016-12-22	"Thu"	"Midday"	"978"	9	7	8	24
14181	2016-12-21	"Wed"	"Evening"	"891"	8	9	1	18
14180	2016-12-21	"Wed"	"Midday"	"728"	7	2	8	17
14179	2016-12-20	"Tue"	"Evening"	"332"	3	3	2	8
14178	2016-12-20	"Tue"	"Midday"	"933"	9	3	3	15
14177	2016-12-19	"Mon"	"Evening"	"094"	0	9	4	13
14176	2016-12-19	"Mon"	"Midday"	"718"	7	1	8	16
14175	2016-12-18	"Sun"	"Evening"	"449"	4	4	9	17
14174	2016-12-18	"Sun"	"Midday"	"376"	3	7	6	16
14173	2016-12-17	"Sat"	"Evening"	"778"	7	7	8	22
14172	2016-12-17	"Sat"	"Midday"	"228"	2	2	8	12
14171	2016-12-16	"Fri"	"Evening"	"680"	6	8	0	14
14170	2016-12-16	"Fri"	"Midday"	"164"	1	6	4	11
14169	2016-12-15	"Thu"	"Evening"	"006"	0	0	6	6
14168	2016-12-15	"Thu"	"Midday"	"834"	8	3	4	15
14167	2016-12-14	"Wed"	"Evening"	"731"	7	3	1	11
14166	2016-12-14	"Wed"	"Midday"	"882"	8	8	2	18
14165	2016-12-13	"Tue"	"Evening"	"832"	8	3	2	13
14164	2016-12-13	"Tue"	"Midday"	"516"	5	1	6	12
14163	2016-12-12	"Mon"	"Evening"	"762"	7	6	2	15
14162	2016-12-12	"Mon"	"Midday"	"439"	4	3	9	16
14161	2016-12-11	"Sun"	"Evening"	"991"	9	9	1	19
14160	2016-12-11	"Sun"	"Midday"	"826"	8	2	6	16
14159	2016-12-10	"Sat"	"Evening"	"091"	0	9	1	10
14158	2016-12-10	"Sat"	"Midday"	"132"	1	3	2	6
14157	2016-12-09	"Fri"	"Evening"	"992"	9	9	2	20
14156	2016-12-09	"Fri"	"Midday"	"842"	8	4	2	14
14155	2016-12-08	"Thu"	"Evening"	"469"	4	6	9	19
14154	2016-12-08	"Thu"	"Midday"	"636"	6	3	6	15
14153	2016-12-07	"Wed"	"Evening"	"840"	8	4	0	12
14152	2016-12-07	"Wed"	"Midday"	"990"	9	9	0	18
14151	2016-12-06	"Tue"	"Evening"	"061"	0	6	1	7
14150	2016-12-06	"Tue"	"Midday"	"683"	6	8	3	17
14149	2016-12-05	"Mon"	"Evening"	"273"	2	7	3	12
14148	2016-12-05	"Mon"	"Midday"	"527"	5	2	7	14
14147	2016-12-04	"Sun"	"Evening"	"741"	7	4	1	12
14146	2016-12-04	"Sun"	"Midday"	"343"	3	4	3	10
14145	2016-12-03	"Sat"	"Evening"	"006"	0	0	6	6
14144	2016-12-03	"Sat"	"Midday"	"397"	3	9	7	19
14143	2016-12-02	"Fri"	"Evening"	"579"	5	7	9	21
14142	2016-12-02	"Fri"	"Midday"	"305"	3	0	5	8
14141	2016-12-01	"Thu"	"Evening"	"278"	2	7	8	17
14140	2016-12-01	"Thu"	"Midday"	"043"	0	4	3	7
14139	2016-11-30	"Wed"	"Evening"	"581"	5	8	1	14
14138	2016-11-30	"Wed"	"Midday"	"289"	2	8	9	19
14137	2016-11-29	"Tue"	"Evening"	"188"	1	8	8	17
14136	2016-11-29	"Tue"	"Midday"	"399"	3	9	9	21
14135	2016-11-28	"Mon"	"Evening"	"458"	4	5	8	17
14134	2016-11-28	"Mon"	"Midday"	"640"	6	4	0	10
14133	2016-11-27	"Sun"	"Evening"	"726"	7	2	6	15
14132	2016-11-27	"Sun"	"Midday"	"424"	4	2	4	10
14131	2016-11-26	"Sat"	"Evening"	"803"	8	0	3	11
14130	2016-11-26	"Sat"	"Midday"	"197"	1	9	7	17
14129	2016-11-25	"Fri"	"Evening"	"891"	8	9	1	18
14128	2016-11-25	"Fri"	"Midday"	"990"	9	9	0	18
14127	2016-11-24	"Thu"	"Evening"	"388"	3	8	8	19
14126	2016-11-24	"Thu"	"Midday"	"778"	7	7	8	22
14125	2016-11-23	"Wed"	"Evening"	"906"	9	0	6	15
14124	2016-11-23	"Wed"	"Midday"	"589"	5	8	9	22
14123	2016-11-22	"Tue"	"Evening"	"518"	5	1	8	14
14122	2016-11-22	"Tue"	"Midday"	"156"	1	5	6	12
14121	2016-11-21	"Mon"	"Evening"	"809"	8	0	9	17
14120	2016-11-21	"Mon"	"Midday"	"192"	1	9	2	12
14119	2016-11-20	"Sun"	"Evening"	"602"	6	0	2	8
14118	2016-11-20	"Sun"	"Midday"	"490"	4	9	0	13
14117	2016-11-19	"Sat"	"Evening"	"033"	0	3	3	6
14116	2016-11-19	"Sat"	"Midday"	"093"	0	9	3	12
14115	2016-11-18	"Fri"	"Evening"	"251"	2	5	1	8
14114	2016-11-18	"Fri"	"Midday"	"407"	4	0	7	11
14113	2016-11-17	"Thu"	"Evening"	"867"	8	6	7	21
14112	2016-11-17	"Thu"	"Midday"	"132"	1	3	2	6
14111	2016-11-16	"Wed"	"Evening"	"443"	4	4	3	11
14110	2016-11-16	"Wed"	"Midday"	"948"	9	4	8	21
14109	2016-11-15	"Tue"	"Evening"	"575"	5	7	5	17
14108	2016-11-15	"Tue"	"Midday"	"768"	7	6	8	21
14107	2016-11-14	"Mon"	"Evening"	"084"	0	8	4	12
14106	2016-11-14	"Mon"	"Midday"	"747"	7	4	7	18
14105	2016-11-13	"Sun"	"Evening"	"777"	7	7	7	21
14104	2016-11-13	"Sun"	"Midday"	"150"	1	5	0	6
14103	2016-11-12	"Sat"	"Evening"	"675"	6	7	5	18
14102	2016-11-12	"Sat"	"Midday"	"802"	8	0	2	10
14101	2016-11-11	"Fri"	"Evening"	"410"	4	1	0	5
14100	2016-11-11	"Fri"	"Midday"	"240"	2	4	0	6
14099	2016-11-10	"Thu"	"Evening"	"418"	4	1	8	13
14098	2016-11-10	"Thu"	"Midday"	"931"	9	3	1	13
14097	2016-11-09	"Wed"	"Evening"	"345"	3	4	5	12
14096	2016-11-09	"Wed"	"Midday"	"489"	4	8	9	21
14095	2016-11-08	"Tue"	"Evening"	"326"	3	2	6	11
14094	2016-11-08	"Tue"	"Midday"	"442"	4	4	2	10
14093	2016-11-07	"Mon"	"Evening"	"919"	9	1	9	19
14092	2016-11-07	"Mon"	"Midday"	"792"	7	9	2	18
14091	2016-11-06	"Sun"	"Evening"	"821"	8	2	1	11
14090	2016-11-06	"Sun"	"Midday"	"158"	1	5	8	14
14089	2016-11-05	"Sat"	"Evening"	"830"	8	3	0	11
14088	2016-11-05	"Sat"	"Midday"	"461"	4	6	1	11
14087	2016-11-04	"Fri"	"Evening"	"179"	1	7	9	17
14086	2016-11-04	"Fri"	"Midday"	"247"	2	4	7	13
14085	2016-11-03	"Thu"	"Evening"	"838"	8	3	8	19
14084	2016-11-03	"Thu"	"Midday"	"948"	9	4	8	21
14083	2016-11-02	"Wed"	"Evening"	"480"	4	8	0	12
14082	2016-11-02	"Wed"	"Midday"	"695"	6	9	5	20
14081	2016-11-01	"Tue"	"Evening"	"860"	8	6	0	14
14080	2016-11-01	"Tue"	"Midday"	"675"	6	7	5	18
14079	2016-10-31	"Mon"	"Evening"	"871"	8	7	1	16
14078	2016-10-31	"Mon"	"Midday"	"203"	2	0	3	5
14077	2016-10-30	"Sun"	"Evening"	"527"	5	2	7	14
14076	2016-10-30	"Sun"	"Midday"	"992"	9	9	2	20
14075	2016-10-29	"Sat"	"Evening"	"742"	7	4	2	13
14074	2016-10-29	"Sat"	"Midday"	"903"	9	0	3	12
14073	2016-10-28	"Fri"	"Evening"	"237"	2	3	7	12
14072	2016-10-28	"Fri"	"Midday"	"303"	3	0	3	6
14071	2016-10-27	"Thu"	"Evening"	"877"	8	7	7	22
14070	2016-10-27	"Thu"	"Midday"	"644"	6	4	4	14
14069	2016-10-26	"Wed"	"Evening"	"776"	7	7	6	20
14068	2016-10-26	"Wed"	"Midday"	"343"	3	4	3	10
14067	2016-10-25	"Tue"	"Evening"	"118"	1	1	8	10
14066	2016-10-25	"Tue"	"Midday"	"430"	4	3	0	7
14065	2016-10-24	"Mon"	"Evening"	"358"	3	5	8	16
14064	2016-10-24	"Mon"	"Midday"	"589"	5	8	9	22
14063	2016-10-23	"Sun"	"Evening"	"855"	8	5	5	18
14062	2016-10-23	"Sun"	"Midday"	"882"	8	8	2	18
14061	2016-10-22	"Sat"	"Evening"	"637"	6	3	7	16
14060	2016-10-22	"Sat"	"Midday"	"150"	1	5	0	6
14059	2016-10-21	"Fri"	"Evening"	"504"	5	0	4	9
14058	2016-10-21	"Fri"	"Midday"	"886"	8	8	6	22
14057	2016-10-20	"Thu"	"Evening"	"605"	6	0	5	11
14056	2016-10-20	"Thu"	"Midday"	"504"	5	0	4	9
14055	2016-10-19	"Wed"	"Evening"	"860"	8	6	0	14
14054	2016-10-19	"Wed"	"Midday"	"345"	3	4	5	12
14053	2016-10-18	"Tue"	"Evening"	"782"	7	8	2	17
14052	2016-10-18	"Tue"	"Midday"	"072"	0	7	2	9
14051	2016-10-17	"Mon"	"Evening"	"366"	3	6	6	15
14050	2016-10-17	"Mon"	"Midday"	"137"	1	3	7	11
14049	2016-10-16	"Sun"	"Evening"	"886"	8	8	6	22
14048	2016-10-16	"Sun"	"Midday"	"679"	6	7	9	22
14047	2016-10-15	"Sat"	"Evening"	"678"	6	7	8	21
14046	2016-10-15	"Sat"	"Midday"	"127"	1	2	7	10
14045	2016-10-14	"Fri"	"Evening"	"670"	6	7	0	13
14044	2016-10-14	"Fri"	"Midday"	"768"	7	6	8	21
14043	2016-10-13	"Thu"	"Evening"	"313"	3	1	3	7
14042	2016-10-13	"Thu"	"Midday"	"392"	3	9	2	14
14041	2016-10-12	"Wed"	"Evening"	"140"	1	4	0	5
14040	2016-10-12	"Wed"	"Midday"	"087"	0	8	7	15
14039	2016-10-11	"Tue"	"Evening"	"694"	6	9	4	19
14038	2016-10-11	"Tue"	"Midday"	"462"	4	6	2	12
14037	2016-10-10	"Mon"	"Evening"	"020"	0	2	0	2
14036	2016-10-10	"Mon"	"Midday"	"636"	6	3	6	15
14035	2016-10-09	"Sun"	"Evening"	"516"	5	1	6	12
14034	2016-10-09	"Sun"	"Midday"	"125"	1	2	5	8
14033	2016-10-08	"Sat"	"Evening"	"839"	8	3	9	20
14032	2016-10-08	"Sat"	"Midday"	"838"	8	3	8	19
14031	2016-10-07	"Fri"	"Evening"	"098"	0	9	8	17
14030	2016-10-07	"Fri"	"Midday"	"212"	2	1	2	5
14029	2016-10-06	"Thu"	"Evening"	"339"	3	3	9	15
14028	2016-10-06	"Thu"	"Midday"	"267"	2	6	7	15
14027	2016-10-05	"Wed"	"Evening"	"997"	9	9	7	25
14026	2016-10-05	"Wed"	"Midday"	"541"	5	4	1	10
14025	2016-10-04	"Tue"	"Evening"	"957"	9	5	7	21
14024	2016-10-04	"Tue"	"Midday"	"513"	5	1	3	9
14023	2016-10-03	"Mon"	"Evening"	"562"	5	6	2	13
14022	2016-10-03	"Mon"	"Midday"	"998"	9	9	8	26
14021	2016-10-02	"Sun"	"Evening"	"597"	5	9	7	21
14020	2016-10-02	"Sun"	"Midday"	"818"	8	1	8	17
14019	2016-10-01	"Sat"	"Evening"	"066"	0	6	6	12
14018	2016-10-01	"Sat"	"Midday"	"120"	1	2	0	3
14017	2016-09-30	"Fri"	"Evening"	"642"	6	4	2	12
14016	2016-09-30	"Fri"	"Midday"	"874"	8	7	4	19
14015	2016-09-29	"Thu"	"Evening"	"842"	8	4	2	14
14014	2016-09-29	"Thu"	"Midday"	"441"	4	4	1	9
14013	2016-09-28	"Wed"	"Evening"	"443"	4	4	3	11
14012	2016-09-28	"Wed"	"Midday"	"512"	5	1	2	8
14011	2016-09-27	"Tue"	"Evening"	"639"	6	3	9	18
14010	2016-09-27	"Tue"	"Midday"	"074"	0	7	4	11
14009	2016-09-26	"Mon"	"Evening"	"121"	1	2	1	4
14008	2016-09-26	"Mon"	"Midday"	"781"	7	8	1	16
14007	2016-09-25	"Sun"	"Evening"	"872"	8	7	2	17
14006	2016-09-25	"Sun"	"Midday"	"826"	8	2	6	16
14005	2016-09-24	"Sat"	"Evening"	"222"	2	2	2	6
14004	2016-09-24	"Sat"	"Midday"	"367"	3	6	7	16
14003	2016-09-23	"Fri"	"Evening"	"240"	2	4	0	6
14002	2016-09-23	"Fri"	"Midday"	"907"	9	0	7	16
14001	2016-09-22	"Thu"	"Evening"	"671"	6	7	1	14
14000	2016-09-22	"Thu"	"Midday"	"987"	9	8	7	24
13999	2016-09-21	"Wed"	"Evening"	"151"	1	5	1	7
13998	2016-09-21	"Wed"	"Midday"	"140"	1	4	0	5
13997	2016-09-20	"Tue"	"Evening"	"373"	3	7	3	13
13996	2016-09-20	"Tue"	"Midday"	"305"	3	0	5	8
13995	2016-09-19	"Mon"	"Evening"	"638"	6	3	8	17
13994	2016-09-19	"Mon"	"Midday"	"799"	7	9	9	25
13993	2016-09-18	"Sun"	"Evening"	"639"	6	3	9	18
13992	2016-09-18	"Sun"	"Midday"	"504"	5	0	4	9
13991	2016-09-17	"Sat"	"Evening"	"202"	2	0	2	4
13990	2016-09-17	"Sat"	"Midday"	"470"	4	7	0	11
13989	2016-09-16	"Fri"	"Evening"	"901"	9	0	1	10
13988	2016-09-16	"Fri"	"Midday"	"601"	6	0	1	7
13987	2016-09-15	"Thu"	"Evening"	"782"	7	8	2	17
13986	2016-09-15	"Thu"	"Midday"	"691"	6	9	1	16
13985	2016-09-14	"Wed"	"Evening"	"134"	1	3	4	8
13984	2016-09-14	"Wed"	"Midday"	"606"	6	0	6	12
13983	2016-09-13	"Tue"	"Evening"	"057"	0	5	7	12
13982	2016-09-13	"Tue"	"Midday"	"307"	3	0	7	10
13981	2016-09-12	"Mon"	"Evening"	"565"	5	6	5	16
13980	2016-09-12	"Mon"	"Midday"	"155"	1	5	5	11
13979	2016-09-11	"Sun"	"Evening"	"553"	5	5	3	13
13978	2016-09-11	"Sun"	"Midday"	"030"	0	3	0	3
13977	2016-09-10	"Sat"	"Evening"	"153"	1	5	3	9
13976	2016-09-10	"Sat"	"Midday"	"369"	3	6	9	18
13975	2016-09-09	"Fri"	"Evening"	"702"	7	0	2	9
13974	2016-09-09	"Fri"	"Midday"	"885"	8	8	5	21
13973	2016-09-08	"Thu"	"Evening"	"174"	1	7	4	12
13972	2016-09-08	"Thu"	"Midday"	"872"	8	7	2	17
13971	2016-09-07	"Wed"	"Evening"	"838"	8	3	8	19
13970	2016-09-07	"Wed"	"Midday"	"680"	6	8	0	14
13969	2016-09-06	"Tue"	"Evening"	"123"	1	2	3	6
13968	2016-09-06	"Tue"	"Midday"	"331"	3	3	1	7
13967	2016-09-05	"Mon"	"Evening"	"567"	5	6	7	18
13966	2016-09-05	"Mon"	"Midday"	"272"	2	7	2	11
13965	2016-09-04	"Sun"	"Evening"	"721"	7	2	1	10
13964	2016-09-04	"Sun"	"Midday"	"905"	9	0	5	14
13963	2016-09-03	"Sat"	"Evening"	"588"	5	8	8	21
13962	2016-09-03	"Sat"	"Midday"	"888"	8	8	8	24
13961	2016-09-02	"Fri"	"Evening"	"264"	2	6	4	12
13960	2016-09-02	"Fri"	"Midday"	"026"	0	2	6	8
13959	2016-09-01	"Thu"	"Evening"	"552"	5	5	2	12
13958	2016-09-01	"Thu"	"Midday"	"958"	9	5	8	22
13957	2016-08-31	"Wed"	"Evening"	"004"	0	0	4	4
13956	2016-08-31	"Wed"	"Midday"	"358"	3	5	8	16
13955	2016-08-30	"Tue"	"Evening"	"899"	8	9	9	26
13954	2016-08-30	"Tue"	"Midday"	"071"	0	7	1	8
13953	2016-08-29	"Mon"	"Evening"	"106"	1	0	6	7
13952	2016-08-29	"Mon"	"Midday"	"994"	9	9	4	22
13951	2016-08-28	"Sun"	"Evening"	"395"	3	9	5	17
13950	2016-08-28	"Sun"	"Midday"	"379"	3	7	9	19
13949	2016-08-27	"Sat"	"Evening"	"797"	7	9	7	23
13948	2016-08-27	"Sat"	"Midday"	"268"	2	6	8	16
13947	2016-08-26	"Fri"	"Evening"	"550"	5	5	0	10
13946	2016-08-26	"Fri"	"Midday"	"874"	8	7	4	19
13945	2016-08-25	"Thu"	"Evening"	"443"	4	4	3	11
13944	2016-08-25	"Thu"	"Midday"	"306"	3	0	6	9
13943	2016-08-24	"Wed"	"Evening"	"253"	2	5	3	10
13942	2016-08-24	"Wed"	"Midday"	"168"	1	6	8	15
13941	2016-08-23	"Tue"	"Evening"	"837"	8	3	7	18
13940	2016-08-23	"Tue"	"Midday"	"371"	3	7	1	11
13939	2016-08-22	"Mon"	"Evening"	"795"	7	9	5	21
13938	2016-08-22	"Mon"	"Midday"	"101"	1	0	1	2
13937	2016-08-21	"Sun"	"Evening"	"984"	9	8	4	21
13936	2016-08-21	"Sun"	"Midday"	"441"	4	4	1	9
13935	2016-08-20	"Sat"	"Evening"	"217"	2	1	7	10
13934	2016-08-20	"Sat"	"Midday"	"502"	5	0	2	7
13933	2016-08-19	"Fri"	"Evening"	"007"	0	0	7	7
13932	2016-08-19	"Fri"	"Midday"	"885"	8	8	5	21
13931	2016-08-18	"Thu"	"Evening"	"927"	9	2	7	18
13930	2016-08-18	"Thu"	"Midday"	"762"	7	6	2	15
13929	2016-08-17	"Wed"	"Evening"	"460"	4	6	0	10
13928	2016-08-17	"Wed"	"Midday"	"587"	5	8	7	20
13927	2016-08-16	"Tue"	"Evening"	"575"	5	7	5	17
13926	2016-08-16	"Tue"	"Midday"	"746"	7	4	6	17
13925	2016-08-15	"Mon"	"Evening"	"333"	3	3	3	9
13924	2016-08-15	"Mon"	"Midday"	"360"	3	6	0	9
13923	2016-08-14	"Sun"	"Evening"	"957"	9	5	7	21
13922	2016-08-14	"Sun"	"Midday"	"566"	5	6	6	17
13921	2016-08-13	"Sat"	"Evening"	"037"	0	3	7	10
13920	2016-08-13	"Sat"	"Midday"	"642"	6	4	2	12
13919	2016-08-12	"Fri"	"Evening"	"086"	0	8	6	14
13918	2016-08-12	"Fri"	"Midday"	"764"	7	6	4	17
13917	2016-08-11	"Thu"	"Evening"	"513"	5	1	3	9
13916	2016-08-11	"Thu"	"Midday"	"329"	3	2	9	14
13915	2016-08-10	"Wed"	"Evening"	"285"	2	8	5	15
13914	2016-08-10	"Wed"	"Midday"	"746"	7	4	6	17
13913	2016-08-09	"Tue"	"Evening"	"359"	3	5	9	17
13912	2016-08-09	"Tue"	"Midday"	"551"	5	5	1	11
13911	2016-08-08	"Mon"	"Evening"	"682"	6	8	2	16
13910	2016-08-08	"Mon"	"Midday"	"673"	6	7	3	16
13909	2016-08-07	"Sun"	"Evening"	"052"	0	5	2	7
13908	2016-08-07	"Sun"	"Midday"	"364"	3	6	4	13
13907	2016-08-06	"Sat"	"Evening"	"806"	8	0	6	14
13906	2016-08-06	"Sat"	"Midday"	"447"	4	4	7	15
13905	2016-08-05	"Fri"	"Evening"	"752"	7	5	2	14
13904	2016-08-05	"Fri"	"Midday"	"970"	9	7	0	16
13903	2016-08-04	"Thu"	"Evening"	"713"	7	1	3	11
13902	2016-08-04	"Thu"	"Midday"	"399"	3	9	9	21
13901	2016-08-03	"Wed"	"Evening"	"286"	2	8	6	16
13900	2016-08-03	"Wed"	"Midday"	"293"	2	9	3	14
13899	2016-08-02	"Tue"	"Evening"	"213"	2	1	3	6
13898	2016-08-02	"Tue"	"Midday"	"892"	8	9	2	19
13897	2016-08-01	"Mon"	"Evening"	"303"	3	0	3	6
13896	2016-08-01	"Mon"	"Midday"	"945"	9	4	5	18
13895	2016-07-31	"Sun"	"Evening"	"238"	2	3	8	13
13894	2016-07-31	"Sun"	"Midday"	"170"	1	7	0	8
13893	2016-07-30	"Sat"	"Evening"	"505"	5	0	5	10
13892	2016-07-30	"Sat"	"Midday"	"447"	4	4	7	15
13891	2016-07-29	"Fri"	"Evening"	"735"	7	3	5	15
13890	2016-07-29	"Fri"	"Midday"	"581"	5	8	1	14
13889	2016-07-28	"Thu"	"Evening"	"993"	9	9	3	21
13888	2016-07-28	"Thu"	"Midday"	"492"	4	9	2	15
13887	2016-07-27	"Wed"	"Evening"	"753"	7	5	3	15
13886	2016-07-27	"Wed"	"Midday"	"445"	4	4	5	13
13885	2016-07-26	"Tue"	"Evening"	"151"	1	5	1	7
13884	2016-07-26	"Tue"	"Midday"	"820"	8	2	0	10
13883	2016-07-25	"Mon"	"Evening"	"515"	5	1	5	11
13882	2016-07-25	"Mon"	"Midday"	"030"	0	3	0	3
13881	2016-07-24	"Sun"	"Evening"	"335"	3	3	5	11
13880	2016-07-24	"Sun"	"Midday"	"852"	8	5	2	15
13879	2016-07-23	"Sat"	"Evening"	"990"	9	9	0	18
13878	2016-07-23	"Sat"	"Midday"	"344"	3	4	4	11
13877	2016-07-22	"Fri"	"Evening"	"336"	3	3	6	12
13876	2016-07-22	"Fri"	"Midday"	"607"	6	0	7	13
13875	2016-07-21	"Thu"	"Evening"	"278"	2	7	8	17
13874	2016-07-21	"Thu"	"Midday"	"063"	0	6	3	9
13873	2016-07-20	"Wed"	"Evening"	"438"	4	3	8	15
13872	2016-07-20	"Wed"	"Midday"	"297"	2	9	7	18
13871	2016-07-19	"Tue"	"Evening"	"415"	4	1	5	10
13870	2016-07-19	"Tue"	"Midday"	"190"	1	9	0	10
13869	2016-07-18	"Mon"	"Evening"	"096"	0	9	6	15
13868	2016-07-18	"Mon"	"Midday"	"978"	9	7	8	24
13867	2016-07-17	"Sun"	"Evening"	"942"	9	4	2	15
13866	2016-07-17	"Sun"	"Midday"	"865"	8	6	5	19
13865	2016-07-16	"Sat"	"Evening"	"607"	6	0	7	13
13864	2016-07-16	"Sat"	"Midday"	"449"	4	4	9	17
13863	2016-07-15	"Fri"	"Evening"	"439"	4	3	9	16
13862	2016-07-15	"Fri"	"Midday"	"108"	1	0	8	9
13861	2016-07-14	"Thu"	"Evening"	"125"	1	2	5	8
13860	2016-07-14	"Thu"	"Midday"	"671"	6	7	1	14
13859	2016-07-13	"Wed"	"Evening"	"997"	9	9	7	25
13858	2016-07-13	"Wed"	"Midday"	"677"	6	7	7	20
13857	2016-07-12	"Tue"	"Evening"	"750"	7	5	0	12
13856	2016-07-12	"Tue"	"Midday"	"086"	0	8	6	14
13855	2016-07-11	"Mon"	"Evening"	"535"	5	3	5	13
13854	2016-07-11	"Mon"	"Midday"	"493"	4	9	3	16
13853	2016-07-10	"Sun"	"Evening"	"441"	4	4	1	9
13852	2016-07-10	"Sun"	"Midday"	"943"	9	4	3	16
13851	2016-07-09	"Sat"	"Evening"	"897"	8	9	7	24
13850	2016-07-09	"Sat"	"Midday"	"928"	9	2	8	19
13849	2016-07-08	"Fri"	"Evening"	"141"	1	4	1	6
13848	2016-07-08	"Fri"	"Midday"	"368"	3	6	8	17
13847	2016-07-07	"Thu"	"Evening"	"332"	3	3	2	8
13846	2016-07-07	"Thu"	"Midday"	"763"	7	6	3	16
13845	2016-07-06	"Wed"	"Evening"	"340"	3	4	0	7
13844	2016-07-06	"Wed"	"Midday"	"791"	7	9	1	17
13843	2016-07-05	"Tue"	"Evening"	"572"	5	7	2	14
13842	2016-07-05	"Tue"	"Midday"	"823"	8	2	3	13
13841	2016-07-04	"Mon"	"Evening"	"442"	4	4	2	10
13840	2016-07-04	"Mon"	"Midday"	"629"	6	2	9	17
13839	2016-07-03	"Sun"	"Evening"	"422"	4	2	2	8
13838	2016-07-03	"Sun"	"Midday"	"026"	0	2	6	8
13837	2016-07-02	"Sat"	"Evening"	"585"	5	8	5	18
13836	2016-07-02	"Sat"	"Midday"	"935"	9	3	5	17
13835	2016-07-01	"Fri"	"Evening"	"602"	6	0	2	8
13834	2016-07-01	"Fri"	"Midday"	"775"	7	7	5	19
13833	2016-06-30	"Thu"	"Evening"	"886"	8	8	6	22
13832	2016-06-30	"Thu"	"Midday"	"473"	4	7	3	14
13831	2016-06-29	"Wed"	"Evening"	"554"	5	5	4	14
13830	2016-06-29	"Wed"	"Midday"	"866"	8	6	6	20
13829	2016-06-28	"Tue"	"Evening"	"526"	5	2	6	13
13828	2016-06-28	"Tue"	"Midday"	"630"	6	3	0	9
13827	2016-06-27	"Mon"	"Evening"	"064"	0	6	4	10
13826	2016-06-27	"Mon"	"Midday"	"988"	9	8	8	25
13825	2016-06-26	"Sun"	"Evening"	"818"	8	1	8	17
13824	2016-06-26	"Sun"	"Midday"	"957"	9	5	7	21
13823	2016-06-25	"Sat"	"Evening"	"184"	1	8	4	13
13822	2016-06-25	"Sat"	"Midday"	"102"	1	0	2	3
13821	2016-06-24	"Fri"	"Evening"	"301"	3	0	1	4
13820	2016-06-24	"Fri"	"Midday"	"626"	6	2	6	14
13819	2016-06-23	"Thu"	"Evening"	"853"	8	5	3	16
13818	2016-06-23	"Thu"	"Midday"	"937"	9	3	7	19
13817	2016-06-22	"Wed"	"Evening"	"221"	2	2	1	5
13816	2016-06-22	"Wed"	"Midday"	"494"	4	9	4	17
13815	2016-06-21	"Tue"	"Evening"	"520"	5	2	0	7
13814	2016-06-21	"Tue"	"Midday"	"032"	0	3	2	5
13813	2016-06-20	"Mon"	"Evening"	"844"	8	4	4	16
13812	2016-06-20	"Mon"	"Midday"	"817"	8	1	7	16
13811	2016-06-19	"Sun"	"Evening"	"488"	4	8	8	20
13810	2016-06-19	"Sun"	"Midday"	"815"	8	1	5	14
13809	2016-06-18	"Sat"	"Evening"	"568"	5	6	8	19
13808	2016-06-18	"Sat"	"Midday"	"917"	9	1	7	17
13807	2016-06-17	"Fri"	"Evening"	"733"	7	3	3	13
13806	2016-06-17	"Fri"	"Midday"	"130"	1	3	0	4
13805	2016-06-16	"Thu"	"Evening"	"804"	8	0	4	12
13804	2016-06-16	"Thu"	"Midday"	"214"	2	1	4	7
13803	2016-06-15	"Wed"	"Evening"	"018"	0	1	8	9
13802	2016-06-15	"Wed"	"Midday"	"856"	8	5	6	19
13801	2016-06-14	"Tue"	"Evening"	"121"	1	2	1	4
13800	2016-06-14	"Tue"	"Midday"	"161"	1	6	1	8
13799	2016-06-13	"Mon"	"Evening"	"299"	2	9	9	20
13798	2016-06-13	"Mon"	"Midday"	"170"	1	7	0	8
13797	2016-06-12	"Sun"	"Evening"	"664"	6	6	4	16
13796	2016-06-12	"Sun"	"Midday"	"154"	1	5	4	10
13795	2016-06-11	"Sat"	"Evening"	"261"	2	6	1	9
13794	2016-06-11	"Sat"	"Midday"	"107"	1	0	7	8
13793	2016-06-10	"Fri"	"Evening"	"866"	8	6	6	20
13792	2016-06-10	"Fri"	"Midday"	"310"	3	1	0	4
13791	2016-06-09	"Thu"	"Evening"	"995"	9	9	5	23
13790	2016-06-09	"Thu"	"Midday"	"793"	7	9	3	19
13789	2016-06-08	"Wed"	"Evening"	"531"	5	3	1	9
13788	2016-06-08	"Wed"	"Midday"	"405"	4	0	5	9
13787	2016-06-07	"Tue"	"Evening"	"396"	3	9	6	18
13786	2016-06-07	"Tue"	"Midday"	"564"	5	6	4	15
13785	2016-06-06	"Mon"	"Evening"	"617"	6	1	7	14
13784	2016-06-06	"Mon"	"Midday"	"572"	5	7	2	14
13783	2016-06-05	"Sun"	"Evening"	"645"	6	4	5	15
13782	2016-06-05	"Sun"	"Midday"	"841"	8	4	1	13
13781	2016-06-04	"Sat"	"Evening"	"130"	1	3	0	4
13780	2016-06-04	"Sat"	"Midday"	"009"	0	0	9	9
13779	2016-06-03	"Fri"	"Evening"	"037"	0	3	7	10
13778	2016-06-03	"Fri"	"Midday"	"428"	4	2	8	14
13777	2016-06-02	"Thu"	"Evening"	"414"	4	1	4	9
13776	2016-06-02	"Thu"	"Midday"	"143"	1	4	3	8
13775	2016-06-01	"Wed"	"Evening"	"133"	1	3	3	7
13774	2016-06-01	"Wed"	"Midday"	"658"	6	5	8	19
13773	2016-05-31	"Tue"	"Evening"	"152"	1	5	2	8
13772	2016-05-31	"Tue"	"Midday"	"670"	6	7	0	13
13771	2016-05-30	"Mon"	"Evening"	"528"	5	2	8	15
13770	2016-05-30	"Mon"	"Midday"	"399"	3	9	9	21
13769	2016-05-29	"Sun"	"Evening"	"598"	5	9	8	22
13768	2016-05-29	"Sun"	"Midday"	"325"	3	2	5	10
13767	2016-05-28	"Sat"	"Evening"	"820"	8	2	0	10
13766	2016-05-28	"Sat"	"Midday"	"145"	1	4	5	10
13765	2016-05-27	"Fri"	"Evening"	"595"	5	9	5	19
13764	2016-05-27	"Fri"	"Midday"	"424"	4	2	4	10
13763	2016-05-26	"Thu"	"Evening"	"780"	7	8	0	15
13762	2016-05-26	"Thu"	"Midday"	"562"	5	6	2	13
13761	2016-05-25	"Wed"	"Evening"	"024"	0	2	4	6
13760	2016-05-25	"Wed"	"Midday"	"267"	2	6	7	15
13759	2016-05-24	"Tue"	"Evening"	"645"	6	4	5	15
13758	2016-05-24	"Tue"	"Midday"	"813"	8	1	3	12
13757	2016-05-23	"Mon"	"Evening"	"109"	1	0	9	10
13756	2016-05-23	"Mon"	"Midday"	"155"	1	5	5	11
13755	2016-05-22	"Sun"	"Evening"	"288"	2	8	8	18
13754	2016-05-22	"Sun"	"Midday"	"463"	4	6	3	13
13753	2016-05-21	"Sat"	"Evening"	"453"	4	5	3	12
13752	2016-05-21	"Sat"	"Midday"	"439"	4	3	9	16
13751	2016-05-20	"Fri"	"Evening"	"623"	6	2	3	11
13750	2016-05-20	"Fri"	"Midday"	"460"	4	6	0	10
13749	2016-05-19	"Thu"	"Evening"	"946"	9	4	6	19
13748	2016-05-19	"Thu"	"Midday"	"103"	1	0	3	4
13747	2016-05-18	"Wed"	"Evening"	"653"	6	5	3	14
13746	2016-05-18	"Wed"	"Midday"	"035"	0	3	5	8
13745	2016-05-17	"Tue"	"Evening"	"102"	1	0	2	3
13744	2016-05-17	"Tue"	"Midday"	"584"	5	8	4	17
13743	2016-05-16	"Mon"	"Evening"	"319"	3	1	9	13
13742	2016-05-16	"Mon"	"Midday"	"047"	0	4	7	11
13741	2016-05-15	"Sun"	"Evening"	"171"	1	7	1	9
13740	2016-05-15	"Sun"	"Midday"	"114"	1	1	4	6
13739	2016-05-14	"Sat"	"Evening"	"939"	9	3	9	21
13738	2016-05-14	"Sat"	"Midday"	"343"	3	4	3	10
13737	2016-05-13	"Fri"	"Evening"	"653"	6	5	3	14
13736	2016-05-13	"Fri"	"Midday"	"205"	2	0	5	7
13735	2016-05-12	"Thu"	"Evening"	"431"	4	3	1	8
13734	2016-05-12	"Thu"	"Midday"	"119"	1	1	9	11
13733	2016-05-11	"Wed"	"Evening"	"663"	6	6	3	15
13732	2016-05-11	"Wed"	"Midday"	"056"	0	5	6	11
13731	2016-05-10	"Tue"	"Evening"	"595"	5	9	5	19
13730	2016-05-10	"Tue"	"Midday"	"297"	2	9	7	18
13729	2016-05-09	"Mon"	"Evening"	"285"	2	8	5	15
13728	2016-05-09	"Mon"	"Midday"	"965"	9	6	5	20
13727	2016-05-08	"Sun"	"Evening"	"370"	3	7	0	10
13726	2016-05-08	"Sun"	"Midday"	"325"	3	2	5	10
13725	2016-05-07	"Sat"	"Evening"	"929"	9	2	9	20
13724	2016-05-07	"Sat"	"Midday"	"130"	1	3	0	4
13723	2016-05-06	"Fri"	"Evening"	"971"	9	7	1	17
13722	2016-05-06	"Fri"	"Midday"	"105"	1	0	5	6
13721	2016-05-05	"Thu"	"Evening"	"681"	6	8	1	15
13720	2016-05-05	"Thu"	"Midday"	"914"	9	1	4	14
13719	2016-05-04	"Wed"	"Evening"	"151"	1	5	1	7
13718	2016-05-04	"Wed"	"Midday"	"977"	9	7	7	23
13717	2016-05-03	"Tue"	"Evening"	"873"	8	7	3	18
13716	2016-05-03	"Tue"	"Midday"	"014"	0	1	4	5
13715	2016-05-02	"Mon"	"Evening"	"853"	8	5	3	16
13714	2016-05-02	"Mon"	"Midday"	"770"	7	7	0	14
13713	2016-05-01	"Sun"	"Evening"	"614"	6	1	4	11
13712	2016-05-01	"Sun"	"Midday"	"565"	5	6	5	16
13711	2016-04-30	"Sat"	"Evening"	"895"	8	9	5	22
13710	2016-04-30	"Sat"	"Midday"	"068"	0	6	8	14
13709	2016-04-29	"Fri"	"Evening"	"002"	0	0	2	2
13708	2016-04-29	"Fri"	"Midday"	"680"	6	8	0	14
13707	2016-04-28	"Thu"	"Evening"	"088"	0	8	8	16
13706	2016-04-28	"Thu"	"Midday"	"153"	1	5	3	9
13705	2016-04-27	"Wed"	"Evening"	"582"	5	8	2	15
13704	2016-04-27	"Wed"	"Midday"	"499"	4	9	9	22
13703	2016-04-26	"Tue"	"Evening"	"303"	3	0	3	6
13702	2016-04-26	"Tue"	"Midday"	"193"	1	9	3	13
13701	2016-04-25	"Mon"	"Evening"	"105"	1	0	5	6
13700	2016-04-25	"Mon"	"Midday"	"913"	9	1	3	13
13699	2016-04-24	"Sun"	"Evening"	"804"	8	0	4	12
13698	2016-04-24	"Sun"	"Midday"	"459"	4	5	9	18
13697	2016-04-23	"Sat"	"Evening"	"458"	4	5	8	17
13696	2016-04-23	"Sat"	"Midday"	"512"	5	1	2	8
13695	2016-04-22	"Fri"	"Evening"	"069"	0	6	9	15
13694	2016-04-22	"Fri"	"Midday"	"857"	8	5	7	20
13693	2016-04-21	"Thu"	"Evening"	"623"	6	2	3	11
13692	2016-04-21	"Thu"	"Midday"	"392"	3	9	2	14
13691	2016-04-20	"Wed"	"Evening"	"848"	8	4	8	20
13690	2016-04-20	"Wed"	"Midday"	"479"	4	7	9	20
13689	2016-04-19	"Tue"	"Evening"	"967"	9	6	7	22
13688	2016-04-19	"Tue"	"Midday"	"980"	9	8	0	17
13687	2016-04-18	"Mon"	"Evening"	"081"	0	8	1	9
13686	2016-04-18	"Mon"	"Midday"	"622"	6	2	2	10
13685	2016-04-17	"Sun"	"Evening"	"454"	4	5	4	13
13684	2016-04-17	"Sun"	"Midday"	"885"	8	8	5	21
13683	2016-04-16	"Sat"	"Evening"	"718"	7	1	8	16
13682	2016-04-16	"Sat"	"Midday"	"952"	9	5	2	16
13681	2016-04-15	"Fri"	"Evening"	"851"	8	5	1	14
13680	2016-04-15	"Fri"	"Midday"	"458"	4	5	8	17
13679	2016-04-14	"Thu"	"Evening"	"699"	6	9	9	24
13678	2016-04-14	"Thu"	"Midday"	"019"	0	1	9	10
13677	2016-04-13	"Wed"	"Evening"	"492"	4	9	2	15
13676	2016-04-13	"Wed"	"Midday"	"890"	8	9	0	17
13675	2016-04-12	"Tue"	"Evening"	"240"	2	4	0	6
13674	2016-04-12	"Tue"	"Midday"	"589"	5	8	9	22
13673	2016-04-11	"Mon"	"Evening"	"977"	9	7	7	23
13672	2016-04-11	"Mon"	"Midday"	"149"	1	4	9	14
13671	2016-04-10	"Sun"	"Evening"	"115"	1	1	5	7
13670	2016-04-10	"Sun"	"Midday"	"956"	9	5	6	20
13669	2016-04-09	"Sat"	"Evening"	"960"	9	6	0	15
13668	2016-04-09	"Sat"	"Midday"	"356"	3	5	6	14
13667	2016-04-08	"Fri"	"Evening"	"008"	0	0	8	8
13666	2016-04-08	"Fri"	"Midday"	"978"	9	7	8	24
13665	2016-04-07	"Thu"	"Evening"	"972"	9	7	2	18
13664	2016-04-07	"Thu"	"Midday"	"271"	2	7	1	10
13663	2016-04-06	"Wed"	"Evening"	"237"	2	3	7	12
13662	2016-04-06	"Wed"	"Midday"	"536"	5	3	6	14
13661	2016-04-05	"Tue"	"Evening"	"820"	8	2	0	10
13660	2016-04-05	"Tue"	"Midday"	"228"	2	2	8	12
13659	2016-04-04	"Mon"	"Evening"	"729"	7	2	9	18
13658	2016-04-04	"Mon"	"Midday"	"959"	9	5	9	23
13657	2016-04-03	"Sun"	"Evening"	"695"	6	9	5	20
13656	2016-04-03	"Sun"	"Midday"	"262"	2	6	2	10
13655	2016-04-02	"Sat"	"Evening"	"029"	0	2	9	11
13654	2016-04-02	"Sat"	"Midday"	"757"	7	5	7	19
13653	2016-04-01	"Fri"	"Evening"	"549"	5	4	9	18
13652	2016-04-01	"Fri"	"Midday"	"815"	8	1	5	14
13651	2016-03-31	"Thu"	"Evening"	"885"	8	8	5	21
13650	2016-03-31	"Thu"	"Midday"	"164"	1	6	4	11
13649	2016-03-30	"Wed"	"Evening"	"631"	6	3	1	10
13648	2016-03-30	"Wed"	"Midday"	"760"	7	6	0	13
13647	2016-03-29	"Tue"	"Evening"	"493"	4	9	3	16
13646	2016-03-29	"Tue"	"Midday"	"198"	1	9	8	18
13645	2016-03-28	"Mon"	"Evening"	"215"	2	1	5	8
13644	2016-03-28	"Mon"	"Midday"	"062"	0	6	2	8
13643	2016-03-27	"Sun"	"Evening"	"223"	2	2	3	7
13642	2016-03-27	"Sun"	"Midday"	"012"	0	1	2	3
13641	2016-03-26	"Sat"	"Evening"	"609"	6	0	9	15
13640	2016-03-26	"Sat"	"Midday"	"782"	7	8	2	17
13639	2016-03-25	"Fri"	"Evening"	"471"	4	7	1	12
13638	2016-03-25	"Fri"	"Midday"	"597"	5	9	7	21
13637	2016-03-24	"Thu"	"Evening"	"402"	4	0	2	6
13636	2016-03-24	"Thu"	"Midday"	"332"	3	3	2	8
13635	2016-03-23	"Wed"	"Evening"	"241"	2	4	1	7
13634	2016-03-23	"Wed"	"Midday"	"594"	5	9	4	18
13633	2016-03-22	"Tue"	"Evening"	"986"	9	8	6	23
13632	2016-03-22	"Tue"	"Midday"	"275"	2	7	5	14
13631	2016-03-21	"Mon"	"Evening"	"973"	9	7	3	19
13630	2016-03-21	"Mon"	"Midday"	"760"	7	6	0	13
13629	2016-03-20	"Sun"	"Evening"	"047"	0	4	7	11
13628	2016-03-20	"Sun"	"Midday"	"057"	0	5	7	12
13627	2016-03-19	"Sat"	"Evening"	"707"	7	0	7	14
13626	2016-03-19	"Sat"	"Midday"	"224"	2	2	4	8
13625	2016-03-18	"Fri"	"Evening"	"829"	8	2	9	19
13624	2016-03-18	"Fri"	"Midday"	"283"	2	8	3	13
13623	2016-03-17	"Thu"	"Evening"	"245"	2	4	5	11
13622	2016-03-17	"Thu"	"Midday"	"160"	1	6	0	7
13621	2016-03-16	"Wed"	"Evening"	"181"	1	8	1	10
13620	2016-03-16	"Wed"	"Midday"	"854"	8	5	4	17
13619	2016-03-15	"Tue"	"Evening"	"209"	2	0	9	11
13618	2016-03-15	"Tue"	"Midday"	"734"	7	3	4	14
13617	2016-03-14	"Mon"	"Evening"	"781"	7	8	1	16
13616	2016-03-14	"Mon"	"Midday"	"801"	8	0	1	9
13615	2016-03-13	"Sun"	"Evening"	"267"	2	6	7	15
13614	2016-03-13	"Sun"	"Midday"	"527"	5	2	7	14
13613	2016-03-12	"Sat"	"Evening"	"362"	3	6	2	11
13612	2016-03-12	"Sat"	"Midday"	"730"	7	3	0	10
13611	2016-03-11	"Fri"	"Evening"	"328"	3	2	8	13
13610	2016-03-11	"Fri"	"Midday"	"708"	7	0	8	15
13609	2016-03-10	"Thu"	"Evening"	"067"	0	6	7	13
13608	2016-03-10	"Thu"	"Midday"	"082"	0	8	2	10
13607	2016-03-09	"Wed"	"Evening"	"435"	4	3	5	12
13606	2016-03-09	"Wed"	"Midday"	"750"	7	5	0	12
13605	2016-03-08	"Tue"	"Evening"	"101"	1	0	1	2
13604	2016-03-08	"Tue"	"Midday"	"779"	7	7	9	23
13603	2016-03-07	"Mon"	"Evening"	"649"	6	4	9	19
13602	2016-03-07	"Mon"	"Midday"	"931"	9	3	1	13
13601	2016-03-06	"Sun"	"Evening"	"568"	5	6	8	19
13600	2016-03-06	"Sun"	"Midday"	"791"	7	9	1	17
13599	2016-03-05	"Sat"	"Evening"	"006"	0	0	6	6
13598	2016-03-05	"Sat"	"Midday"	"366"	3	6	6	15
13597	2016-03-04	"Fri"	"Evening"	"642"	6	4	2	12
13596	2016-03-04	"Fri"	"Midday"	"755"	7	5	5	17
13595	2016-03-03	"Thu"	"Evening"	"943"	9	4	3	16
13594	2016-03-03	"Thu"	"Midday"	"468"	4	6	8	18
13593	2016-03-02	"Wed"	"Evening"	"392"	3	9	2	14
13592	2016-03-02	"Wed"	"Midday"	"645"	6	4	5	15
13591	2016-03-01	"Tue"	"Evening"	"819"	8	1	9	18
13590	2016-03-01	"Tue"	"Midday"	"113"	1	1	3	5
13589	2016-02-29	"Mon"	"Evening"	"250"	2	5	0	7
13588	2016-02-29	"Mon"	"Midday"	"257"	2	5	7	14
13587	2016-02-28	"Sun"	"Evening"	"103"	1	0	3	4
13586	2016-02-28	"Sun"	"Midday"	"288"	2	8	8	18
13585	2016-02-27	"Sat"	"Evening"	"790"	7	9	0	16
13584	2016-02-27	"Sat"	"Midday"	"874"	8	7	4	19
13583	2016-02-26	"Fri"	"Evening"	"783"	7	8	3	18
13582	2016-02-26	"Fri"	"Midday"	"828"	8	2	8	18
13581	2016-02-25	"Thu"	"Evening"	"212"	2	1	2	5
13580	2016-02-25	"Thu"	"Midday"	"209"	2	0	9	11
13579	2016-02-24	"Wed"	"Evening"	"469"	4	6	9	19
13578	2016-02-24	"Wed"	"Midday"	"663"	6	6	3	15
13577	2016-02-23	"Tue"	"Evening"	"082"	0	8	2	10
13576	2016-02-23	"Tue"	"Midday"	"362"	3	6	2	11
13575	2016-02-22	"Mon"	"Evening"	"744"	7	4	4	15
13574	2016-02-22	"Mon"	"Midday"	"319"	3	1	9	13
13573	2016-02-21	"Sun"	"Evening"	"682"	6	8	2	16
13572	2016-02-21	"Sun"	"Midday"	"807"	8	0	7	15
13571	2016-02-20	"Sat"	"Evening"	"605"	6	0	5	11
13570	2016-02-20	"Sat"	"Midday"	"089"	0	8	9	17
13569	2016-02-19	"Fri"	"Evening"	"378"	3	7	8	18
13568	2016-02-19	"Fri"	"Midday"	"150"	1	5	0	6
13567	2016-02-18	"Thu"	"Evening"	"884"	8	8	4	20
13566	2016-02-18	"Thu"	"Midday"	"977"	9	7	7	23
13565	2016-02-17	"Wed"	"Evening"	"892"	8	9	2	19
13564	2016-02-17	"Wed"	"Midday"	"741"	7	4	1	12
13563	2016-02-16	"Tue"	"Evening"	"631"	6	3	1	10
13562	2016-02-16	"Tue"	"Midday"	"144"	1	4	4	9
13561	2016-02-15	"Mon"	"Evening"	"119"	1	1	9	11
13560	2016-02-15	"Mon"	"Midday"	"004"	0	0	4	4
13559	2016-02-14	"Sun"	"Evening"	"675"	6	7	5	18
13558	2016-02-14	"Sun"	"Midday"	"668"	6	6	8	20
13557	2016-02-13	"Sat"	"Evening"	"792"	7	9	2	18
13556	2016-02-13	"Sat"	"Midday"	"453"	4	5	3	12
13555	2016-02-12	"Fri"	"Evening"	"410"	4	1	0	5
13554	2016-02-12	"Fri"	"Midday"	"507"	5	0	7	12
13553	2016-02-11	"Thu"	"Evening"	"906"	9	0	6	15
13552	2016-02-11	"Thu"	"Midday"	"938"	9	3	8	20
13551	2016-02-10	"Wed"	"Evening"	"087"	0	8	7	15
13550	2016-02-10	"Wed"	"Midday"	"882"	8	8	2	18
13549	2016-02-09	"Tue"	"Evening"	"586"	5	8	6	19
13548	2016-02-09	"Tue"	"Midday"	"245"	2	4	5	11
13547	2016-02-08	"Mon"	"Evening"	"094"	0	9	4	13
13546	2016-02-08	"Mon"	"Midday"	"690"	6	9	0	15
13545	2016-02-07	"Sun"	"Evening"	"657"	6	5	7	18
13544	2016-02-07	"Sun"	"Midday"	"416"	4	1	6	11
13543	2016-02-06	"Sat"	"Evening"	"724"	7	2	4	13
13542	2016-02-06	"Sat"	"Midday"	"663"	6	6	3	15
13541	2016-02-05	"Fri"	"Evening"	"189"	1	8	9	18
13540	2016-02-05	"Fri"	"Midday"	"183"	1	8	3	12
13539	2016-02-04	"Thu"	"Evening"	"423"	4	2	3	9
13538	2016-02-04	"Thu"	"Midday"	"768"	7	6	8	21
13537	2016-02-03	"Wed"	"Evening"	"447"	4	4	7	15
13536	2016-02-03	"Wed"	"Midday"	"512"	5	1	2	8
13535	2016-02-02	"Tue"	"Evening"	"109"	1	0	9	10
13534	2016-02-02	"Tue"	"Midday"	"567"	5	6	7	18
13533	2016-02-01	"Mon"	"Evening"	"641"	6	4	1	11
13532	2016-02-01	"Mon"	"Midday"	"714"	7	1	4	12
13531	2016-01-31	"Sun"	"Evening"	"037"	0	3	7	10
13530	2016-01-31	"Sun"	"Midday"	"485"	4	8	5	17
13529	2016-01-30	"Sat"	"Evening"	"287"	2	8	7	17
13528	2016-01-30	"Sat"	"Midday"	"237"	2	3	7	12
13527	2016-01-29	"Fri"	"Evening"	"950"	9	5	0	14
13526	2016-01-29	"Fri"	"Midday"	"105"	1	0	5	6
13525	2016-01-28	"Thu"	"Evening"	"702"	7	0	2	9
13524	2016-01-28	"Thu"	"Midday"	"444"	4	4	4	12
13523	2016-01-27	"Wed"	"Evening"	"861"	8	6	1	15
13522	2016-01-27	"Wed"	"Midday"	"601"	6	0	1	7
13521	2016-01-26	"Tue"	"Evening"	"724"	7	2	4	13
13520	2016-01-26	"Tue"	"Midday"	"721"	7	2	1	10
13519	2016-01-25	"Mon"	"Evening"	"764"	7	6	4	17
13518	2016-01-25	"Mon"	"Midday"	"289"	2	8	9	19
13517	2016-01-24	"Sun"	"Evening"	"680"	6	8	0	14
13516	2016-01-24	"Sun"	"Midday"	"056"	0	5	6	11
13515	2016-01-23	"Sat"	"Evening"	"263"	2	6	3	11
13514	2016-01-23	"Sat"	"Midday"	"577"	5	7	7	19
13513	2016-01-22	"Fri"	"Evening"	"590"	5	9	0	14
13512	2016-01-22	"Fri"	"Midday"	"812"	8	1	2	11
13511	2016-01-21	"Thu"	"Evening"	"804"	8	0	4	12
13510	2016-01-21	"Thu"	"Midday"	"729"	7	2	9	18
13509	2016-01-20	"Wed"	"Evening"	"534"	5	3	4	12
13508	2016-01-20	"Wed"	"Midday"	"772"	7	7	2	16
13507	2016-01-19	"Tue"	"Evening"	"748"	7	4	8	19
13506	2016-01-19	"Tue"	"Midday"	"882"	8	8	2	18
13505	2016-01-18	"Mon"	"Evening"	"819"	8	1	9	18
13504	2016-01-18	"Mon"	"Midday"	"776"	7	7	6	20
13503	2016-01-17	"Sun"	"Evening"	"872"	8	7	2	17
13502	2016-01-17	"Sun"	"Midday"	"392"	3	9	2	14
13501	2016-01-16	"Sat"	"Evening"	"457"	4	5	7	16
13500	2016-01-16	"Sat"	"Midday"	"233"	2	3	3	8
13499	2016-01-15	"Fri"	"Evening"	"867"	8	6	7	21
13498	2016-01-15	"Fri"	"Midday"	"015"	0	1	5	6
13497	2016-01-14	"Thu"	"Evening"	"444"	4	4	4	12
13496	2016-01-14	"Thu"	"Midday"	"980"	9	8	0	17
13495	2016-01-13	"Wed"	"Evening"	"481"	4	8	1	13
13494	2016-01-13	"Wed"	"Midday"	"540"	5	4	0	9
13493	2016-01-12	"Tue"	"Evening"	"918"	9	1	8	18
13492	2016-01-12	"Tue"	"Midday"	"736"	7	3	6	16
13491	2016-01-11	"Mon"	"Evening"	"553"	5	5	3	13
13490	2016-01-11	"Mon"	"Midday"	"303"	3	0	3	6
13489	2016-01-10	"Sun"	"Evening"	"638"	6	3	8	17
13488	2016-01-10	"Sun"	"Midday"	"308"	3	0	8	11
13487	2016-01-09	"Sat"	"Evening"	"097"	0	9	7	16
13486	2016-01-09	"Sat"	"Midday"	"998"	9	9	8	26
13485	2016-01-08	"Fri"	"Evening"	"177"	1	7	7	15
13484	2016-01-08	"Fri"	"Midday"	"655"	6	5	5	16
13483	2016-01-07	"Thu"	"Evening"	"665"	6	6	5	17
13482	2016-01-07	"Thu"	"Midday"	"347"	3	4	7	14
13481	2016-01-06	"Wed"	"Evening"	"600"	6	0	0	6
13480	2016-01-06	"Wed"	"Midday"	"136"	1	3	6	10
13479	2016-01-05	"Tue"	"Evening"	"568"	5	6	8	19
13478	2016-01-05	"Tue"	"Midday"	"346"	3	4	6	13
13477	2016-01-04	"Mon"	"Evening"	"278"	2	7	8	17
13476	2016-01-04	"Mon"	"Midday"	"934"	9	3	4	16
13475	2016-01-03	"Sun"	"Evening"	"536"	5	3	6	14
13474	2016-01-03	"Sun"	"Midday"	"380"	3	8	0	11
13473	2016-01-02	"Sat"	"Evening"	"504"	5	0	4	9
13472	2016-01-02	"Sat"	"Midday"	"842"	8	4	2	14
13471	2016-01-01	"Fri"	"Evening"	"410"	4	1	0	5
13470	2016-01-01	"Fri"	"Midday"	"777"	7	7	7	21
13469	2015-12-31	"Thu"	"Evening"	"688"	6	8	8	22
13468	2015-12-31	"Thu"	"Midday"	"858"	8	5	8	21
13467	2015-12-30	"Wed"	"Evening"	"071"	0	7	1	8
13466	2015-12-30	"Wed"	"Midday"	"059"	0	5	9	14
13465	2015-12-29	"Tue"	"Evening"	"071"	0	7	1	8
13464	2015-12-29	"Tue"	"Midday"	"883"	8	8	3	19
13463	2015-12-28	"Mon"	"Evening"	"290"	2	9	0	11
13462	2015-12-28	"Mon"	"Midday"	"307"	3	0	7	10
13461	2015-12-27	"Sun"	"Evening"	"859"	8	5	9	22
13460	2015-12-27	"Sun"	"Midday"	"498"	4	9	8	21
13459	2015-12-26	"Sat"	"Evening"	"224"	2	2	4	8
13458	2015-12-26	"Sat"	"Midday"	"050"	0	5	0	5
13457	2015-12-25	"Fri"	"Evening"	"427"	4	2	7	13
13456	2015-12-25	"Fri"	"Midday"	"655"	6	5	5	16
13455	2015-12-24	"Thu"	"Evening"	"045"	0	4	5	9
13454	2015-12-24	"Thu"	"Midday"	"732"	7	3	2	12
13453	2015-12-23	"Wed"	"Evening"	"725"	7	2	5	14
13452	2015-12-23	"Wed"	"Midday"	"922"	9	2	2	13
13451	2015-12-22	"Tue"	"Evening"	"004"	0	0	4	4
13450	2015-12-22	"Tue"	"Midday"	"868"	8	6	8	22
13449	2015-12-21	"Mon"	"Evening"	"895"	8	9	5	22
13448	2015-12-21	"Mon"	"Midday"	"658"	6	5	8	19
13447	2015-12-20	"Sun"	"Evening"	"034"	0	3	4	7
13446	2015-12-20	"Sun"	"Midday"	"848"	8	4	8	20
13445	2015-12-19	"Sat"	"Evening"	"872"	8	7	2	17
13444	2015-12-19	"Sat"	"Midday"	"532"	5	3	2	10
13443	2015-12-18	"Fri"	"Evening"	"415"	4	1	5	10
13442	2015-12-18	"Fri"	"Midday"	"234"	2	3	4	9
13441	2015-12-17	"Thu"	"Evening"	"144"	1	4	4	9
13440	2015-12-17	"Thu"	"Midday"	"895"	8	9	5	22
13439	2015-12-16	"Wed"	"Evening"	"615"	6	1	5	12
13438	2015-12-16	"Wed"	"Midday"	"103"	1	0	3	4
13437	2015-12-15	"Tue"	"Evening"	"541"	5	4	1	10
13436	2015-12-15	"Tue"	"Midday"	"508"	5	0	8	13
13435	2015-12-14	"Mon"	"Evening"	"580"	5	8	0	13
13434	2015-12-14	"Mon"	"Midday"	"177"	1	7	7	15
13433	2015-12-13	"Sun"	"Evening"	"991"	9	9	1	19
13432	2015-12-13	"Sun"	"Midday"	"266"	2	6	6	14
13431	2015-12-12	"Sat"	"Evening"	"472"	4	7	2	13
13430	2015-12-12	"Sat"	"Midday"	"917"	9	1	7	17
13429	2015-12-11	"Fri"	"Evening"	"359"	3	5	9	17
13428	2015-12-11	"Fri"	"Midday"	"790"	7	9	0	16
13427	2015-12-10	"Thu"	"Evening"	"611"	6	1	1	8
13426	2015-12-10	"Thu"	"Midday"	"977"	9	7	7	23
13425	2015-12-09	"Wed"	"Evening"	"865"	8	6	5	19
13424	2015-12-09	"Wed"	"Midday"	"515"	5	1	5	11
13423	2015-12-08	"Tue"	"Evening"	"196"	1	9	6	16
13422	2015-12-08	"Tue"	"Midday"	"690"	6	9	0	15
13421	2015-12-07	"Mon"	"Evening"	"614"	6	1	4	11
13420	2015-12-07	"Mon"	"Midday"	"859"	8	5	9	22
13419	2015-12-06	"Sun"	"Evening"	"833"	8	3	3	14
13418	2015-12-06	"Sun"	"Midday"	"300"	3	0	0	3
13417	2015-12-05	"Sat"	"Evening"	"810"	8	1	0	9
13416	2015-12-05	"Sat"	"Midday"	"097"	0	9	7	16
13415	2015-12-04	"Fri"	"Evening"	"763"	7	6	3	16
13414	2015-12-04	"Fri"	"Midday"	"911"	9	1	1	11
13413	2015-12-03	"Thu"	"Evening"	"056"	0	5	6	11
13412	2015-12-03	"Thu"	"Midday"	"934"	9	3	4	16
13411	2015-12-02	"Wed"	"Evening"	"610"	6	1	0	7
13410	2015-12-02	"Wed"	"Midday"	"376"	3	7	6	16
13409	2015-12-01	"Tue"	"Evening"	"952"	9	5	2	16
13408	2015-12-01	"Tue"	"Midday"	"835"	8	3	5	16
13407	2015-11-30	"Mon"	"Evening"	"122"	1	2	2	5
13406	2015-11-30	"Mon"	"Midday"	"394"	3	9	4	16
13405	2015-11-29	"Sun"	"Evening"	"716"	7	1	6	14
13404	2015-11-29	"Sun"	"Midday"	"329"	3	2	9	14
13403	2015-11-28	"Sat"	"Evening"	"225"	2	2	5	9
13402	2015-11-28	"Sat"	"Midday"	"888"	8	8	8	24
13401	2015-11-27	"Fri"	"Evening"	"312"	3	1	2	6
13400	2015-11-27	"Fri"	"Midday"	"995"	9	9	5	23
13399	2015-11-26	"Thu"	"Evening"	"482"	4	8	2	14
13398	2015-11-26	"Thu"	"Midday"	"274"	2	7	4	13
13397	2015-11-25	"Wed"	"Evening"	"267"	2	6	7	15
13396	2015-11-25	"Wed"	"Midday"	"411"	4	1	1	6
13395	2015-11-24	"Tue"	"Evening"	"898"	8	9	8	25
13394	2015-11-24	"Tue"	"Midday"	"771"	7	7	1	15
13393	2015-11-23	"Mon"	"Evening"	"526"	5	2	6	13
13392	2015-11-23	"Mon"	"Midday"	"497"	4	9	7	20
13391	2015-11-22	"Sun"	"Evening"	"796"	7	9	6	22
13390	2015-11-22	"Sun"	"Midday"	"810"	8	1	0	9
13389	2015-11-21	"Sat"	"Evening"	"175"	1	7	5	13
13388	2015-11-21	"Sat"	"Midday"	"012"	0	1	2	3
13387	2015-11-20	"Fri"	"Evening"	"610"	6	1	0	7
13386	2015-11-20	"Fri"	"Midday"	"408"	4	0	8	12
13385	2015-11-19	"Thu"	"Evening"	"214"	2	1	4	7
13384	2015-11-19	"Thu"	"Midday"	"078"	0	7	8	15
13383	2015-11-18	"Wed"	"Evening"	"244"	2	4	4	10
13382	2015-11-18	"Wed"	"Midday"	"262"	2	6	2	10
13381	2015-11-17	"Tue"	"Evening"	"263"	2	6	3	11
13380	2015-11-17	"Tue"	"Midday"	"474"	4	7	4	15
13379	2015-11-16	"Mon"	"Evening"	"683"	6	8	3	17
13378	2015-11-16	"Mon"	"Midday"	"644"	6	4	4	14
13377	2015-11-15	"Sun"	"Evening"	"647"	6	4	7	17
13376	2015-11-15	"Sun"	"Midday"	"344"	3	4	4	11
13375	2015-11-14	"Sat"	"Evening"	"301"	3	0	1	4
13374	2015-11-14	"Sat"	"Midday"	"197"	1	9	7	17
13373	2015-11-13	"Fri"	"Evening"	"139"	1	3	9	13
13372	2015-11-13	"Fri"	"Midday"	"288"	2	8	8	18
13371	2015-11-12	"Thu"	"Evening"	"166"	1	6	6	13
13370	2015-11-12	"Thu"	"Midday"	"405"	4	0	5	9
13369	2015-11-11	"Wed"	"Evening"	"659"	6	5	9	20
13368	2015-11-11	"Wed"	"Midday"	"032"	0	3	2	5
13367	2015-11-10	"Tue"	"Evening"	"965"	9	6	5	20
13366	2015-11-10	"Tue"	"Midday"	"877"	8	7	7	22
13365	2015-11-09	"Mon"	"Evening"	"323"	3	2	3	8
13364	2015-11-09	"Mon"	"Midday"	"518"	5	1	8	14
13363	2015-11-08	"Sun"	"Evening"	"827"	8	2	7	17
13362	2015-11-08	"Sun"	"Midday"	"301"	3	0	1	4
13361	2015-11-07	"Sat"	"Evening"	"943"	9	4	3	16
13360	2015-11-07	"Sat"	"Midday"	"747"	7	4	7	18
13359	2015-11-06	"Fri"	"Evening"	"125"	1	2	5	8
13358	2015-11-06	"Fri"	"Midday"	"000"	0	0	0	0
13357	2015-11-05	"Thu"	"Evening"	"526"	5	2	6	13
13356	2015-11-05	"Thu"	"Midday"	"135"	1	3	5	9
13355	2015-11-04	"Wed"	"Evening"	"854"	8	5	4	17
13354	2015-11-04	"Wed"	"Midday"	"818"	8	1	8	17
13353	2015-11-03	"Tue"	"Evening"	"657"	6	5	7	18
13352	2015-11-03	"Tue"	"Midday"	"138"	1	3	8	12
13351	2015-11-02	"Mon"	"Evening"	"513"	5	1	3	9
13350	2015-11-02	"Mon"	"Midday"	"706"	7	0	6	13
13349	2015-11-01	"Sun"	"Evening"	"958"	9	5	8	22
13348	2015-11-01	"Sun"	"Midday"	"299"	2	9	9	20
13347	2015-10-31	"Sat"	"Evening"	"315"	3	1	5	9
13346	2015-10-31	"Sat"	"Midday"	"764"	7	6	4	17
13345	2015-10-30	"Fri"	"Evening"	"875"	8	7	5	20
13344	2015-10-30	"Fri"	"Midday"	"486"	4	8	6	18
13343	2015-10-29	"Thu"	"Evening"	"865"	8	6	5	19
13342	2015-10-29	"Thu"	"Midday"	"777"	7	7	7	21
13341	2015-10-28	"Wed"	"Evening"	"045"	0	4	5	9
13340	2015-10-28	"Wed"	"Midday"	"485"	4	8	5	17
13339	2015-10-27	"Tue"	"Evening"	"766"	7	6	6	19
13338	2015-10-27	"Tue"	"Midday"	"507"	5	0	7	12
13337	2015-10-26	"Mon"	"Evening"	"984"	9	8	4	21
13336	2015-10-26	"Mon"	"Midday"	"215"	2	1	5	8
13335	2015-10-25	"Sun"	"Evening"	"746"	7	4	6	17
13334	2015-10-25	"Sun"	"Midday"	"747"	7	4	7	18
13333	2015-10-24	"Sat"	"Evening"	"463"	4	6	3	13
13332	2015-10-24	"Sat"	"Midday"	"575"	5	7	5	17
13331	2015-10-23	"Fri"	"Evening"	"421"	4	2	1	7
13330	2015-10-23	"Fri"	"Midday"	"119"	1	1	9	11
13329	2015-10-22	"Thu"	"Evening"	"186"	1	8	6	15
13328	2015-10-22	"Thu"	"Midday"	"410"	4	1	0	5
13327	2015-10-21	"Wed"	"Evening"	"978"	9	7	8	24
13326	2015-10-21	"Wed"	"Midday"	"561"	5	6	1	12
13325	2015-10-20	"Tue"	"Evening"	"318"	3	1	8	12
13324	2015-10-20	"Tue"	"Midday"	"222"	2	2	2	6
13323	2015-10-19	"Mon"	"Evening"	"791"	7	9	1	17
13322	2015-10-19	"Mon"	"Midday"	"028"	0	2	8	10
13321	2015-10-18	"Sun"	"Evening"	"194"	1	9	4	14
13320	2015-10-18	"Sun"	"Midday"	"060"	0	6	0	6
13319	2015-10-17	"Sat"	"Evening"	"541"	5	4	1	10
13318	2015-10-17	"Sat"	"Midday"	"889"	8	8	9	25
13317	2015-10-16	"Fri"	"Evening"	"741"	7	4	1	12
13316	2015-10-16	"Fri"	"Midday"	"359"	3	5	9	17
13315	2015-10-15	"Thu"	"Evening"	"669"	6	6	9	21
13314	2015-10-15	"Thu"	"Midday"	"540"	5	4	0	9
13313	2015-10-14	"Wed"	"Evening"	"767"	7	6	7	20
13312	2015-10-14	"Wed"	"Midday"	"487"	4	8	7	19
13311	2015-10-13	"Tue"	"Evening"	"364"	3	6	4	13
13310	2015-10-13	"Tue"	"Midday"	"023"	0	2	3	5
13309	2015-10-12	"Mon"	"Evening"	"966"	9	6	6	21
13308	2015-10-12	"Mon"	"Midday"	"209"	2	0	9	11
13307	2015-10-11	"Sun"	"Evening"	"736"	7	3	6	16
13306	2015-10-11	"Sun"	"Midday"	"935"	9	3	5	17
13305	2015-10-10	"Sat"	"Evening"	"128"	1	2	8	11
13304	2015-10-10	"Sat"	"Midday"	"354"	3	5	4	12
13303	2015-10-09	"Fri"	"Evening"	"572"	5	7	2	14
13302	2015-10-09	"Fri"	"Midday"	"421"	4	2	1	7
13301	2015-10-08	"Thu"	"Evening"	"010"	0	1	0	1
13300	2015-10-08	"Thu"	"Midday"	"861"	8	6	1	15
13299	2015-10-07	"Wed"	"Evening"	"527"	5	2	7	14
13298	2015-10-07	"Wed"	"Midday"	"735"	7	3	5	15
13297	2015-10-06	"Tue"	"Evening"	"740"	7	4	0	11
13296	2015-10-06	"Tue"	"Midday"	"457"	4	5	7	16
13295	2015-10-05	"Mon"	"Evening"	"789"	7	8	9	24
13294	2015-10-05	"Mon"	"Midday"	"985"	9	8	5	22
13293	2015-10-04	"Sun"	"Evening"	"353"	3	5	3	11
13292	2015-10-04	"Sun"	"Midday"	"951"	9	5	1	15
13291	2015-10-03	"Sat"	"Evening"	"453"	4	5	3	12
13290	2015-10-03	"Sat"	"Midday"	"389"	3	8	9	20
13289	2015-10-02	"Fri"	"Evening"	"432"	4	3	2	9
13288	2015-10-02	"Fri"	"Midday"	"070"	0	7	0	7
13287	2015-10-01	"Thu"	"Evening"	"647"	6	4	7	17
13286	2015-10-01	"Thu"	"Midday"	"751"	7	5	1	13
13285	2015-09-30	"Wed"	"Evening"	"299"	2	9	9	20
13284	2015-09-30	"Wed"	"Midday"	"871"	8	7	1	16
13283	2015-09-29	"Tue"	"Evening"	"703"	7	0	3	10
13282	2015-09-29	"Tue"	"Midday"	"636"	6	3	6	15
13281	2015-09-28	"Mon"	"Evening"	"827"	8	2	7	17
13280	2015-09-28	"Mon"	"Midday"	"322"	3	2	2	7
13279	2015-09-27	"Sun"	"Evening"	"222"	2	2	2	6
13278	2015-09-27	"Sun"	"Midday"	"827"	8	2	7	17
13277	2015-09-26	"Sat"	"Evening"	"864"	8	6	4	18
13276	2015-09-26	"Sat"	"Midday"	"475"	4	7	5	16
13275	2015-09-25	"Fri"	"Evening"	"065"	0	6	5	11
13274	2015-09-25	"Fri"	"Midday"	"199"	1	9	9	19
13273	2015-09-24	"Thu"	"Evening"	"332"	3	3	2	8
13272	2015-09-24	"Thu"	"Midday"	"538"	5	3	8	16
13271	2015-09-23	"Wed"	"Evening"	"051"	0	5	1	6
13270	2015-09-23	"Wed"	"Midday"	"771"	7	7	1	15
13269	2015-09-22	"Tue"	"Evening"	"716"	7	1	6	14
13268	2015-09-22	"Tue"	"Midday"	"393"	3	9	3	15
13267	2015-09-21	"Mon"	"Evening"	"234"	2	3	4	9
13266	2015-09-21	"Mon"	"Midday"	"480"	4	8	0	12
13265	2015-09-20	"Sun"	"Evening"	"937"	9	3	7	19
13264	2015-09-20	"Sun"	"Midday"	"823"	8	2	3	13
13263	2015-09-19	"Sat"	"Evening"	"649"	6	4	9	19
13262	2015-09-19	"Sat"	"Midday"	"505"	5	0	5	10
13261	2015-09-18	"Fri"	"Evening"	"714"	7	1	4	12
13260	2015-09-18	"Fri"	"Midday"	"288"	2	8	8	18
13259	2015-09-17	"Thu"	"Evening"	"637"	6	3	7	16
13258	2015-09-17	"Thu"	"Midday"	"695"	6	9	5	20
13257	2015-09-16	"Wed"	"Evening"	"238"	2	3	8	13
13256	2015-09-16	"Wed"	"Midday"	"919"	9	1	9	19
13255	2015-09-15	"Tue"	"Evening"	"709"	7	0	9	16
13254	2015-09-15	"Tue"	"Midday"	"430"	4	3	0	7
13253	2015-09-14	"Mon"	"Evening"	"228"	2	2	8	12
13252	2015-09-14	"Mon"	"Midday"	"152"	1	5	2	8
13251	2015-09-13	"Sun"	"Evening"	"229"	2	2	9	13
13250	2015-09-13	"Sun"	"Midday"	"869"	8	6	9	23
13249	2015-09-12	"Sat"	"Evening"	"988"	9	8	8	25
13248	2015-09-12	"Sat"	"Midday"	"144"	1	4	4	9
13247	2015-09-11	"Fri"	"Evening"	"174"	1	7	4	12
13246	2015-09-11	"Fri"	"Midday"	"113"	1	1	3	5
13245	2015-09-10	"Thu"	"Evening"	"053"	0	5	3	8
13244	2015-09-10	"Thu"	"Midday"	"780"	7	8	0	15
13243	2015-09-09	"Wed"	"Evening"	"982"	9	8	2	19
13242	2015-09-09	"Wed"	"Midday"	"846"	8	4	6	18
13241	2015-09-08	"Tue"	"Evening"	"600"	6	0	0	6
13240	2015-09-08	"Tue"	"Midday"	"743"	7	4	3	14
13239	2015-09-07	"Mon"	"Evening"	"804"	8	0	4	12
13238	2015-09-07	"Mon"	"Midday"	"615"	6	1	5	12
13237	2015-09-06	"Sun"	"Evening"	"051"	0	5	1	6
13236	2015-09-06	"Sun"	"Midday"	"419"	4	1	9	14
13235	2015-09-05	"Sat"	"Evening"	"358"	3	5	8	16
13234	2015-09-05	"Sat"	"Midday"	"135"	1	3	5	9
13233	2015-09-04	"Fri"	"Evening"	"480"	4	8	0	12
13232	2015-09-04	"Fri"	"Midday"	"263"	2	6	3	11
13231	2015-09-03	"Thu"	"Evening"	"474"	4	7	4	15
13230	2015-09-03	"Thu"	"Midday"	"806"	8	0	6	14
13229	2015-09-02	"Wed"	"Evening"	"322"	3	2	2	7
13228	2015-09-02	"Wed"	"Midday"	"798"	7	9	8	24
13227	2015-09-01	"Tue"	"Evening"	"089"	0	8	9	17
13226	2015-09-01	"Tue"	"Midday"	"649"	6	4	9	19
13225	2015-08-31	"Mon"	"Evening"	"003"	0	0	3	3
13224	2015-08-31	"Mon"	"Midday"	"657"	6	5	7	18
13223	2015-08-30	"Sun"	"Evening"	"584"	5	8	4	17
13222	2015-08-30	"Sun"	"Midday"	"855"	8	5	5	18
13221	2015-08-29	"Sat"	"Evening"	"423"	4	2	3	9
13220	2015-08-29	"Sat"	"Midday"	"821"	8	2	1	11
13219	2015-08-28	"Fri"	"Evening"	"485"	4	8	5	17
13218	2015-08-28	"Fri"	"Midday"	"543"	5	4	3	12
13217	2015-08-27	"Thu"	"Evening"	"675"	6	7	5	18
13216	2015-08-27	"Thu"	"Midday"	"279"	2	7	9	18
13215	2015-08-26	"Wed"	"Evening"	"569"	5	6	9	20
13214	2015-08-26	"Wed"	"Midday"	"057"	0	5	7	12
13213	2015-08-25	"Tue"	"Evening"	"184"	1	8	4	13
13212	2015-08-25	"Tue"	"Midday"	"324"	3	2	4	9
13211	2015-08-24	"Mon"	"Evening"	"653"	6	5	3	14
13210	2015-08-24	"Mon"	"Midday"	"978"	9	7	8	24
13209	2015-08-23	"Sun"	"Evening"	"772"	7	7	2	16
13208	2015-08-23	"Sun"	"Midday"	"688"	6	8	8	22
13207	2015-08-22	"Sat"	"Evening"	"825"	8	2	5	15
13206	2015-08-22	"Sat"	"Midday"	"702"	7	0	2	9
13205	2015-08-21	"Fri"	"Evening"	"544"	5	4	4	13
13204	2015-08-21	"Fri"	"Midday"	"997"	9	9	7	25
13203	2015-08-20	"Thu"	"Evening"	"058"	0	5	8	13
13202	2015-08-20	"Thu"	"Midday"	"577"	5	7	7	19
13201	2015-08-19	"Wed"	"Evening"	"711"	7	1	1	9
13200	2015-08-19	"Wed"	"Midday"	"667"	6	6	7	19
13199	2015-08-18	"Tue"	"Evening"	"611"	6	1	1	8
13198	2015-08-18	"Tue"	"Midday"	"817"	8	1	7	16
13197	2015-08-17	"Mon"	"Evening"	"499"	4	9	9	22
13196	2015-08-17	"Mon"	"Midday"	"014"	0	1	4	5
13195	2015-08-16	"Sun"	"Evening"	"777"	7	7	7	21
13194	2015-08-16	"Sun"	"Midday"	"863"	8	6	3	17
13193	2015-08-15	"Sat"	"Evening"	"070"	0	7	0	7
13192	2015-08-15	"Sat"	"Midday"	"670"	6	7	0	13
13191	2015-08-14	"Fri"	"Evening"	"131"	1	3	1	5
13190	2015-08-14	"Fri"	"Midday"	"396"	3	9	6	18
13189	2015-08-13	"Thu"	"Evening"	"552"	5	5	2	12
13188	2015-08-13	"Thu"	"Midday"	"177"	1	7	7	15
13187	2015-08-12	"Wed"	"Evening"	"326"	3	2	6	11
13186	2015-08-12	"Wed"	"Midday"	"575"	5	7	5	17
13185	2015-08-11	"Tue"	"Evening"	"782"	7	8	2	17
13184	2015-08-11	"Tue"	"Midday"	"761"	7	6	1	14
13183	2015-08-10	"Mon"	"Evening"	"709"	7	0	9	16
13182	2015-08-10	"Mon"	"Midday"	"646"	6	4	6	16
13181	2015-08-09	"Sun"	"Evening"	"612"	6	1	2	9
13180	2015-08-09	"Sun"	"Midday"	"318"	3	1	8	12
13179	2015-08-08	"Sat"	"Evening"	"993"	9	9	3	21
13178	2015-08-08	"Sat"	"Midday"	"736"	7	3	6	16
13177	2015-08-07	"Fri"	"Evening"	"480"	4	8	0	12
13176	2015-08-07	"Fri"	"Midday"	"701"	7	0	1	8
13175	2015-08-06	"Thu"	"Evening"	"843"	8	4	3	15
13174	2015-08-06	"Thu"	"Midday"	"066"	0	6	6	12
13173	2015-08-05	"Wed"	"Evening"	"589"	5	8	9	22
13172	2015-08-05	"Wed"	"Midday"	"035"	0	3	5	8
13171	2015-08-04	"Tue"	"Evening"	"226"	2	2	6	10
13170	2015-08-04	"Tue"	"Midday"	"670"	6	7	0	13
13169	2015-08-03	"Mon"	"Evening"	"805"	8	0	5	13
13168	2015-08-03	"Mon"	"Midday"	"166"	1	6	6	13
13167	2015-08-02	"Sun"	"Evening"	"171"	1	7	1	9
13166	2015-08-02	"Sun"	"Midday"	"170"	1	7	0	8
13165	2015-08-01	"Sat"	"Evening"	"312"	3	1	2	6
13164	2015-08-01	"Sat"	"Midday"	"625"	6	2	5	13
13163	2015-07-31	"Fri"	"Evening"	"241"	2	4	1	7
13162	2015-07-31	"Fri"	"Midday"	"130"	1	3	0	4
13161	2015-07-30	"Thu"	"Evening"	"160"	1	6	0	7
13160	2015-07-30	"Thu"	"Midday"	"024"	0	2	4	6
13159	2015-07-29	"Wed"	"Evening"	"178"	1	7	8	16
13158	2015-07-29	"Wed"	"Midday"	"511"	5	1	1	7
13157	2015-07-28	"Tue"	"Evening"	"547"	5	4	7	16
13156	2015-07-28	"Tue"	"Midday"	"957"	9	5	7	21
13155	2015-07-27	"Mon"	"Evening"	"921"	9	2	1	12
13154	2015-07-27	"Mon"	"Midday"	"911"	9	1	1	11
13153	2015-07-26	"Sun"	"Evening"	"602"	6	0	2	8
13152	2015-07-26	"Sun"	"Midday"	"353"	3	5	3	11
13151	2015-07-25	"Sat"	"Evening"	"697"	6	9	7	22
13150	2015-07-25	"Sat"	"Midday"	"936"	9	3	6	18
13149	2015-07-24	"Fri"	"Evening"	"049"	0	4	9	13
13148	2015-07-24	"Fri"	"Midday"	"271"	2	7	1	10
13147	2015-07-23	"Thu"	"Evening"	"334"	3	3	4	10
13146	2015-07-23	"Thu"	"Midday"	"377"	3	7	7	17
13145	2015-07-22	"Wed"	"Evening"	"476"	4	7	6	17
13144	2015-07-22	"Wed"	"Midday"	"621"	6	2	1	9
13143	2015-07-21	"Tue"	"Evening"	"174"	1	7	4	12
13142	2015-07-21	"Tue"	"Midday"	"760"	7	6	0	13
13141	2015-07-20	"Mon"	"Evening"	"829"	8	2	9	19
13140	2015-07-20	"Mon"	"Midday"	"418"	4	1	8	13
13139	2015-07-19	"Sun"	"Evening"	"877"	8	7	7	22
13138	2015-07-19	"Sun"	"Midday"	"908"	9	0	8	17
13137	2015-07-18	"Sat"	"Evening"	"002"	0	0	2	2
13136	2015-07-18	"Sat"	"Midday"	"411"	4	1	1	6
13135	2015-07-17	"Fri"	"Evening"	"106"	1	0	6	7
13134	2015-07-17	"Fri"	"Midday"	"248"	2	4	8	14
13133	2015-07-16	"Thu"	"Evening"	"690"	6	9	0	15
13132	2015-07-16	"Thu"	"Midday"	"823"	8	2	3	13
13131	2015-07-15	"Wed"	"Evening"	"882"	8	8	2	18
13130	2015-07-15	"Wed"	"Midday"	"433"	4	3	3	10
13129	2015-07-14	"Tue"	"Evening"	"603"	6	0	3	9
13128	2015-07-14	"Tue"	"Midday"	"840"	8	4	0	12
13127	2015-07-13	"Mon"	"Evening"	"210"	2	1	0	3
13126	2015-07-13	"Mon"	"Midday"	"204"	2	0	4	6
13125	2015-07-12	"Sun"	"Evening"	"708"	7	0	8	15
13124	2015-07-12	"Sun"	"Midday"	"030"	0	3	0	3
13123	2015-07-11	"Sat"	"Evening"	"572"	5	7	2	14
13122	2015-07-11	"Sat"	"Midday"	"796"	7	9	6	22
13121	2015-07-10	"Fri"	"Evening"	"954"	9	5	4	18
13120	2015-07-10	"Fri"	"Midday"	"382"	3	8	2	13
13119	2015-07-09	"Thu"	"Evening"	"018"	0	1	8	9
13118	2015-07-09	"Thu"	"Midday"	"083"	0	8	3	11
13117	2015-07-08	"Wed"	"Evening"	"454"	4	5	4	13
13116	2015-07-08	"Wed"	"Midday"	"594"	5	9	4	18
13115	2015-07-07	"Tue"	"Evening"	"154"	1	5	4	10
13114	2015-07-07	"Tue"	"Midday"	"711"	7	1	1	9
13113	2015-07-06	"Mon"	"Evening"	"854"	8	5	4	17
13112	2015-07-06	"Mon"	"Midday"	"945"	9	4	5	18
13111	2015-07-05	"Sun"	"Evening"	"025"	0	2	5	7
13110	2015-07-05	"Sun"	"Midday"	"804"	8	0	4	12
13109	2015-07-04	"Sat"	"Evening"	"319"	3	1	9	13
13108	2015-07-04	"Sat"	"Midday"	"784"	7	8	4	19
13107	2015-07-03	"Fri"	"Evening"	"288"	2	8	8	18
13106	2015-07-03	"Fri"	"Midday"	"086"	0	8	6	14
13105	2015-07-02	"Thu"	"Evening"	"978"	9	7	8	24
13104	2015-07-02	"Thu"	"Midday"	"108"	1	0	8	9
13103	2015-07-01	"Wed"	"Evening"	"958"	9	5	8	22
13102	2015-07-01	"Wed"	"Midday"	"810"	8	1	0	9
13101	2015-06-30	"Tue"	"Evening"	"973"	9	7	3	19
13100	2015-06-30	"Tue"	"Midday"	"335"	3	3	5	11
13099	2015-06-29	"Mon"	"Evening"	"770"	7	7	0	14
13098	2015-06-29	"Mon"	"Midday"	"726"	7	2	6	15
13097	2015-06-28	"Sun"	"Evening"	"292"	2	9	2	13
13096	2015-06-28	"Sun"	"Midday"	"456"	4	5	6	15
13095	2015-06-27	"Sat"	"Evening"	"474"	4	7	4	15
13094	2015-06-27	"Sat"	"Midday"	"874"	8	7	4	19
13093	2015-06-26	"Fri"	"Evening"	"537"	5	3	7	15
13092	2015-06-26	"Fri"	"Midday"	"443"	4	4	3	11
13091	2015-06-25	"Thu"	"Evening"	"897"	8	9	7	24
13090	2015-06-25	"Thu"	"Midday"	"019"	0	1	9	10
13089	2015-06-24	"Wed"	"Evening"	"331"	3	3	1	7
13088	2015-06-24	"Wed"	"Midday"	"612"	6	1	2	9
13087	2015-06-23	"Tue"	"Evening"	"829"	8	2	9	19
13086	2015-06-23	"Tue"	"Midday"	"248"	2	4	8	14
13085	2015-06-22	"Mon"	"Evening"	"148"	1	4	8	13
13084	2015-06-22	"Mon"	"Midday"	"071"	0	7	1	8
13083	2015-06-21	"Sun"	"Evening"	"861"	8	6	1	15
13082	2015-06-21	"Sun"	"Midday"	"736"	7	3	6	16
13081	2015-06-20	"Sat"	"Evening"	"394"	3	9	4	16
13080	2015-06-20	"Sat"	"Midday"	"764"	7	6	4	17
13079	2015-06-19	"Fri"	"Evening"	"445"	4	4	5	13
13078	2015-06-19	"Fri"	"Midday"	"376"	3	7	6	16
13077	2015-06-18	"Thu"	"Evening"	"543"	5	4	3	12
13076	2015-06-18	"Thu"	"Midday"	"056"	0	5	6	11
13075	2015-06-17	"Wed"	"Evening"	"122"	1	2	2	5
13074	2015-06-17	"Wed"	"Midday"	"286"	2	8	6	16
13073	2015-06-16	"Tue"	"Evening"	"997"	9	9	7	25
13072	2015-06-16	"Tue"	"Midday"	"637"	6	3	7	16
13071	2015-06-15	"Mon"	"Evening"	"679"	6	7	9	22
13070	2015-06-15	"Mon"	"Midday"	"978"	9	7	8	24
13069	2015-06-14	"Sun"	"Evening"	"813"	8	1	3	12
13068	2015-06-14	"Sun"	"Midday"	"778"	7	7	8	22
13067	2015-06-13	"Sat"	"Evening"	"111"	1	1	1	3
13066	2015-06-13	"Sat"	"Midday"	"774"	7	7	4	18
13065	2015-06-12	"Fri"	"Evening"	"519"	5	1	9	15
13064	2015-06-12	"Fri"	"Midday"	"690"	6	9	0	15
13063	2015-06-11	"Thu"	"Evening"	"431"	4	3	1	8
13062	2015-06-11	"Thu"	"Midday"	"961"	9	6	1	16
13061	2015-06-10	"Wed"	"Evening"	"737"	7	3	7	17
13060	2015-06-10	"Wed"	"Midday"	"082"	0	8	2	10
13059	2015-06-09	"Tue"	"Evening"	"737"	7	3	7	17
13058	2015-06-09	"Tue"	"Midday"	"214"	2	1	4	7
13057	2015-06-08	"Mon"	"Evening"	"390"	3	9	0	12
13056	2015-06-08	"Mon"	"Midday"	"322"	3	2	2	7
13055	2015-06-07	"Sun"	"Evening"	"927"	9	2	7	18
13054	2015-06-07	"Sun"	"Midday"	"360"	3	6	0	9
13053	2015-06-06	"Sat"	"Evening"	"325"	3	2	5	10
13052	2015-06-06	"Sat"	"Midday"	"601"	6	0	1	7
13051	2015-06-05	"Fri"	"Evening"	"304"	3	0	4	7
13050	2015-06-05	"Fri"	"Midday"	"175"	1	7	5	13
13049	2015-06-04	"Thu"	"Evening"	"669"	6	6	9	21
13048	2015-06-04	"Thu"	"Midday"	"837"	8	3	7	18
13047	2015-06-03	"Wed"	"Evening"	"770"	7	7	0	14
13046	2015-06-03	"Wed"	"Midday"	"173"	1	7	3	11
13045	2015-06-02	"Tue"	"Evening"	"113"	1	1	3	5
13044	2015-06-02	"Tue"	"Midday"	"083"	0	8	3	11
13043	2015-06-01	"Mon"	"Evening"	"166"	1	6	6	13
13042	2015-06-01	"Mon"	"Midday"	"655"	6	5	5	16
13041	2015-05-31	"Sun"	"Evening"	"554"	5	5	4	14
13040	2015-05-31	"Sun"	"Midday"	"586"	5	8	6	19
13039	2015-05-30	"Sat"	"Evening"	"542"	5	4	2	11
13038	2015-05-30	"Sat"	"Midday"	"972"	9	7	2	18
13037	2015-05-29	"Fri"	"Evening"	"801"	8	0	1	9
13036	2015-05-29	"Fri"	"Midday"	"887"	8	8	7	23
13035	2015-05-28	"Thu"	"Evening"	"888"	8	8	8	24
13034	2015-05-28	"Thu"	"Midday"	"205"	2	0	5	7
13033	2015-05-27	"Wed"	"Evening"	"026"	0	2	6	8
13032	2015-05-27	"Wed"	"Midday"	"454"	4	5	4	13
13031	2015-05-26	"Tue"	"Evening"	"596"	5	9	6	20
13030	2015-05-26	"Tue"	"Midday"	"426"	4	2	6	12
13029	2015-05-25	"Mon"	"Evening"	"282"	2	8	2	12
13028	2015-05-25	"Mon"	"Midday"	"501"	5	0	1	6
13027	2015-05-24	"Sun"	"Evening"	"418"	4	1	8	13
13026	2015-05-24	"Sun"	"Midday"	"908"	9	0	8	17
13025	2015-05-23	"Sat"	"Evening"	"396"	3	9	6	18
13024	2015-05-23	"Sat"	"Midday"	"101"	1	0	1	2
13023	2015-05-22	"Fri"	"Evening"	"445"	4	4	5	13
13022	2015-05-22	"Fri"	"Midday"	"947"	9	4	7	20
13021	2015-05-21	"Thu"	"Evening"	"466"	4	6	6	16
13020	2015-05-21	"Thu"	"Midday"	"272"	2	7	2	11
13019	2015-05-20	"Wed"	"Evening"	"505"	5	0	5	10
13018	2015-05-20	"Wed"	"Midday"	"760"	7	6	0	13
13017	2015-05-19	"Tue"	"Evening"	"330"	3	3	0	6
13016	2015-05-19	"Tue"	"Midday"	"041"	0	4	1	5
13015	2015-05-18	"Mon"	"Evening"	"667"	6	6	7	19
13014	2015-05-18	"Mon"	"Midday"	"836"	8	3	6	17
13013	2015-05-17	"Sun"	"Evening"	"371"	3	7	1	11
13012	2015-05-17	"Sun"	"Midday"	"909"	9	0	9	18
13011	2015-05-16	"Sat"	"Evening"	"283"	2	8	3	13
13010	2015-05-16	"Sat"	"Midday"	"181"	1	8	1	10
13009	2015-05-15	"Fri"	"Evening"	"571"	5	7	1	13
13008	2015-05-15	"Fri"	"Midday"	"084"	0	8	4	12
13007	2015-05-14	"Thu"	"Evening"	"696"	6	9	6	21
13006	2015-05-14	"Thu"	"Midday"	"470"	4	7	0	11
13005	2015-05-13	"Wed"	"Evening"	"074"	0	7	4	11
13004	2015-05-13	"Wed"	"Midday"	"218"	2	1	8	11
13003	2015-05-12	"Tue"	"Evening"	"323"	3	2	3	8
13002	2015-05-12	"Tue"	"Midday"	"052"	0	5	2	7
13001	2015-05-11	"Mon"	"Evening"	"789"	7	8	9	24
13000	2015-05-11	"Mon"	"Midday"	"515"	5	1	5	11
12999	2015-05-10	"Sun"	"Evening"	"780"	7	8	0	15
12998	2015-05-10	"Sun"	"Midday"	"064"	0	6	4	10
12997	2015-05-09	"Sat"	"Evening"	"519"	5	1	9	15
12996	2015-05-09	"Sat"	"Midday"	"091"	0	9	1	10
12995	2015-05-08	"Fri"	"Evening"	"564"	5	6	4	15
12994	2015-05-08	"Fri"	"Midday"	"231"	2	3	1	6
12993	2015-05-07	"Thu"	"Evening"	"564"	5	6	4	15
12992	2015-05-07	"Thu"	"Midday"	"889"	8	8	9	25
12991	2015-05-06	"Wed"	"Evening"	"159"	1	5	9	15
12990	2015-05-06	"Wed"	"Midday"	"041"	0	4	1	5
12989	2015-05-05	"Tue"	"Evening"	"591"	5	9	1	15
12988	2015-05-05	"Tue"	"Midday"	"939"	9	3	9	21
12987	2015-05-04	"Mon"	"Evening"	"420"	4	2	0	6
12986	2015-05-04	"Mon"	"Midday"	"755"	7	5	5	17
12985	2015-05-03	"Sun"	"Evening"	"858"	8	5	8	21
12984	2015-05-03	"Sun"	"Midday"	"869"	8	6	9	23
12983	2015-05-02	"Sat"	"Evening"	"464"	4	6	4	14
12982	2015-05-02	"Sat"	"Midday"	"635"	6	3	5	14
12981	2015-05-01	"Fri"	"Evening"	"846"	8	4	6	18
12980	2015-05-01	"Fri"	"Midday"	"193"	1	9	3	13
12979	2015-04-30	"Thu"	"Evening"	"380"	3	8	0	11
12978	2015-04-30	"Thu"	"Midday"	"105"	1	0	5	6
12977	2015-04-29	"Wed"	"Evening"	"598"	5	9	8	22
12976	2015-04-29	"Wed"	"Midday"	"814"	8	1	4	13
12975	2015-04-28	"Tue"	"Evening"	"075"	0	7	5	12
12974	2015-04-28	"Tue"	"Midday"	"196"	1	9	6	16
12973	2015-04-27	"Mon"	"Evening"	"011"	0	1	1	2
12972	2015-04-27	"Mon"	"Midday"	"001"	0	0	1	1
12971	2015-04-26	"Sun"	"Evening"	"971"	9	7	1	17
12970	2015-04-26	"Sun"	"Midday"	"514"	5	1	4	10
12969	2015-04-25	"Sat"	"Evening"	"544"	5	4	4	13
12968	2015-04-25	"Sat"	"Midday"	"055"	0	5	5	10
12967	2015-04-24	"Fri"	"Evening"	"280"	2	8	0	10
12966	2015-04-24	"Fri"	"Midday"	"836"	8	3	6	17
12965	2015-04-23	"Thu"	"Evening"	"916"	9	1	6	16
12964	2015-04-23	"Thu"	"Midday"	"643"	6	4	3	13
12963	2015-04-22	"Wed"	"Evening"	"611"	6	1	1	8
12962	2015-04-22	"Wed"	"Midday"	"342"	3	4	2	9
12961	2015-04-21	"Tue"	"Evening"	"304"	3	0	4	7
12960	2015-04-21	"Tue"	"Midday"	"708"	7	0	8	15
12959	2015-04-20	"Mon"	"Evening"	"384"	3	8	4	15
12958	2015-04-20	"Mon"	"Midday"	"044"	0	4	4	8
12957	2015-04-19	"Sun"	"Evening"	"761"	7	6	1	14
12956	2015-04-19	"Sun"	"Midday"	"964"	9	6	4	19
12955	2015-04-18	"Sat"	"Evening"	"013"	0	1	3	4
12954	2015-04-18	"Sat"	"Midday"	"815"	8	1	5	14
12953	2015-04-17	"Fri"	"Evening"	"770"	7	7	0	14
12952	2015-04-17	"Fri"	"Midday"	"972"	9	7	2	18
12951	2015-04-16	"Thu"	"Evening"	"481"	4	8	1	13
12950	2015-04-16	"Thu"	"Midday"	"874"	8	7	4	19
12949	2015-04-15	"Wed"	"Evening"	"190"	1	9	0	10
12948	2015-04-15	"Wed"	"Midday"	"585"	5	8	5	18
12947	2015-04-14	"Tue"	"Evening"	"924"	9	2	4	15
12946	2015-04-14	"Tue"	"Midday"	"773"	7	7	3	17
12945	2015-04-13	"Mon"	"Evening"	"385"	3	8	5	16
12944	2015-04-13	"Mon"	"Midday"	"238"	2	3	8	13
12943	2015-04-12	"Sun"	"Evening"	"544"	5	4	4	13
12942	2015-04-12	"Sun"	"Midday"	"080"	0	8	0	8
12941	2015-04-11	"Sat"	"Evening"	"012"	0	1	2	3
12940	2015-04-11	"Sat"	"Midday"	"196"	1	9	6	16
12939	2015-04-10	"Fri"	"Evening"	"153"	1	5	3	9
12938	2015-04-10	"Fri"	"Midday"	"475"	4	7	5	16
12937	2015-04-09	"Thu"	"Evening"	"995"	9	9	5	23
12936	2015-04-09	"Thu"	"Midday"	"811"	8	1	1	10
12935	2015-04-08	"Wed"	"Evening"	"563"	5	6	3	14
12934	2015-04-08	"Wed"	"Midday"	"807"	8	0	7	15
12933	2015-04-07	"Tue"	"Evening"	"872"	8	7	2	17
12932	2015-04-07	"Tue"	"Midday"	"781"	7	8	1	16
12931	2015-04-06	"Mon"	"Evening"	"023"	0	2	3	5
12930	2015-04-06	"Mon"	"Midday"	"919"	9	1	9	19
12929	2015-04-05	"Sun"	"Evening"	"234"	2	3	4	9
12928	2015-04-05	"Sun"	"Midday"	"093"	0	9	3	12
12927	2015-04-04	"Sat"	"Evening"	"408"	4	0	8	12
12926	2015-04-04	"Sat"	"Midday"	"569"	5	6	9	20
12925	2015-04-03	"Fri"	"Evening"	"681"	6	8	1	15
12924	2015-04-03	"Fri"	"Midday"	"632"	6	3	2	11
12923	2015-04-02	"Thu"	"Evening"	"991"	9	9	1	19
12922	2015-04-02	"Thu"	"Midday"	"293"	2	9	3	14
12921	2015-04-01	"Wed"	"Evening"	"733"	7	3	3	13
12920	2015-04-01	"Wed"	"Midday"	"514"	5	1	4	10
12919	2015-03-31	"Tue"	"Evening"	"596"	5	9	6	20
12918	2015-03-31	"Tue"	"Midday"	"403"	4	0	3	7
12917	2015-03-30	"Mon"	"Evening"	"866"	8	6	6	20
12916	2015-03-30	"Mon"	"Midday"	"376"	3	7	6	16
12915	2015-03-29	"Sun"	"Evening"	"241"	2	4	1	7
12914	2015-03-29	"Sun"	"Midday"	"308"	3	0	8	11
12913	2015-03-28	"Sat"	"Evening"	"189"	1	8	9	18
12912	2015-03-28	"Sat"	"Midday"	"495"	4	9	5	18
12911	2015-03-27	"Fri"	"Evening"	"058"	0	5	8	13
12910	2015-03-27	"Fri"	"Midday"	"468"	4	6	8	18
12909	2015-03-26	"Thu"	"Evening"	"693"	6	9	3	18
12908	2015-03-26	"Thu"	"Midday"	"360"	3	6	0	9
12907	2015-03-25	"Wed"	"Evening"	"388"	3	8	8	19
12906	2015-03-25	"Wed"	"Midday"	"664"	6	6	4	16
12905	2015-03-24	"Tue"	"Evening"	"889"	8	8	9	25
12904	2015-03-24	"Tue"	"Midday"	"054"	0	5	4	9
12903	2015-03-23	"Mon"	"Evening"	"658"	6	5	8	19
12902	2015-03-23	"Mon"	"Midday"	"830"	8	3	0	11
12901	2015-03-22	"Sun"	"Evening"	"842"	8	4	2	14
12900	2015-03-22	"Sun"	"Midday"	"151"	1	5	1	7
12899	2015-03-21	"Sat"	"Evening"	"632"	6	3	2	11
12898	2015-03-21	"Sat"	"Midday"	"520"	5	2	0	7
12897	2015-03-20	"Fri"	"Evening"	"955"	9	5	5	19
12896	2015-03-20	"Fri"	"Midday"	"051"	0	5	1	6
12895	2015-03-19	"Thu"	"Evening"	"842"	8	4	2	14
12894	2015-03-19	"Thu"	"Midday"	"671"	6	7	1	14
12893	2015-03-18	"Wed"	"Evening"	"705"	7	0	5	12
12892	2015-03-18	"Wed"	"Midday"	"456"	4	5	6	15
12891	2015-03-17	"Tue"	"Evening"	"070"	0	7	0	7
12890	2015-03-17	"Tue"	"Midday"	"069"	0	6	9	15
12889	2015-03-16	"Mon"	"Evening"	"084"	0	8	4	12
12888	2015-03-16	"Mon"	"Midday"	"129"	1	2	9	12
12887	2015-03-15	"Sun"	"Evening"	"057"	0	5	7	12
12886	2015-03-15	"Sun"	"Midday"	"587"	5	8	7	20
12885	2015-03-14	"Sat"	"Evening"	"878"	8	7	8	23
12884	2015-03-14	"Sat"	"Midday"	"478"	4	7	8	19
12883	2015-03-13	"Fri"	"Evening"	"889"	8	8	9	25
12882	2015-03-13	"Fri"	"Midday"	"382"	3	8	2	13
12881	2015-03-12	"Thu"	"Evening"	"835"	8	3	5	16
12880	2015-03-12	"Thu"	"Midday"	"934"	9	3	4	16
12879	2015-03-11	"Wed"	"Evening"	"010"	0	1	0	1
12878	2015-03-11	"Wed"	"Midday"	"344"	3	4	4	11
12877	2015-03-10	"Tue"	"Evening"	"842"	8	4	2	14
12876	2015-03-10	"Tue"	"Midday"	"185"	1	8	5	14
12875	2015-03-09	"Mon"	"Evening"	"321"	3	2	1	6
12874	2015-03-09	"Mon"	"Midday"	"755"	7	5	5	17
12873	2015-03-08	"Sun"	"Evening"	"141"	1	4	1	6
12872	2015-03-08	"Sun"	"Midday"	"269"	2	6	9	17
12871	2015-03-07	"Sat"	"Evening"	"933"	9	3	3	15
12870	2015-03-07	"Sat"	"Midday"	"332"	3	3	2	8
12869	2015-03-06	"Fri"	"Evening"	"917"	9	1	7	17
12868	2015-03-06	"Fri"	"Midday"	"898"	8	9	8	25
12867	2015-03-05	"Thu"	"Evening"	"918"	9	1	8	18
12866	2015-03-05	"Thu"	"Midday"	"957"	9	5	7	21
12865	2015-03-04	"Wed"	"Evening"	"410"	4	1	0	5
12864	2015-03-04	"Wed"	"Midday"	"743"	7	4	3	14
12863	2015-03-03	"Tue"	"Evening"	"949"	9	4	9	22
12862	2015-03-03	"Tue"	"Midday"	"712"	7	1	2	10
12861	2015-03-02	"Mon"	"Evening"	"967"	9	6	7	22
12860	2015-03-02	"Mon"	"Midday"	"761"	7	6	1	14
12859	2015-03-01	"Sun"	"Evening"	"461"	4	6	1	11
12858	2015-03-01	"Sun"	"Midday"	"597"	5	9	7	21
12857	2015-02-28	"Sat"	"Evening"	"032"	0	3	2	5
12856	2015-02-28	"Sat"	"Midday"	"263"	2	6	3	11
12855	2015-02-27	"Fri"	"Evening"	"368"	3	6	8	17
12854	2015-02-27	"Fri"	"Midday"	"963"	9	6	3	18
12853	2015-02-26	"Thu"	"Evening"	"234"	2	3	4	9
12852	2015-02-26	"Thu"	"Midday"	"014"	0	1	4	5
12851	2015-02-25	"Wed"	"Evening"	"710"	7	1	0	8
12850	2015-02-25	"Wed"	"Midday"	"782"	7	8	2	17
12849	2015-02-24	"Tue"	"Evening"	"538"	5	3	8	16
12848	2015-02-24	"Tue"	"Midday"	"044"	0	4	4	8
12847	2015-02-23	"Mon"	"Evening"	"995"	9	9	5	23
12846	2015-02-23	"Mon"	"Midday"	"315"	3	1	5	9
12845	2015-02-22	"Sun"	"Evening"	"755"	7	5	5	17
12844	2015-02-22	"Sun"	"Midday"	"987"	9	8	7	24
12843	2015-02-21	"Sat"	"Evening"	"618"	6	1	8	15
12842	2015-02-21	"Sat"	"Midday"	"429"	4	2	9	15
12841	2015-02-20	"Fri"	"Evening"	"121"	1	2	1	4
12840	2015-02-20	"Fri"	"Midday"	"147"	1	4	7	12
12839	2015-02-19	"Thu"	"Evening"	"772"	7	7	2	16
12838	2015-02-19	"Thu"	"Midday"	"563"	5	6	3	14
12837	2015-02-18	"Wed"	"Evening"	"011"	0	1	1	2
12836	2015-02-18	"Wed"	"Midday"	"417"	4	1	7	12
12835	2015-02-17	"Tue"	"Evening"	"202"	2	0	2	4
12834	2015-02-17	"Tue"	"Midday"	"404"	4	0	4	8
12833	2015-02-16	"Mon"	"Evening"	"714"	7	1	4	12
12832	2015-02-16	"Mon"	"Midday"	"317"	3	1	7	11
12831	2015-02-15	"Sun"	"Evening"	"808"	8	0	8	16
12830	2015-02-15	"Sun"	"Midday"	"231"	2	3	1	6
12829	2015-02-14	"Sat"	"Evening"	"904"	9	0	4	13
12828	2015-02-14	"Sat"	"Midday"	"025"	0	2	5	7
12827	2015-02-13	"Fri"	"Evening"	"698"	6	9	8	23
12826	2015-02-13	"Fri"	"Midday"	"296"	2	9	6	17
12825	2015-02-12	"Thu"	"Evening"	"610"	6	1	0	7
12824	2015-02-12	"Thu"	"Midday"	"350"	3	5	0	8
12823	2015-02-11	"Wed"	"Evening"	"388"	3	8	8	19
12822	2015-02-11	"Wed"	"Midday"	"008"	0	0	8	8
12821	2015-02-10	"Tue"	"Evening"	"276"	2	7	6	15
12820	2015-02-10	"Tue"	"Midday"	"338"	3	3	8	14
12819	2015-02-09	"Mon"	"Evening"	"701"	7	0	1	8
12818	2015-02-09	"Mon"	"Midday"	"489"	4	8	9	21
12817	2015-02-08	"Sun"	"Evening"	"257"	2	5	7	14
12816	2015-02-08	"Sun"	"Midday"	"919"	9	1	9	19
12815	2015-02-07	"Sat"	"Evening"	"065"	0	6	5	11
12814	2015-02-07	"Sat"	"Midday"	"477"	4	7	7	18
12813	2015-02-06	"Fri"	"Evening"	"802"	8	0	2	10
12812	2015-02-06	"Fri"	"Midday"	"778"	7	7	8	22
12811	2015-02-05	"Thu"	"Evening"	"688"	6	8	8	22
12810	2015-02-05	"Thu"	"Midday"	"514"	5	1	4	10
12809	2015-02-04	"Wed"	"Evening"	"264"	2	6	4	12
12808	2015-02-04	"Wed"	"Midday"	"120"	1	2	0	3
12807	2015-02-03	"Tue"	"Evening"	"405"	4	0	5	9
12806	2015-02-03	"Tue"	"Midday"	"887"	8	8	7	23
12805	2015-02-02	"Mon"	"Evening"	"131"	1	3	1	5
12804	2015-02-02	"Mon"	"Midday"	"409"	4	0	9	13
12803	2015-02-01	"Sun"	"Evening"	"076"	0	7	6	13
12802	2015-02-01	"Sun"	"Midday"	"147"	1	4	7	12
12801	2015-01-31	"Sat"	"Evening"	"388"	3	8	8	19
12800	2015-01-31	"Sat"	"Midday"	"854"	8	5	4	17
12799	2015-01-30	"Fri"	"Evening"	"901"	9	0	1	10
12798	2015-01-30	"Fri"	"Midday"	"241"	2	4	1	7
12797	2015-01-29	"Thu"	"Evening"	"916"	9	1	6	16
12796	2015-01-29	"Thu"	"Midday"	"826"	8	2	6	16
12795	2015-01-28	"Wed"	"Evening"	"572"	5	7	2	14
12794	2015-01-28	"Wed"	"Midday"	"870"	8	7	0	15
12793	2015-01-27	"Tue"	"Evening"	"738"	7	3	8	18
12792	2015-01-27	"Tue"	"Midday"	"640"	6	4	0	10
12791	2015-01-26	"Mon"	"Evening"	"460"	4	6	0	10
12790	2015-01-26	"Mon"	"Midday"	"602"	6	0	2	8
12789	2015-01-25	"Sun"	"Evening"	"254"	2	5	4	11
12788	2015-01-25	"Sun"	"Midday"	"135"	1	3	5	9
12787	2015-01-24	"Sat"	"Evening"	"963"	9	6	3	18
12786	2015-01-24	"Sat"	"Midday"	"953"	9	5	3	17
12785	2015-01-23	"Fri"	"Evening"	"872"	8	7	2	17
12784	2015-01-23	"Fri"	"Midday"	"414"	4	1	4	9
12783	2015-01-22	"Thu"	"Evening"	"721"	7	2	1	10
12782	2015-01-22	"Thu"	"Midday"	"575"	5	7	5	17
12781	2015-01-21	"Wed"	"Evening"	"484"	4	8	4	16
12780	2015-01-21	"Wed"	"Midday"	"010"	0	1	0	1
12779	2015-01-20	"Tue"	"Evening"	"137"	1	3	7	11
12778	2015-01-20	"Tue"	"Midday"	"107"	1	0	7	8
12777	2015-01-19	"Mon"	"Evening"	"189"	1	8	9	18
12776	2015-01-19	"Mon"	"Midday"	"370"	3	7	0	10
12775	2015-01-18	"Sun"	"Evening"	"462"	4	6	2	12
12774	2015-01-18	"Sun"	"Midday"	"755"	7	5	5	17
12773	2015-01-17	"Sat"	"Evening"	"917"	9	1	7	17
12772	2015-01-17	"Sat"	"Midday"	"154"	1	5	4	10
12771	2015-01-16	"Fri"	"Evening"	"946"	9	4	6	19
12770	2015-01-16	"Fri"	"Midday"	"145"	1	4	5	10
12769	2015-01-15	"Thu"	"Evening"	"773"	7	7	3	17
12768	2015-01-15	"Thu"	"Midday"	"911"	9	1	1	11
12767	2015-01-14	"Wed"	"Evening"	"939"	9	3	9	21
12766	2015-01-14	"Wed"	"Midday"	"350"	3	5	0	8
12765	2015-01-13	"Tue"	"Evening"	"148"	1	4	8	13
12764	2015-01-13	"Tue"	"Midday"	"189"	1	8	9	18
12763	2015-01-12	"Mon"	"Evening"	"982"	9	8	2	19
12762	2015-01-12	"Mon"	"Midday"	"322"	3	2	2	7
12761	2015-01-11	"Sun"	"Evening"	"816"	8	1	6	15
12760	2015-01-11	"Sun"	"Midday"	"552"	5	5	2	12
12759	2015-01-10	"Sat"	"Evening"	"592"	5	9	2	16
12758	2015-01-10	"Sat"	"Midday"	"106"	1	0	6	7
12757	2015-01-09	"Fri"	"Evening"	"909"	9	0	9	18
12756	2015-01-09	"Fri"	"Midday"	"324"	3	2	4	9
12755	2015-01-08	"Thu"	"Evening"	"330"	3	3	0	6
12754	2015-01-08	"Thu"	"Midday"	"515"	5	1	5	11
12753	2015-01-07	"Wed"	"Evening"	"665"	6	6	5	17
12752	2015-01-07	"Wed"	"Midday"	"671"	6	7	1	14
12751	2015-01-06	"Tue"	"Evening"	"712"	7	1	2	10
12750	2015-01-06	"Tue"	"Midday"	"396"	3	9	6	18
12749	2015-01-05	"Mon"	"Evening"	"239"	2	3	9	14
12748	2015-01-05	"Mon"	"Midday"	"485"	4	8	5	17
12747	2015-01-04	"Sun"	"Evening"	"549"	5	4	9	18
12746	2015-01-04	"Sun"	"Midday"	"051"	0	5	1	6
12745	2015-01-03	"Sat"	"Evening"	"080"	0	8	0	8
12744	2015-01-03	"Sat"	"Midday"	"230"	2	3	0	5
12743	2015-01-02	"Fri"	"Evening"	"710"	7	1	0	8
12742	2015-01-02	"Fri"	"Midday"	"939"	9	3	9	21
12741	2015-01-01	"Thu"	"Evening"	"900"	9	0	0	9
12740	2015-01-01	"Thu"	"Midday"	"250"	2	5	0	7
12739	2014-12-31	"Wed"	"Evening"	"853"	8	5	3	16
12738	2014-12-31	"Wed"	"Midday"	"305"	3	0	5	8
12737	2014-12-30	"Tue"	"Evening"	"887"	8	8	7	23
12736	2014-12-30	"Tue"	"Midday"	"707"	7	0	7	14
12735	2014-12-29	"Mon"	"Evening"	"869"	8	6	9	23
12734	2014-12-29	"Mon"	"Midday"	"026"	0	2	6	8
12733	2014-12-28	"Sun"	"Evening"	"003"	0	0	3	3
12732	2014-12-28	"Sun"	"Midday"	"555"	5	5	5	15
12731	2014-12-27	"Sat"	"Evening"	"860"	8	6	0	14
12730	2014-12-27	"Sat"	"Midday"	"525"	5	2	5	12
12729	2014-12-26	"Fri"	"Evening"	"334"	3	3	4	10
12728	2014-12-26	"Fri"	"Midday"	"919"	9	1	9	19
12727	2014-12-25	"Thu"	"Evening"	"366"	3	6	6	15
12726	2014-12-25	"Thu"	"Midday"	"631"	6	3	1	10
12725	2014-12-24	"Wed"	"Evening"	"684"	6	8	4	18
12724	2014-12-24	"Wed"	"Midday"	"478"	4	7	8	19
12723	2014-12-23	"Tue"	"Evening"	"493"	4	9	3	16
12722	2014-12-23	"Tue"	"Midday"	"981"	9	8	1	18
12721	2014-12-22	"Mon"	"Evening"	"605"	6	0	5	11
12720	2014-12-22	"Mon"	"Midday"	"632"	6	3	2	11
12719	2014-12-21	"Sun"	"Evening"	"770"	7	7	0	14
12718	2014-12-21	"Sun"	"Midday"	"545"	5	4	5	14
12717	2014-12-20	"Sat"	"Evening"	"790"	7	9	0	16
12716	2014-12-20	"Sat"	"Midday"	"745"	7	4	5	16
12715	2014-12-19	"Fri"	"Evening"	"742"	7	4	2	13
12714	2014-12-19	"Fri"	"Midday"	"554"	5	5	4	14
12713	2014-12-18	"Thu"	"Evening"	"871"	8	7	1	16
12712	2014-12-18	"Thu"	"Midday"	"273"	2	7	3	12
12711	2014-12-17	"Wed"	"Evening"	"810"	8	1	0	9
12710	2014-12-17	"Wed"	"Midday"	"368"	3	6	8	17
12709	2014-12-16	"Tue"	"Evening"	"069"	0	6	9	15
12708	2014-12-16	"Tue"	"Midday"	"891"	8	9	1	18
12707	2014-12-15	"Mon"	"Evening"	"368"	3	6	8	17
12706	2014-12-15	"Mon"	"Midday"	"245"	2	4	5	11
12705	2014-12-14	"Sun"	"Evening"	"892"	8	9	2	19
12704	2014-12-14	"Sun"	"Midday"	"599"	5	9	9	23
12703	2014-12-13	"Sat"	"Evening"	"661"	6	6	1	13
12702	2014-12-13	"Sat"	"Midday"	"322"	3	2	2	7
12701	2014-12-12	"Fri"	"Evening"	"313"	3	1	3	7
12700	2014-12-12	"Fri"	"Midday"	"175"	1	7	5	13
12699	2014-12-11	"Thu"	"Evening"	"105"	1	0	5	6
12698	2014-12-11	"Thu"	"Midday"	"969"	9	6	9	24
12697	2014-12-10	"Wed"	"Evening"	"030"	0	3	0	3
12696	2014-12-10	"Wed"	"Midday"	"812"	8	1	2	11
12695	2014-12-09	"Tue"	"Evening"	"168"	1	6	8	15
12694	2014-12-09	"Tue"	"Midday"	"041"	0	4	1	5
12693	2014-12-08	"Mon"	"Evening"	"511"	5	1	1	7
12692	2014-12-08	"Mon"	"Midday"	"396"	3	9	6	18
12691	2014-12-07	"Sun"	"Evening"	"178"	1	7	8	16
12690	2014-12-07	"Sun"	"Midday"	"229"	2	2	9	13
12689	2014-12-06	"Sat"	"Evening"	"367"	3	6	7	16
12688	2014-12-06	"Sat"	"Midday"	"090"	0	9	0	9
12687	2014-12-05	"Fri"	"Evening"	"610"	6	1	0	7
12686	2014-12-05	"Fri"	"Midday"	"810"	8	1	0	9
12685	2014-12-04	"Thu"	"Evening"	"203"	2	0	3	5
12684	2014-12-04	"Thu"	"Midday"	"509"	5	0	9	14
12683	2014-12-03	"Wed"	"Evening"	"415"	4	1	5	10
12682	2014-12-03	"Wed"	"Midday"	"004"	0	0	4	4
12681	2014-12-02	"Tue"	"Evening"	"671"	6	7	1	14
12680	2014-12-02	"Tue"	"Midday"	"280"	2	8	0	10
12679	2014-12-01	"Mon"	"Evening"	"689"	6	8	9	23
12678	2014-12-01	"Mon"	"Midday"	"920"	9	2	0	11
12677	2014-11-30	"Sun"	"Evening"	"608"	6	0	8	14
12676	2014-11-30	"Sun"	"Midday"	"540"	5	4	0	9
12675	2014-11-29	"Sat"	"Evening"	"995"	9	9	5	23
12674	2014-11-29	"Sat"	"Midday"	"116"	1	1	6	8
12673	2014-11-28	"Fri"	"Evening"	"703"	7	0	3	10
12672	2014-11-28	"Fri"	"Midday"	"657"	6	5	7	18
12671	2014-11-27	"Thu"	"Evening"	"002"	0	0	2	2
12670	2014-11-27	"Thu"	"Midday"	"686"	6	8	6	20
12669	2014-11-26	"Wed"	"Evening"	"801"	8	0	1	9
12668	2014-11-26	"Wed"	"Midday"	"221"	2	2	1	5
12667	2014-11-25	"Tue"	"Evening"	"661"	6	6	1	13
12666	2014-11-25	"Tue"	"Midday"	"203"	2	0	3	5
12665	2014-11-24	"Mon"	"Evening"	"762"	7	6	2	15
12664	2014-11-24	"Mon"	"Midday"	"687"	6	8	7	21
12663	2014-11-23	"Sun"	"Evening"	"804"	8	0	4	12
12662	2014-11-23	"Sun"	"Midday"	"458"	4	5	8	17
12661	2014-11-22	"Sat"	"Evening"	"769"	7	6	9	22
12660	2014-11-22	"Sat"	"Midday"	"474"	4	7	4	15
12659	2014-11-21	"Fri"	"Evening"	"420"	4	2	0	6
12658	2014-11-21	"Fri"	"Midday"	"211"	2	1	1	4
12657	2014-11-20	"Thu"	"Evening"	"579"	5	7	9	21
12656	2014-11-20	"Thu"	"Midday"	"528"	5	2	8	15
12655	2014-11-19	"Wed"	"Evening"	"785"	7	8	5	20
12654	2014-11-19	"Wed"	"Midday"	"620"	6	2	0	8
12653	2014-11-18	"Tue"	"Evening"	"484"	4	8	4	16
12652	2014-11-18	"Tue"	"Midday"	"080"	0	8	0	8
12651	2014-11-17	"Mon"	"Evening"	"188"	1	8	8	17
12650	2014-11-17	"Mon"	"Midday"	"300"	3	0	0	3
12649	2014-11-16	"Sun"	"Evening"	"004"	0	0	4	4
12648	2014-11-16	"Sun"	"Midday"	"946"	9	4	6	19
12647	2014-11-15	"Sat"	"Evening"	"250"	2	5	0	7
12646	2014-11-15	"Sat"	"Midday"	"501"	5	0	1	6
12645	2014-11-14	"Fri"	"Evening"	"543"	5	4	3	12
12644	2014-11-14	"Fri"	"Midday"	"908"	9	0	8	17
12643	2014-11-13	"Thu"	"Evening"	"750"	7	5	0	12
12642	2014-11-13	"Thu"	"Midday"	"024"	0	2	4	6
12641	2014-11-12	"Wed"	"Evening"	"004"	0	0	4	4
12640	2014-11-12	"Wed"	"Midday"	"285"	2	8	5	15
12639	2014-11-11	"Tue"	"Evening"	"545"	5	4	5	14
12638	2014-11-11	"Tue"	"Midday"	"222"	2	2	2	6
12637	2014-11-10	"Mon"	"Evening"	"215"	2	1	5	8
12636	2014-11-10	"Mon"	"Midday"	"938"	9	3	8	20
12635	2014-11-09	"Sun"	"Evening"	"011"	0	1	1	2
12634	2014-11-09	"Sun"	"Midday"	"496"	4	9	6	19
12633	2014-11-08	"Sat"	"Evening"	"642"	6	4	2	12
12632	2014-11-08	"Sat"	"Midday"	"670"	6	7	0	13
12631	2014-11-07	"Fri"	"Evening"	"462"	4	6	2	12
12630	2014-11-07	"Fri"	"Midday"	"819"	8	1	9	18
12629	2014-11-06	"Thu"	"Evening"	"767"	7	6	7	20
12628	2014-11-06	"Thu"	"Midday"	"514"	5	1	4	10
12627	2014-11-05	"Wed"	"Evening"	"513"	5	1	3	9
12626	2014-11-05	"Wed"	"Midday"	"738"	7	3	8	18
12625	2014-11-04	"Tue"	"Evening"	"457"	4	5	7	16
12624	2014-11-04	"Tue"	"Midday"	"592"	5	9	2	16
12623	2014-11-03	"Mon"	"Evening"	"625"	6	2	5	13
12622	2014-11-03	"Mon"	"Midday"	"295"	2	9	5	16
12621	2014-11-02	"Sun"	"Evening"	"328"	3	2	8	13
12620	2014-11-02	"Sun"	"Midday"	"652"	6	5	2	13
12619	2014-11-01	"Sat"	"Evening"	"575"	5	7	5	17
12618	2014-11-01	"Sat"	"Midday"	"945"	9	4	5	18
12617	2014-10-31	"Fri"	"Evening"	"433"	4	3	3	10
12616	2014-10-31	"Fri"	"Midday"	"030"	0	3	0	3
12615	2014-10-30	"Thu"	"Evening"	"180"	1	8	0	9
12614	2014-10-30	"Thu"	"Midday"	"553"	5	5	3	13
12613	2014-10-29	"Wed"	"Evening"	"156"	1	5	6	12
12612	2014-10-29	"Wed"	"Midday"	"880"	8	8	0	16
12611	2014-10-28	"Tue"	"Evening"	"126"	1	2	6	9
12610	2014-10-28	"Tue"	"Midday"	"479"	4	7	9	20
12609	2014-10-27	"Mon"	"Evening"	"860"	8	6	0	14
12608	2014-10-27	"Mon"	"Midday"	"251"	2	5	1	8
12607	2014-10-26	"Sun"	"Evening"	"677"	6	7	7	20
12606	2014-10-26	"Sun"	"Midday"	"466"	4	6	6	16
12605	2014-10-25	"Sat"	"Evening"	"983"	9	8	3	20
12604	2014-10-25	"Sat"	"Midday"	"132"	1	3	2	6
12603	2014-10-24	"Fri"	"Evening"	"942"	9	4	2	15
12602	2014-10-24	"Fri"	"Midday"	"781"	7	8	1	16
12601	2014-10-23	"Thu"	"Evening"	"053"	0	5	3	8
12600	2014-10-23	"Thu"	"Midday"	"568"	5	6	8	19
12599	2014-10-22	"Wed"	"Evening"	"253"	2	5	3	10
12598	2014-10-22	"Wed"	"Midday"	"870"	8	7	0	15
12597	2014-10-21	"Tue"	"Evening"	"196"	1	9	6	16
12596	2014-10-21	"Tue"	"Midday"	"338"	3	3	8	14
12595	2014-10-20	"Mon"	"Evening"	"880"	8	8	0	16
12594	2014-10-20	"Mon"	"Midday"	"626"	6	2	6	14
12593	2014-10-19	"Sun"	"Evening"	"473"	4	7	3	14
12592	2014-10-19	"Sun"	"Midday"	"320"	3	2	0	5
12591	2014-10-18	"Sat"	"Evening"	"327"	3	2	7	12
12590	2014-10-18	"Sat"	"Midday"	"075"	0	7	5	12
12589	2014-10-17	"Fri"	"Evening"	"891"	8	9	1	18
12588	2014-10-17	"Fri"	"Midday"	"392"	3	9	2	14
12587	2014-10-16	"Thu"	"Evening"	"786"	7	8	6	21
12586	2014-10-16	"Thu"	"Midday"	"646"	6	4	6	16
12585	2014-10-15	"Wed"	"Evening"	"698"	6	9	8	23
12584	2014-10-15	"Wed"	"Midday"	"629"	6	2	9	17
12583	2014-10-14	"Tue"	"Evening"	"725"	7	2	5	14
12582	2014-10-14	"Tue"	"Midday"	"846"	8	4	6	18
12581	2014-10-13	"Mon"	"Evening"	"514"	5	1	4	10
12580	2014-10-13	"Mon"	"Midday"	"642"	6	4	2	12
12579	2014-10-12	"Sun"	"Evening"	"449"	4	4	9	17
12578	2014-10-12	"Sun"	"Midday"	"067"	0	6	7	13
12577	2014-10-11	"Sat"	"Evening"	"960"	9	6	0	15
12576	2014-10-11	"Sat"	"Midday"	"203"	2	0	3	5
12575	2014-10-10	"Fri"	"Evening"	"737"	7	3	7	17
12574	2014-10-10	"Fri"	"Midday"	"020"	0	2	0	2
12573	2014-10-09	"Thu"	"Evening"	"019"	0	1	9	10
12572	2014-10-09	"Thu"	"Midday"	"978"	9	7	8	24
12571	2014-10-08	"Wed"	"Evening"	"372"	3	7	2	12
12570	2014-10-08	"Wed"	"Midday"	"138"	1	3	8	12
12569	2014-10-07	"Tue"	"Evening"	"624"	6	2	4	12
12568	2014-10-07	"Tue"	"Midday"	"714"	7	1	4	12
12567	2014-10-06	"Mon"	"Evening"	"976"	9	7	6	22
12566	2014-10-06	"Mon"	"Midday"	"792"	7	9	2	18
12565	2014-10-05	"Sun"	"Evening"	"795"	7	9	5	21
12564	2014-10-05	"Sun"	"Midday"	"362"	3	6	2	11
12563	2014-10-04	"Sat"	"Evening"	"999"	9	9	9	27
12562	2014-10-04	"Sat"	"Midday"	"144"	1	4	4	9
12561	2014-10-03	"Fri"	"Evening"	"739"	7	3	9	19
12560	2014-10-03	"Fri"	"Midday"	"558"	5	5	8	18
12559	2014-10-02	"Thu"	"Evening"	"306"	3	0	6	9
12558	2014-10-02	"Thu"	"Midday"	"802"	8	0	2	10
12557	2014-10-01	"Wed"	"Evening"	"162"	1	6	2	9
12556	2014-10-01	"Wed"	"Midday"	"098"	0	9	8	17
12555	2014-09-30	"Tue"	"Evening"	"582"	5	8	2	15
12554	2014-09-30	"Tue"	"Midday"	"541"	5	4	1	10
12553	2014-09-29	"Mon"	"Evening"	"016"	0	1	6	7
12552	2014-09-29	"Mon"	"Midday"	"685"	6	8	5	19
12551	2014-09-28	"Sun"	"Evening"	"242"	2	4	2	8
12550	2014-09-28	"Sun"	"Midday"	"979"	9	7	9	25
12549	2014-09-27	"Sat"	"Evening"	"981"	9	8	1	18
12548	2014-09-27	"Sat"	"Midday"	"586"	5	8	6	19
12547	2014-09-26	"Fri"	"Evening"	"722"	7	2	2	11
12546	2014-09-26	"Fri"	"Midday"	"305"	3	0	5	8
12545	2014-09-25	"Thu"	"Evening"	"512"	5	1	2	8
12544	2014-09-25	"Thu"	"Midday"	"102"	1	0	2	3
12543	2014-09-24	"Wed"	"Evening"	"193"	1	9	3	13
12542	2014-09-24	"Wed"	"Midday"	"203"	2	0	3	5
12541	2014-09-23	"Tue"	"Evening"	"247"	2	4	7	13
12540	2014-09-23	"Tue"	"Midday"	"960"	9	6	0	15
12539	2014-09-22	"Mon"	"Evening"	"293"	2	9	3	14
12538	2014-09-22	"Mon"	"Midday"	"137"	1	3	7	11
12537	2014-09-21	"Sun"	"Evening"	"018"	0	1	8	9
12536	2014-09-21	"Sun"	"Midday"	"348"	3	4	8	15
12535	2014-09-20	"Sat"	"Evening"	"791"	7	9	1	17
12534	2014-09-20	"Sat"	"Midday"	"120"	1	2	0	3
12533	2014-09-19	"Fri"	"Evening"	"201"	2	0	1	3
12532	2014-09-19	"Fri"	"Midday"	"903"	9	0	3	12
12531	2014-09-18	"Thu"	"Evening"	"912"	9	1	2	12
12530	2014-09-18	"Thu"	"Midday"	"595"	5	9	5	19
12529	2014-09-17	"Wed"	"Evening"	"601"	6	0	1	7
12528	2014-09-17	"Wed"	"Midday"	"712"	7	1	2	10
12527	2014-09-16	"Tue"	"Evening"	"497"	4	9	7	20
12526	2014-09-16	"Tue"	"Midday"	"143"	1	4	3	8
12525	2014-09-15	"Mon"	"Evening"	"506"	5	0	6	11
12524	2014-09-15	"Mon"	"Midday"	"931"	9	3	1	13
12523	2014-09-14	"Sun"	"Evening"	"277"	2	7	7	16
12522	2014-09-14	"Sun"	"Midday"	"430"	4	3	0	7
12521	2014-09-13	"Sat"	"Evening"	"266"	2	6	6	14
12520	2014-09-13	"Sat"	"Midday"	"344"	3	4	4	11
12519	2014-09-12	"Fri"	"Evening"	"845"	8	4	5	17
12518	2014-09-12	"Fri"	"Midday"	"902"	9	0	2	11
12517	2014-09-11	"Thu"	"Evening"	"857"	8	5	7	20
12516	2014-09-11	"Thu"	"Midday"	"768"	7	6	8	21
12515	2014-09-10	"Wed"	"Evening"	"521"	5	2	1	8
12514	2014-09-10	"Wed"	"Midday"	"715"	7	1	5	13
12513	2014-09-09	"Tue"	"Evening"	"515"	5	1	5	11
12512	2014-09-09	"Tue"	"Midday"	"273"	2	7	3	12
12511	2014-09-08	"Mon"	"Evening"	"217"	2	1	7	10
12510	2014-09-08	"Mon"	"Midday"	"370"	3	7	0	10
12509	2014-09-07	"Sun"	"Evening"	"317"	3	1	7	11
12508	2014-09-07	"Sun"	"Midday"	"204"	2	0	4	6
12507	2014-09-06	"Sat"	"Evening"	"449"	4	4	9	17
12506	2014-09-06	"Sat"	"Midday"	"864"	8	6	4	18
12505	2014-09-05	"Fri"	"Evening"	"317"	3	1	7	11
12504	2014-09-05	"Fri"	"Midday"	"282"	2	8	2	12
12503	2014-09-04	"Thu"	"Evening"	"769"	7	6	9	22
12502	2014-09-04	"Thu"	"Midday"	"652"	6	5	2	13
12501	2014-09-03	"Wed"	"Evening"	"054"	0	5	4	9
12500	2014-09-03	"Wed"	"Midday"	"864"	8	6	4	18
12499	2014-09-02	"Tue"	"Evening"	"010"	0	1	0	1
12498	2014-09-02	"Tue"	"Midday"	"820"	8	2	0	10
12497	2014-09-01	"Mon"	"Evening"	"527"	5	2	7	14
12496	2014-09-01	"Mon"	"Midday"	"612"	6	1	2	9
12495	2014-08-31	"Sun"	"Evening"	"527"	5	2	7	14
12494	2014-08-31	"Sun"	"Midday"	"917"	9	1	7	17
12493	2014-08-30	"Sat"	"Evening"	"209"	2	0	9	11
12492	2014-08-30	"Sat"	"Midday"	"597"	5	9	7	21
12491	2014-08-29	"Fri"	"Evening"	"789"	7	8	9	24
12490	2014-08-29	"Fri"	"Midday"	"165"	1	6	5	12
12489	2014-08-28	"Thu"	"Evening"	"467"	4	6	7	17
12488	2014-08-28	"Thu"	"Midday"	"504"	5	0	4	9
12487	2014-08-27	"Wed"	"Evening"	"186"	1	8	6	15
12486	2014-08-27	"Wed"	"Midday"	"551"	5	5	1	11
12485	2014-08-26	"Tue"	"Evening"	"973"	9	7	3	19
12484	2014-08-26	"Tue"	"Midday"	"805"	8	0	5	13
12483	2014-08-25	"Mon"	"Evening"	"915"	9	1	5	15
12482	2014-08-25	"Mon"	"Midday"	"754"	7	5	4	16
12481	2014-08-24	"Sun"	"Evening"	"540"	5	4	0	9
12480	2014-08-24	"Sun"	"Midday"	"270"	2	7	0	9
12479	2014-08-23	"Sat"	"Evening"	"888"	8	8	8	24
12478	2014-08-23	"Sat"	"Midday"	"249"	2	4	9	15
12477	2014-08-22	"Fri"	"Evening"	"465"	4	6	5	15
12476	2014-08-22	"Fri"	"Midday"	"208"	2	0	8	10
12475	2014-08-21	"Thu"	"Evening"	"408"	4	0	8	12
12474	2014-08-21	"Thu"	"Midday"	"074"	0	7	4	11
12473	2014-08-20	"Wed"	"Evening"	"454"	4	5	4	13
12472	2014-08-20	"Wed"	"Midday"	"489"	4	8	9	21
12471	2014-08-19	"Tue"	"Evening"	"237"	2	3	7	12
12470	2014-08-19	"Tue"	"Midday"	"897"	8	9	7	24
12469	2014-08-18	"Mon"	"Evening"	"177"	1	7	7	15
12468	2014-08-18	"Mon"	"Midday"	"385"	3	8	5	16
12467	2014-08-17	"Sun"	"Evening"	"403"	4	0	3	7
12466	2014-08-17	"Sun"	"Midday"	"656"	6	5	6	17
12465	2014-08-16	"Sat"	"Evening"	"536"	5	3	6	14
12464	2014-08-16	"Sat"	"Midday"	"578"	5	7	8	20
12463	2014-08-15	"Fri"	"Evening"	"404"	4	0	4	8
12462	2014-08-15	"Fri"	"Midday"	"177"	1	7	7	15
12461	2014-08-14	"Thu"	"Evening"	"736"	7	3	6	16
12460	2014-08-14	"Thu"	"Midday"	"034"	0	3	4	7
12459	2014-08-13	"Wed"	"Evening"	"804"	8	0	4	12
12458	2014-08-13	"Wed"	"Midday"	"594"	5	9	4	18
12457	2014-08-12	"Tue"	"Evening"	"761"	7	6	1	14
12456	2014-08-12	"Tue"	"Midday"	"268"	2	6	8	16
12455	2014-08-11	"Mon"	"Evening"	"631"	6	3	1	10
12454	2014-08-11	"Mon"	"Midday"	"903"	9	0	3	12
12453	2014-08-10	"Sun"	"Evening"	"409"	4	0	9	13
12452	2014-08-10	"Sun"	"Midday"	"031"	0	3	1	4
12451	2014-08-09	"Sat"	"Evening"	"555"	5	5	5	15
12450	2014-08-09	"Sat"	"Midday"	"097"	0	9	7	16
12449	2014-08-08	"Fri"	"Evening"	"310"	3	1	0	4
12448	2014-08-08	"Fri"	"Midday"	"734"	7	3	4	14
12447	2014-08-07	"Thu"	"Evening"	"691"	6	9	1	16
12446	2014-08-07	"Thu"	"Midday"	"722"	7	2	2	11
12445	2014-08-06	"Wed"	"Evening"	"293"	2	9	3	14
12444	2014-08-06	"Wed"	"Midday"	"330"	3	3	0	6
12443	2014-08-05	"Tue"	"Evening"	"927"	9	2	7	18
12442	2014-08-05	"Tue"	"Midday"	"129"	1	2	9	12
12441	2014-08-04	"Mon"	"Evening"	"066"	0	6	6	12
12440	2014-08-04	"Mon"	"Midday"	"836"	8	3	6	17
12439	2014-08-03	"Sun"	"Evening"	"408"	4	0	8	12
12438	2014-08-03	"Sun"	"Midday"	"956"	9	5	6	20
12437	2014-08-02	"Sat"	"Evening"	"494"	4	9	4	17
12436	2014-08-02	"Sat"	"Midday"	"523"	5	2	3	10
12435	2014-08-01	"Fri"	"Evening"	"468"	4	6	8	18
12434	2014-08-01	"Fri"	"Midday"	"928"	9	2	8	19
12433	2014-07-31	"Thu"	"Evening"	"314"	3	1	4	8
12432	2014-07-31	"Thu"	"Midday"	"365"	3	6	5	14
12431	2014-07-30	"Wed"	"Evening"	"651"	6	5	1	12
12430	2014-07-30	"Wed"	"Midday"	"693"	6	9	3	18
12429	2014-07-29	"Tue"	"Evening"	"909"	9	0	9	18
12428	2014-07-29	"Tue"	"Midday"	"215"	2	1	5	8
12427	2014-07-28	"Mon"	"Evening"	"638"	6	3	8	17
12426	2014-07-28	"Mon"	"Midday"	"827"	8	2	7	17
12425	2014-07-27	"Sun"	"Evening"	"334"	3	3	4	10
12424	2014-07-27	"Sun"	"Midday"	"509"	5	0	9	14
12423	2014-07-26	"Sat"	"Evening"	"008"	0	0	8	8
12422	2014-07-26	"Sat"	"Midday"	"815"	8	1	5	14
12421	2014-07-25	"Fri"	"Evening"	"380"	3	8	0	11
12420	2014-07-25	"Fri"	"Midday"	"051"	0	5	1	6
12419	2014-07-24	"Thu"	"Evening"	"379"	3	7	9	19
12418	2014-07-24	"Thu"	"Midday"	"251"	2	5	1	8
12417	2014-07-23	"Wed"	"Evening"	"731"	7	3	1	11
12416	2014-07-23	"Wed"	"Midday"	"302"	3	0	2	5
12415	2014-07-22	"Tue"	"Evening"	"577"	5	7	7	19
12414	2014-07-22	"Tue"	"Midday"	"981"	9	8	1	18
12413	2014-07-21	"Mon"	"Evening"	"679"	6	7	9	22
12412	2014-07-21	"Mon"	"Midday"	"327"	3	2	7	12
12411	2014-07-20	"Sun"	"Evening"	"719"	7	1	9	17
12410	2014-07-20	"Sun"	"Midday"	"010"	0	1	0	1
12409	2014-07-19	"Sat"	"Evening"	"716"	7	1	6	14
12408	2014-07-19	"Sat"	"Midday"	"114"	1	1	4	6
12407	2014-07-18	"Fri"	"Evening"	"164"	1	6	4	11
12406	2014-07-18	"Fri"	"Midday"	"213"	2	1	3	6
12405	2014-07-17	"Thu"	"Evening"	"760"	7	6	0	13
12404	2014-07-17	"Thu"	"Midday"	"987"	9	8	7	24
12403	2014-07-16	"Wed"	"Evening"	"476"	4	7	6	17
12402	2014-07-16	"Wed"	"Midday"	"608"	6	0	8	14
12401	2014-07-15	"Tue"	"Evening"	"918"	9	1	8	18
12400	2014-07-15	"Tue"	"Midday"	"457"	4	5	7	16
12399	2014-07-14	"Mon"	"Evening"	"800"	8	0	0	8
12398	2014-07-14	"Mon"	"Midday"	"167"	1	6	7	14
12397	2014-07-13	"Sun"	"Evening"	"785"	7	8	5	20
12396	2014-07-13	"Sun"	"Midday"	"527"	5	2	7	14
12395	2014-07-12	"Sat"	"Evening"	"045"	0	4	5	9
12394	2014-07-12	"Sat"	"Midday"	"219"	2	1	9	12
12393	2014-07-11	"Fri"	"Evening"	"311"	3	1	1	5
12392	2014-07-11	"Fri"	"Midday"	"513"	5	1	3	9
12391	2014-07-10	"Thu"	"Evening"	"639"	6	3	9	18
12390	2014-07-10	"Thu"	"Midday"	"858"	8	5	8	21
12389	2014-07-09	"Wed"	"Evening"	"746"	7	4	6	17
12388	2014-07-09	"Wed"	"Midday"	"349"	3	4	9	16
12387	2014-07-08	"Tue"	"Evening"	"732"	7	3	2	12
12386	2014-07-08	"Tue"	"Midday"	"016"	0	1	6	7
12385	2014-07-07	"Mon"	"Evening"	"486"	4	8	6	18
12384	2014-07-07	"Mon"	"Midday"	"948"	9	4	8	21
12383	2014-07-06	"Sun"	"Evening"	"883"	8	8	3	19
12382	2014-07-06	"Sun"	"Midday"	"052"	0	5	2	7
12381	2014-07-05	"Sat"	"Evening"	"883"	8	8	3	19
12380	2014-07-05	"Sat"	"Midday"	"118"	1	1	8	10
12379	2014-07-04	"Fri"	"Evening"	"591"	5	9	1	15
12378	2014-07-04	"Fri"	"Midday"	"333"	3	3	3	9
12377	2014-07-03	"Thu"	"Evening"	"296"	2	9	6	17
12376	2014-07-03	"Thu"	"Midday"	"141"	1	4	1	6
12375	2014-07-02	"Wed"	"Evening"	"493"	4	9	3	16
12374	2014-07-02	"Wed"	"Midday"	"345"	3	4	5	12
12373	2014-07-01	"Tue"	"Evening"	"321"	3	2	1	6
12372	2014-07-01	"Tue"	"Midday"	"015"	0	1	5	6
12371	2014-06-30	"Mon"	"Evening"	"768"	7	6	8	21
12370	2014-06-30	"Mon"	"Midday"	"904"	9	0	4	13
12369	2014-06-29	"Sun"	"Evening"	"740"	7	4	0	11
12368	2014-06-29	"Sun"	"Midday"	"831"	8	3	1	12
12367	2014-06-28	"Sat"	"Evening"	"476"	4	7	6	17
12366	2014-06-28	"Sat"	"Midday"	"752"	7	5	2	14
12365	2014-06-27	"Fri"	"Evening"	"964"	9	6	4	19
12364	2014-06-27	"Fri"	"Midday"	"687"	6	8	7	21
12363	2014-06-26	"Thu"	"Evening"	"457"	4	5	7	16
12362	2014-06-26	"Thu"	"Midday"	"450"	4	5	0	9
12361	2014-06-25	"Wed"	"Evening"	"583"	5	8	3	16
12360	2014-06-25	"Wed"	"Midday"	"451"	4	5	1	10
12359	2014-06-24	"Tue"	"Evening"	"944"	9	4	4	17
12358	2014-06-24	"Tue"	"Midday"	"876"	8	7	6	21
12357	2014-06-23	"Mon"	"Evening"	"346"	3	4	6	13
12356	2014-06-23	"Mon"	"Midday"	"036"	0	3	6	9
12355	2014-06-22	"Sun"	"Evening"	"292"	2	9	2	13
12354	2014-06-22	"Sun"	"Midday"	"151"	1	5	1	7
12353	2014-06-21	"Sat"	"Evening"	"936"	9	3	6	18
12352	2014-06-21	"Sat"	"Midday"	"779"	7	7	9	23
12351	2014-06-20	"Fri"	"Evening"	"875"	8	7	5	20
12350	2014-06-20	"Fri"	"Midday"	"873"	8	7	3	18
12349	2014-06-19	"Thu"	"Evening"	"705"	7	0	5	12
12348	2014-06-19	"Thu"	"Midday"	"416"	4	1	6	11
12347	2014-06-18	"Wed"	"Evening"	"483"	4	8	3	15
12346	2014-06-18	"Wed"	"Midday"	"831"	8	3	1	12
12345	2014-06-17	"Tue"	"Evening"	"471"	4	7	1	12
12344	2014-06-17	"Tue"	"Midday"	"153"	1	5	3	9
12343	2014-06-16	"Mon"	"Evening"	"173"	1	7	3	11
12342	2014-06-16	"Mon"	"Midday"	"834"	8	3	4	15
12341	2014-06-15	"Sun"	"Evening"	"911"	9	1	1	11
12340	2014-06-15	"Sun"	"Midday"	"416"	4	1	6	11
12339	2014-06-14	"Sat"	"Evening"	"876"	8	7	6	21
12338	2014-06-14	"Sat"	"Midday"	"269"	2	6	9	17
12337	2014-06-13	"Fri"	"Evening"	"021"	0	2	1	3
12336	2014-06-13	"Fri"	"Midday"	"294"	2	9	4	15
12335	2014-06-12	"Thu"	"Evening"	"830"	8	3	0	11
12334	2014-06-12	"Thu"	"Midday"	"825"	8	2	5	15
12333	2014-06-11	"Wed"	"Evening"	"472"	4	7	2	13
12332	2014-06-11	"Wed"	"Midday"	"087"	0	8	7	15
12331	2014-06-10	"Tue"	"Evening"	"808"	8	0	8	16
12330	2014-06-10	"Tue"	"Midday"	"625"	6	2	5	13
12329	2014-06-09	"Mon"	"Evening"	"027"	0	2	7	9
12328	2014-06-09	"Mon"	"Midday"	"244"	2	4	4	10
12327	2014-06-08	"Sun"	"Evening"	"310"	3	1	0	4
12326	2014-06-08	"Sun"	"Midday"	"134"	1	3	4	8
12325	2014-06-07	"Sat"	"Evening"	"735"	7	3	5	15
12324	2014-06-07	"Sat"	"Midday"	"222"	2	2	2	6
12323	2014-06-06	"Fri"	"Evening"	"772"	7	7	2	16
12322	2014-06-06	"Fri"	"Midday"	"438"	4	3	8	15
12321	2014-06-05	"Thu"	"Evening"	"905"	9	0	5	14
12320	2014-06-05	"Thu"	"Midday"	"695"	6	9	5	20
12319	2014-06-04	"Wed"	"Evening"	"876"	8	7	6	21
12318	2014-06-04	"Wed"	"Midday"	"575"	5	7	5	17
12317	2014-06-03	"Tue"	"Evening"	"334"	3	3	4	10
12316	2014-06-03	"Tue"	"Midday"	"461"	4	6	1	11
12315	2014-06-02	"Mon"	"Evening"	"841"	8	4	1	13
12314	2014-06-02	"Mon"	"Midday"	"549"	5	4	9	18
12313	2014-06-01	"Sun"	"Evening"	"985"	9	8	5	22
12312	2014-06-01	"Sun"	"Midday"	"782"	7	8	2	17
12311	2014-05-31	"Sat"	"Evening"	"175"	1	7	5	13
12310	2014-05-31	"Sat"	"Midday"	"513"	5	1	3	9
12309	2014-05-30	"Fri"	"Evening"	"849"	8	4	9	21
12308	2014-05-30	"Fri"	"Midday"	"101"	1	0	1	2
12307	2014-05-29	"Thu"	"Evening"	"021"	0	2	1	3
12306	2014-05-29	"Thu"	"Midday"	"919"	9	1	9	19
12305	2014-05-28	"Wed"	"Evening"	"584"	5	8	4	17
12304	2014-05-28	"Wed"	"Midday"	"440"	4	4	0	8
12303	2014-05-27	"Tue"	"Evening"	"810"	8	1	0	9
12302	2014-05-27	"Tue"	"Midday"	"047"	0	4	7	11
12301	2014-05-26	"Mon"	"Evening"	"916"	9	1	6	16
12300	2014-05-26	"Mon"	"Midday"	"572"	5	7	2	14
12299	2014-05-25	"Sun"	"Evening"	"898"	8	9	8	25
12298	2014-05-25	"Sun"	"Midday"	"679"	6	7	9	22
12297	2014-05-24	"Sat"	"Evening"	"103"	1	0	3	4
12296	2014-05-24	"Sat"	"Midday"	"313"	3	1	3	7
12295	2014-05-23	"Fri"	"Evening"	"287"	2	8	7	17
12294	2014-05-23	"Fri"	"Midday"	"698"	6	9	8	23
12293	2014-05-22	"Thu"	"Evening"	"514"	5	1	4	10
12292	2014-05-22	"Thu"	"Midday"	"414"	4	1	4	9
12291	2014-05-21	"Wed"	"Evening"	"983"	9	8	3	20
12290	2014-05-21	"Wed"	"Midday"	"408"	4	0	8	12
12289	2014-05-20	"Tue"	"Evening"	"574"	5	7	4	16
12288	2014-05-20	"Tue"	"Midday"	"955"	9	5	5	19
12287	2014-05-19	"Mon"	"Evening"	"586"	5	8	6	19
12286	2014-05-19	"Mon"	"Midday"	"169"	1	6	9	16
12285	2014-05-18	"Sun"	"Evening"	"823"	8	2	3	13
12284	2014-05-18	"Sun"	"Midday"	"969"	9	6	9	24
12283	2014-05-17	"Sat"	"Evening"	"791"	7	9	1	17
12282	2014-05-17	"Sat"	"Midday"	"420"	4	2	0	6
12281	2014-05-16	"Fri"	"Evening"	"452"	4	5	2	11
12280	2014-05-16	"Fri"	"Midday"	"954"	9	5	4	18
12279	2014-05-15	"Thu"	"Evening"	"048"	0	4	8	12
12278	2014-05-15	"Thu"	"Midday"	"591"	5	9	1	15
12277	2014-05-14	"Wed"	"Evening"	"443"	4	4	3	11
12276	2014-05-14	"Wed"	"Midday"	"134"	1	3	4	8
12275	2014-05-13	"Tue"	"Evening"	"020"	0	2	0	2
12274	2014-05-13	"Tue"	"Midday"	"264"	2	6	4	12
12273	2014-05-12	"Mon"	"Evening"	"815"	8	1	5	14
12272	2014-05-12	"Mon"	"Midday"	"281"	2	8	1	11
12271	2014-05-11	"Sun"	"Evening"	"785"	7	8	5	20
12270	2014-05-11	"Sun"	"Midday"	"757"	7	5	7	19
12269	2014-05-10	"Sat"	"Evening"	"413"	4	1	3	8
12268	2014-05-10	"Sat"	"Midday"	"864"	8	6	4	18
12267	2014-05-09	"Fri"	"Evening"	"283"	2	8	3	13
12266	2014-05-09	"Fri"	"Midday"	"832"	8	3	2	13
12265	2014-05-08	"Thu"	"Evening"	"379"	3	7	9	19
12264	2014-05-08	"Thu"	"Midday"	"082"	0	8	2	10
12263	2014-05-07	"Wed"	"Evening"	"626"	6	2	6	14
12262	2014-05-07	"Wed"	"Midday"	"068"	0	6	8	14
12261	2014-05-06	"Tue"	"Evening"	"792"	7	9	2	18
12260	2014-05-06	"Tue"	"Midday"	"396"	3	9	6	18
12259	2014-05-05	"Mon"	"Evening"	"909"	9	0	9	18
12258	2014-05-05	"Mon"	"Midday"	"715"	7	1	5	13
12257	2014-05-04	"Sun"	"Evening"	"693"	6	9	3	18
12256	2014-05-04	"Sun"	"Midday"	"542"	5	4	2	11
12255	2014-05-03	"Sat"	"Evening"	"968"	9	6	8	23
12254	2014-05-03	"Sat"	"Midday"	"100"	1	0	0	1
12253	2014-05-02	"Fri"	"Evening"	"694"	6	9	4	19
12252	2014-05-02	"Fri"	"Midday"	"250"	2	5	0	7
12251	2014-05-01	"Thu"	"Evening"	"504"	5	0	4	9
12250	2014-05-01	"Thu"	"Midday"	"456"	4	5	6	15
12249	2014-04-30	"Wed"	"Evening"	"000"	0	0	0	0
12248	2014-04-30	"Wed"	"Midday"	"359"	3	5	9	17
12247	2014-04-29	"Tue"	"Evening"	"057"	0	5	7	12
12246	2014-04-29	"Tue"	"Midday"	"425"	4	2	5	11
12245	2014-04-28	"Mon"	"Evening"	"927"	9	2	7	18
12244	2014-04-28	"Mon"	"Midday"	"476"	4	7	6	17
12243	2014-04-27	"Sun"	"Evening"	"395"	3	9	5	17
12242	2014-04-27	"Sun"	"Midday"	"467"	4	6	7	17
12241	2014-04-26	"Sat"	"Evening"	"611"	6	1	1	8
12240	2014-04-26	"Sat"	"Midday"	"999"	9	9	9	27
12239	2014-04-25	"Fri"	"Evening"	"877"	8	7	7	22
12238	2014-04-25	"Fri"	"Midday"	"963"	9	6	3	18
12237	2014-04-24	"Thu"	"Evening"	"356"	3	5	6	14
12236	2014-04-24	"Thu"	"Midday"	"695"	6	9	5	20
12235	2014-04-23	"Wed"	"Evening"	"222"	2	2	2	6
12234	2014-04-23	"Wed"	"Midday"	"478"	4	7	8	19
12233	2014-04-22	"Tue"	"Evening"	"898"	8	9	8	25
12232	2014-04-22	"Tue"	"Midday"	"587"	5	8	7	20
12231	2014-04-21	"Mon"	"Evening"	"161"	1	6	1	8
12230	2014-04-21	"Mon"	"Midday"	"270"	2	7	0	9
12229	2014-04-20	"Sun"	"Evening"	"393"	3	9	3	15
12228	2014-04-20	"Sun"	"Midday"	"077"	0	7	7	14
12227	2014-04-19	"Sat"	"Evening"	"765"	7	6	5	18
12226	2014-04-19	"Sat"	"Midday"	"629"	6	2	9	17
12225	2014-04-18	"Fri"	"Evening"	"631"	6	3	1	10
12224	2014-04-18	"Fri"	"Midday"	"949"	9	4	9	22
12223	2014-04-17	"Thu"	"Evening"	"508"	5	0	8	13
12222	2014-04-17	"Thu"	"Midday"	"771"	7	7	1	15
12221	2014-04-16	"Wed"	"Evening"	"383"	3	8	3	14
12220	2014-04-16	"Wed"	"Midday"	"015"	0	1	5	6
12219	2014-04-15	"Tue"	"Evening"	"915"	9	1	5	15
12218	2014-04-15	"Tue"	"Midday"	"085"	0	8	5	13
12217	2014-04-14	"Mon"	"Evening"	"541"	5	4	1	10
12216	2014-04-14	"Mon"	"Midday"	"666"	6	6	6	18
12215	2014-04-13	"Sun"	"Evening"	"697"	6	9	7	22
12214	2014-04-13	"Sun"	"Midday"	"644"	6	4	4	14
12213	2014-04-12	"Sat"	"Evening"	"641"	6	4	1	11
12212	2014-04-12	"Sat"	"Midday"	"962"	9	6	2	17
12211	2014-04-11	"Fri"	"Evening"	"510"	5	1	0	6
12210	2014-04-11	"Fri"	"Midday"	"532"	5	3	2	10
12209	2014-04-10	"Thu"	"Evening"	"026"	0	2	6	8
12208	2014-04-10	"Thu"	"Midday"	"033"	0	3	3	6
12207	2014-04-09	"Wed"	"Evening"	"253"	2	5	3	10
12206	2014-04-09	"Wed"	"Midday"	"566"	5	6	6	17
12205	2014-04-08	"Tue"	"Evening"	"326"	3	2	6	11
12204	2014-04-08	"Tue"	"Midday"	"793"	7	9	3	19
12203	2014-04-07	"Mon"	"Evening"	"611"	6	1	1	8
12202	2014-04-07	"Mon"	"Midday"	"205"	2	0	5	7
12201	2014-04-06	"Sun"	"Evening"	"976"	9	7	6	22
12200	2014-04-06	"Sun"	"Midday"	"013"	0	1	3	4
12199	2014-04-05	"Sat"	"Evening"	"490"	4	9	0	13
12198	2014-04-05	"Sat"	"Midday"	"613"	6	1	3	10
12197	2014-04-04	"Fri"	"Evening"	"287"	2	8	7	17
12196	2014-04-04	"Fri"	"Midday"	"188"	1	8	8	17
12195	2014-04-03	"Thu"	"Evening"	"830"	8	3	0	11
12194	2014-04-03	"Thu"	"Midday"	"028"	0	2	8	10
12193	2014-04-02	"Wed"	"Evening"	"740"	7	4	0	11
12192	2014-04-02	"Wed"	"Midday"	"111"	1	1	1	3
12191	2014-04-01	"Tue"	"Evening"	"189"	1	8	9	18
12190	2014-04-01	"Tue"	"Midday"	"617"	6	1	7	14
12189	2014-03-31	"Mon"	"Evening"	"268"	2	6	8	16
12188	2014-03-31	"Mon"	"Midday"	"680"	6	8	0	14
12187	2014-03-30	"Sun"	"Evening"	"595"	5	9	5	19
12186	2014-03-30	"Sun"	"Midday"	"759"	7	5	9	21
12185	2014-03-29	"Sat"	"Evening"	"832"	8	3	2	13
12184	2014-03-29	"Sat"	"Midday"	"965"	9	6	5	20
12183	2014-03-28	"Fri"	"Evening"	"085"	0	8	5	13
12182	2014-03-28	"Fri"	"Midday"	"563"	5	6	3	14
12181	2014-03-27	"Thu"	"Evening"	"980"	9	8	0	17
12180	2014-03-27	"Thu"	"Midday"	"287"	2	8	7	17
12179	2014-03-26	"Wed"	"Evening"	"114"	1	1	4	6
12178	2014-03-26	"Wed"	"Midday"	"210"	2	1	0	3
12177	2014-03-25	"Tue"	"Evening"	"850"	8	5	0	13
12176	2014-03-25	"Tue"	"Midday"	"669"	6	6	9	21
12175	2014-03-24	"Mon"	"Evening"	"468"	4	6	8	18
12174	2014-03-24	"Mon"	"Midday"	"151"	1	5	1	7
12173	2014-03-23	"Sun"	"Evening"	"758"	7	5	8	20
12172	2014-03-23	"Sun"	"Midday"	"142"	1	4	2	7
12171	2014-03-22	"Sat"	"Evening"	"721"	7	2	1	10
12170	2014-03-22	"Sat"	"Midday"	"699"	6	9	9	24
12169	2014-03-21	"Fri"	"Evening"	"268"	2	6	8	16
12168	2014-03-21	"Fri"	"Midday"	"611"	6	1	1	8
12167	2014-03-20	"Thu"	"Evening"	"827"	8	2	7	17
12166	2014-03-20	"Thu"	"Midday"	"327"	3	2	7	12
12165	2014-03-19	"Wed"	"Evening"	"507"	5	0	7	12
12164	2014-03-19	"Wed"	"Midday"	"849"	8	4	9	21
12163	2014-03-18	"Tue"	"Evening"	"356"	3	5	6	14
12162	2014-03-18	"Tue"	"Midday"	"536"	5	3	6	14
12161	2014-03-17	"Mon"	"Evening"	"556"	5	5	6	16
12160	2014-03-17	"Mon"	"Midday"	"732"	7	3	2	12
12159	2014-03-16	"Sun"	"Evening"	"065"	0	6	5	11
12158	2014-03-16	"Sun"	"Midday"	"549"	5	4	9	18
12157	2014-03-15	"Sat"	"Evening"	"711"	7	1	1	9
12156	2014-03-15	"Sat"	"Midday"	"494"	4	9	4	17
12155	2014-03-14	"Fri"	"Evening"	"338"	3	3	8	14
12154	2014-03-14	"Fri"	"Midday"	"521"	5	2	1	8
12153	2014-03-13	"Thu"	"Evening"	"170"	1	7	0	8
12152	2014-03-13	"Thu"	"Midday"	"309"	3	0	9	12
12151	2014-03-12	"Wed"	"Evening"	"635"	6	3	5	14
12150	2014-03-12	"Wed"	"Midday"	"488"	4	8	8	20
12149	2014-03-11	"Tue"	"Evening"	"645"	6	4	5	15
12148	2014-03-11	"Tue"	"Midday"	"884"	8	8	4	20
12147	2014-03-10	"Mon"	"Evening"	"386"	3	8	6	17
12146	2014-03-10	"Mon"	"Midday"	"202"	2	0	2	4
12145	2014-03-09	"Sun"	"Evening"	"104"	1	0	4	5
12144	2014-03-09	"Sun"	"Midday"	"533"	5	3	3	11
12143	2014-03-08	"Sat"	"Evening"	"813"	8	1	3	12
12142	2014-03-08	"Sat"	"Midday"	"397"	3	9	7	19
12141	2014-03-07	"Fri"	"Evening"	"060"	0	6	0	6
12140	2014-03-07	"Fri"	"Midday"	"719"	7	1	9	17
12139	2014-03-06	"Thu"	"Evening"	"374"	3	7	4	14
12138	2014-03-06	"Thu"	"Midday"	"252"	2	5	2	9
12137	2014-03-05	"Wed"	"Evening"	"727"	7	2	7	16
12136	2014-03-05	"Wed"	"Midday"	"805"	8	0	5	13
12135	2014-03-04	"Tue"	"Evening"	"527"	5	2	7	14
12134	2014-03-04	"Tue"	"Midday"	"639"	6	3	9	18
12133	2014-03-03	"Mon"	"Evening"	"343"	3	4	3	10
12132	2014-03-03	"Mon"	"Midday"	"606"	6	0	6	12
12131	2014-03-02	"Sun"	"Evening"	"708"	7	0	8	15
12130	2014-03-02	"Sun"	"Midday"	"580"	5	8	0	13
12129	2014-03-01	"Sat"	"Evening"	"567"	5	6	7	18
12128	2014-03-01	"Sat"	"Midday"	"032"	0	3	2	5
12127	2014-02-28	"Fri"	"Evening"	"907"	9	0	7	16
12126	2014-02-28	"Fri"	"Midday"	"847"	8	4	7	19
12125	2014-02-27	"Thu"	"Evening"	"222"	2	2	2	6
12124	2014-02-27	"Thu"	"Midday"	"697"	6	9	7	22
12123	2014-02-26	"Wed"	"Evening"	"106"	1	0	6	7
12122	2014-02-26	"Wed"	"Midday"	"975"	9	7	5	21
12121	2014-02-25	"Tue"	"Evening"	"817"	8	1	7	16
12120	2014-02-25	"Tue"	"Midday"	"775"	7	7	5	19
12119	2014-02-24	"Mon"	"Evening"	"221"	2	2	1	5
12118	2014-02-24	"Mon"	"Midday"	"799"	7	9	9	25
12117	2014-02-23	"Sun"	"Evening"	"901"	9	0	1	10
12116	2014-02-23	"Sun"	"Midday"	"818"	8	1	8	17
12115	2014-02-22	"Sat"	"Evening"	"720"	7	2	0	9
12114	2014-02-22	"Sat"	"Midday"	"651"	6	5	1	12
12113	2014-02-21	"Fri"	"Evening"	"250"	2	5	0	7
12112	2014-02-21	"Fri"	"Midday"	"371"	3	7	1	11
12111	2014-02-20	"Thu"	"Evening"	"295"	2	9	5	16
12110	2014-02-20	"Thu"	"Midday"	"690"	6	9	0	15
12109	2014-02-19	"Wed"	"Evening"	"927"	9	2	7	18
12108	2014-02-19	"Wed"	"Midday"	"561"	5	6	1	12
12107	2014-02-18	"Tue"	"Evening"	"921"	9	2	1	12
12106	2014-02-18	"Tue"	"Midday"	"544"	5	4	4	13
12105	2014-02-17	"Mon"	"Evening"	"531"	5	3	1	9
12104	2014-02-17	"Mon"	"Midday"	"135"	1	3	5	9
12103	2014-02-16	"Sun"	"Evening"	"857"	8	5	7	20
12102	2014-02-16	"Sun"	"Midday"	"855"	8	5	5	18
12101	2014-02-15	"Sat"	"Evening"	"700"	7	0	0	7
12100	2014-02-15	"Sat"	"Midday"	"951"	9	5	1	15
12099	2014-02-14	"Fri"	"Evening"	"006"	0	0	6	6
12098	2014-02-14	"Fri"	"Midday"	"054"	0	5	4	9
12097	2014-02-13	"Thu"	"Evening"	"059"	0	5	9	14
12096	2014-02-13	"Thu"	"Midday"	"580"	5	8	0	13
12095	2014-02-12	"Wed"	"Evening"	"623"	6	2	3	11
12094	2014-02-12	"Wed"	"Midday"	"461"	4	6	1	11
12093	2014-02-11	"Tue"	"Evening"	"599"	5	9	9	23
12092	2014-02-11	"Tue"	"Midday"	"438"	4	3	8	15
12091	2014-02-10	"Mon"	"Evening"	"993"	9	9	3	21
12090	2014-02-10	"Mon"	"Midday"	"546"	5	4	6	15
12089	2014-02-09	"Sun"	"Evening"	"701"	7	0	1	8
12088	2014-02-09	"Sun"	"Midday"	"213"	2	1	3	6
12087	2014-02-08	"Sat"	"Evening"	"154"	1	5	4	10
12086	2014-02-08	"Sat"	"Midday"	"132"	1	3	2	6
12085	2014-02-07	"Fri"	"Evening"	"797"	7	9	7	23
12084	2014-02-07	"Fri"	"Midday"	"846"	8	4	6	18
12083	2014-02-06	"Thu"	"Evening"	"064"	0	6	4	10
12082	2014-02-06	"Thu"	"Midday"	"804"	8	0	4	12
12081	2014-02-05	"Wed"	"Evening"	"072"	0	7	2	9
12080	2014-02-05	"Wed"	"Midday"	"935"	9	3	5	17
12079	2014-02-04	"Tue"	"Evening"	"466"	4	6	6	16
12078	2014-02-04	"Tue"	"Midday"	"477"	4	7	7	18
12077	2014-02-03	"Mon"	"Evening"	"898"	8	9	8	25
12076	2014-02-03	"Mon"	"Midday"	"161"	1	6	1	8
12075	2014-02-02	"Sun"	"Evening"	"089"	0	8	9	17
12074	2014-02-02	"Sun"	"Midday"	"103"	1	0	3	4
12073	2014-02-01	"Sat"	"Evening"	"744"	7	4	4	15
12072	2014-02-01	"Sat"	"Midday"	"558"	5	5	8	18
12071	2014-01-31	"Fri"	"Evening"	"800"	8	0	0	8
12070	2014-01-31	"Fri"	"Midday"	"368"	3	6	8	17
12069	2014-01-30	"Thu"	"Evening"	"127"	1	2	7	10
12068	2014-01-30	"Thu"	"Midday"	"730"	7	3	0	10
12067	2014-01-29	"Wed"	"Evening"	"825"	8	2	5	15
12066	2014-01-29	"Wed"	"Midday"	"452"	4	5	2	11
12065	2014-01-28	"Tue"	"Evening"	"235"	2	3	5	10
12064	2014-01-28	"Tue"	"Midday"	"299"	2	9	9	20
12063	2014-01-27	"Mon"	"Evening"	"670"	6	7	0	13
12062	2014-01-27	"Mon"	"Midday"	"775"	7	7	5	19
12061	2014-01-26	"Sun"	"Evening"	"122"	1	2	2	5
12060	2014-01-26	"Sun"	"Midday"	"253"	2	5	3	10
12059	2014-01-25	"Sat"	"Evening"	"162"	1	6	2	9
12058	2014-01-25	"Sat"	"Midday"	"662"	6	6	2	14
12057	2014-01-24	"Fri"	"Evening"	"345"	3	4	5	12
12056	2014-01-24	"Fri"	"Midday"	"534"	5	3	4	12
12055	2014-01-23	"Thu"	"Evening"	"925"	9	2	5	16
12054	2014-01-23	"Thu"	"Midday"	"530"	5	3	0	8
12053	2014-01-22	"Wed"	"Evening"	"844"	8	4	4	16
12052	2014-01-22	"Wed"	"Midday"	"502"	5	0	2	7
12051	2014-01-21	"Tue"	"Evening"	"981"	9	8	1	18
12050	2014-01-21	"Tue"	"Midday"	"675"	6	7	5	18
12049	2014-01-20	"Mon"	"Evening"	"245"	2	4	5	11
12048	2014-01-20	"Mon"	"Midday"	"030"	0	3	0	3
12047	2014-01-19	"Sun"	"Evening"	"518"	5	1	8	14
12046	2014-01-19	"Sun"	"Midday"	"591"	5	9	1	15
12045	2014-01-18	"Sat"	"Evening"	"503"	5	0	3	8
12044	2014-01-18	"Sat"	"Midday"	"099"	0	9	9	18
12043	2014-01-17	"Fri"	"Evening"	"604"	6	0	4	10
12042	2014-01-17	"Fri"	"Midday"	"741"	7	4	1	12
12041	2014-01-16	"Thu"	"Evening"	"782"	7	8	2	17
12040	2014-01-16	"Thu"	"Midday"	"385"	3	8	5	16
12039	2014-01-15	"Wed"	"Evening"	"559"	5	5	9	19
12038	2014-01-15	"Wed"	"Midday"	"052"	0	5	2	7
12037	2014-01-14	"Tue"	"Evening"	"214"	2	1	4	7
12036	2014-01-14	"Tue"	"Midday"	"921"	9	2	1	12
12035	2014-01-13	"Mon"	"Evening"	"631"	6	3	1	10
12034	2014-01-13	"Mon"	"Midday"	"735"	7	3	5	15
12033	2014-01-12	"Sun"	"Evening"	"193"	1	9	3	13
12032	2014-01-12	"Sun"	"Midday"	"753"	7	5	3	15
12031	2014-01-11	"Sat"	"Evening"	"475"	4	7	5	16
12030	2014-01-11	"Sat"	"Midday"	"928"	9	2	8	19
12029	2014-01-10	"Fri"	"Evening"	"168"	1	6	8	15
12028	2014-01-10	"Fri"	"Midday"	"991"	9	9	1	19
12027	2014-01-09	"Thu"	"Evening"	"256"	2	5	6	13
12026	2014-01-09	"Thu"	"Midday"	"696"	6	9	6	21
12025	2014-01-08	"Wed"	"Evening"	"440"	4	4	0	8
12024	2014-01-08	"Wed"	"Midday"	"509"	5	0	9	14
12023	2014-01-07	"Tue"	"Evening"	"289"	2	8	9	19
12022	2014-01-07	"Tue"	"Midday"	"554"	5	5	4	14
12021	2014-01-06	"Mon"	"Evening"	"044"	0	4	4	8
12020	2014-01-06	"Mon"	"Midday"	"453"	4	5	3	12
12019	2014-01-05	"Sun"	"Evening"	"059"	0	5	9	14
12018	2014-01-05	"Sun"	"Midday"	"928"	9	2	8	19
12017	2014-01-04	"Sat"	"Evening"	"785"	7	8	5	20
12016	2014-01-04	"Sat"	"Midday"	"555"	5	5	5	15
12015	2014-01-03	"Fri"	"Evening"	"746"	7	4	6	17
12014	2014-01-03	"Fri"	"Midday"	"901"	9	0	1	10
12013	2014-01-02	"Thu"	"Evening"	"967"	9	6	7	22
12012	2014-01-02	"Thu"	"Midday"	"991"	9	9	1	19
12011	2014-01-01	"Wed"	"Evening"	"165"	1	6	5	12
12010	2014-01-01	"Wed"	"Midday"	"621"	6	2	1	9
12009	2013-12-31	"Tue"	"Evening"	"477"	4	7	7	18
12008	2013-12-31	"Tue"	"Midday"	"797"	7	9	7	23
12007	2013-12-30	"Mon"	"Evening"	"803"	8	0	3	11
12006	2013-12-30	"Mon"	"Midday"	"597"	5	9	7	21
12005	2013-12-29	"Sun"	"Evening"	"074"	0	7	4	11
12004	2013-12-29	"Sun"	"Midday"	"665"	6	6	5	17
12003	2013-12-28	"Sat"	"Evening"	"739"	7	3	9	19
12002	2013-12-28	"Sat"	"Midday"	"302"	3	0	2	5
12001	2013-12-27	"Fri"	"Evening"	"242"	2	4	2	8
12000	2013-12-27	"Fri"	"Midday"	"025"	0	2	5	7
11999	2013-12-26	"Thu"	"Evening"	"081"	0	8	1	9
11998	2013-12-26	"Thu"	"Midday"	"652"	6	5	2	13
11997	2013-12-25	"Wed"	"Evening"	"260"	2	6	0	8
11996	2013-12-25	"Wed"	"Midday"	"349"	3	4	9	16
11995	2013-12-24	"Tue"	"Evening"	"239"	2	3	9	14
11994	2013-12-24	"Tue"	"Midday"	"054"	0	5	4	9
11993	2013-12-23	"Mon"	"Evening"	"565"	5	6	5	16
11992	2013-12-23	"Mon"	"Midday"	"944"	9	4	4	17
11991	2013-12-22	"Sun"	"Evening"	"856"	8	5	6	19
11990	2013-12-22	"Sun"	"Midday"	"074"	0	7	4	11
11989	2013-12-21	"Sat"	"Evening"	"249"	2	4	9	15
11988	2013-12-21	"Sat"	"Midday"	"876"	8	7	6	21
11987	2013-12-20	"Fri"	"Evening"	"370"	3	7	0	10
11986	2013-12-20	"Fri"	"Midday"	"024"	0	2	4	6
11985	2013-12-19	"Thu"	"Evening"	"986"	9	8	6	23
11984	2013-12-19	"Thu"	"Midday"	"989"	9	8	9	26
11983	2013-12-18	"Wed"	"Evening"	"533"	5	3	3	11
11982	2013-12-18	"Wed"	"Midday"	"673"	6	7	3	16
11981	2013-12-17	"Tue"	"Evening"	"997"	9	9	7	25
11980	2013-12-17	"Tue"	"Midday"	"854"	8	5	4	17
11979	2013-12-16	"Mon"	"Evening"	"451"	4	5	1	10
11978	2013-12-16	"Mon"	"Midday"	"680"	6	8	0	14
11977	2013-12-15	"Sun"	"Evening"	"280"	2	8	0	10
11976	2013-12-15	"Sun"	"Midday"	"924"	9	2	4	15
11975	2013-12-14	"Sat"	"Evening"	"774"	7	7	4	18
11974	2013-12-14	"Sat"	"Midday"	"543"	5	4	3	12
11973	2013-12-13	"Fri"	"Evening"	"844"	8	4	4	16
11972	2013-12-13	"Fri"	"Midday"	"852"	8	5	2	15
11971	2013-12-12	"Thu"	"Evening"	"005"	0	0	5	5
11970	2013-12-12	"Thu"	"Midday"	"037"	0	3	7	10
11969	2013-12-11	"Wed"	"Evening"	"223"	2	2	3	7
11968	2013-12-11	"Wed"	"Midday"	"406"	4	0	6	10
11967	2013-12-10	"Tue"	"Evening"	"650"	6	5	0	11
11966	2013-12-10	"Tue"	"Midday"	"868"	8	6	8	22
11965	2013-12-09	"Mon"	"Evening"	"484"	4	8	4	16
11964	2013-12-09	"Mon"	"Midday"	"412"	4	1	2	7
11963	2013-12-08	"Sun"	"Evening"	"047"	0	4	7	11
11962	2013-12-08	"Sun"	"Midday"	"938"	9	3	8	20
11961	2013-12-07	"Sat"	"Evening"	"019"	0	1	9	10
11960	2013-12-07	"Sat"	"Midday"	"114"	1	1	4	6
11959	2013-12-06	"Fri"	"Evening"	"566"	5	6	6	17
11958	2013-12-06	"Fri"	"Midday"	"553"	5	5	3	13
11957	2013-12-05	"Thu"	"Evening"	"800"	8	0	0	8
11956	2013-12-05	"Thu"	"Midday"	"777"	7	7	7	21
11955	2013-12-04	"Wed"	"Evening"	"576"	5	7	6	18
11954	2013-12-04	"Wed"	"Midday"	"615"	6	1	5	12
11953	2013-12-03	"Tue"	"Evening"	"416"	4	1	6	11
11952	2013-12-03	"Tue"	"Midday"	"694"	6	9	4	19
11951	2013-12-02	"Mon"	"Evening"	"203"	2	0	3	5
11950	2013-12-02	"Mon"	"Midday"	"606"	6	0	6	12
11949	2013-12-01	"Sun"	"Evening"	"803"	8	0	3	11
11948	2013-12-01	"Sun"	"Midday"	"471"	4	7	1	12
11947	2013-11-30	"Sat"	"Evening"	"789"	7	8	9	24
11946	2013-11-30	"Sat"	"Midday"	"954"	9	5	4	18
11945	2013-11-29	"Fri"	"Evening"	"085"	0	8	5	13
11944	2013-11-29	"Fri"	"Midday"	"386"	3	8	6	17
11943	2013-11-28	"Thu"	"Evening"	"932"	9	3	2	14
11942	2013-11-28	"Thu"	"Midday"	"483"	4	8	3	15
11941	2013-11-27	"Wed"	"Evening"	"290"	2	9	0	11
11940	2013-11-27	"Wed"	"Midday"	"886"	8	8	6	22
11939	2013-11-26	"Tue"	"Evening"	"598"	5	9	8	22
11938	2013-11-26	"Tue"	"Midday"	"135"	1	3	5	9
11937	2013-11-25	"Mon"	"Evening"	"598"	5	9	8	22
11936	2013-11-25	"Mon"	"Midday"	"170"	1	7	0	8
11935	2013-11-24	"Sun"	"Evening"	"948"	9	4	8	21
11934	2013-11-24	"Sun"	"Midday"	"651"	6	5	1	12
11933	2013-11-23	"Sat"	"Evening"	"937"	9	3	7	19
11932	2013-11-23	"Sat"	"Midday"	"386"	3	8	6	17
11931	2013-11-22	"Fri"	"Evening"	"584"	5	8	4	17
11930	2013-11-22	"Fri"	"Midday"	"114"	1	1	4	6
11929	2013-11-21	"Thu"	"Evening"	"711"	7	1	1	9
11928	2013-11-21	"Thu"	"Midday"	"704"	7	0	4	11
11927	2013-11-20	"Wed"	"Evening"	"621"	6	2	1	9
11926	2013-11-20	"Wed"	"Midday"	"567"	5	6	7	18
11925	2013-11-19	"Tue"	"Evening"	"904"	9	0	4	13
11924	2013-11-19	"Tue"	"Midday"	"395"	3	9	5	17
11923	2013-11-18	"Mon"	"Evening"	"727"	7	2	7	16
11922	2013-11-18	"Mon"	"Midday"	"227"	2	2	7	11
11921	2013-11-17	"Sun"	"Evening"	"052"	0	5	2	7
11920	2013-11-17	"Sun"	"Midday"	"581"	5	8	1	14
11919	2013-11-16	"Sat"	"Evening"	"572"	5	7	2	14
11918	2013-11-16	"Sat"	"Midday"	"086"	0	8	6	14
11917	2013-11-15	"Fri"	"Evening"	"508"	5	0	8	13
11916	2013-11-15	"Fri"	"Midday"	"981"	9	8	1	18
11915	2013-11-14	"Thu"	"Evening"	"645"	6	4	5	15
11914	2013-11-14	"Thu"	"Midday"	"055"	0	5	5	10
11913	2013-11-13	"Wed"	"Evening"	"016"	0	1	6	7
11912	2013-11-13	"Wed"	"Midday"	"157"	1	5	7	13
11911	2013-11-12	"Tue"	"Evening"	"649"	6	4	9	19
11910	2013-11-12	"Tue"	"Midday"	"713"	7	1	3	11
11909	2013-11-11	"Mon"	"Evening"	"047"	0	4	7	11
11908	2013-11-11	"Mon"	"Midday"	"603"	6	0	3	9
11907	2013-11-10	"Sun"	"Evening"	"375"	3	7	5	15
11906	2013-11-10	"Sun"	"Midday"	"470"	4	7	0	11
11905	2013-11-09	"Sat"	"Evening"	"764"	7	6	4	17
11904	2013-11-09	"Sat"	"Midday"	"648"	6	4	8	18
11903	2013-11-08	"Fri"	"Evening"	"123"	1	2	3	6
11902	2013-11-08	"Fri"	"Midday"	"540"	5	4	0	9
11901	2013-11-07	"Thu"	"Evening"	"788"	7	8	8	23
11900	2013-11-07	"Thu"	"Midday"	"159"	1	5	9	15
11899	2013-11-06	"Wed"	"Evening"	"959"	9	5	9	23
11898	2013-11-06	"Wed"	"Midday"	"915"	9	1	5	15
11897	2013-11-05	"Tue"	"Evening"	"504"	5	0	4	9
11896	2013-11-05	"Tue"	"Midday"	"874"	8	7	4	19
11895	2013-11-04	"Mon"	"Evening"	"474"	4	7	4	15
11894	2013-11-04	"Mon"	"Midday"	"050"	0	5	0	5
11893	2013-11-03	"Sun"	"Evening"	"207"	2	0	7	9
11892	2013-11-03	"Sun"	"Midday"	"812"	8	1	2	11
11891	2013-11-02	"Sat"	"Evening"	"409"	4	0	9	13
11890	2013-11-02	"Sat"	"Midday"	"565"	5	6	5	16
11889	2013-11-01	"Fri"	"Evening"	"815"	8	1	5	14
11888	2013-11-01	"Fri"	"Midday"	"450"	4	5	0	9
11887	2013-10-31	"Thu"	"Evening"	"106"	1	0	6	7
11886	2013-10-31	"Thu"	"Midday"	"288"	2	8	8	18
11885	2013-10-30	"Wed"	"Evening"	"652"	6	5	2	13
11884	2013-10-30	"Wed"	"Midday"	"523"	5	2	3	10
11883	2013-10-29	"Tue"	"Evening"	"576"	5	7	6	18
11882	2013-10-29	"Tue"	"Midday"	"988"	9	8	8	25
11881	2013-10-28	"Mon"	"Evening"	"607"	6	0	7	13
11880	2013-10-28	"Mon"	"Midday"	"069"	0	6	9	15
11879	2013-10-27	"Sun"	"Evening"	"598"	5	9	8	22
11878	2013-10-27	"Sun"	"Midday"	"843"	8	4	3	15
11877	2013-10-26	"Sat"	"Evening"	"244"	2	4	4	10
11876	2013-10-26	"Sat"	"Midday"	"023"	0	2	3	5
11875	2013-10-25	"Fri"	"Evening"	"323"	3	2	3	8
11874	2013-10-25	"Fri"	"Midday"	"702"	7	0	2	9
11873	2013-10-24	"Thu"	"Evening"	"311"	3	1	1	5
11872	2013-10-24	"Thu"	"Midday"	"011"	0	1	1	2
11871	2013-10-23	"Wed"	"Evening"	"078"	0	7	8	15
11870	2013-10-23	"Wed"	"Midday"	"440"	4	4	0	8
11869	2013-10-22	"Tue"	"Evening"	"463"	4	6	3	13
11868	2013-10-22	"Tue"	"Midday"	"038"	0	3	8	11
11867	2013-10-21	"Mon"	"Evening"	"597"	5	9	7	21
11866	2013-10-21	"Mon"	"Midday"	"723"	7	2	3	12
11865	2013-10-20	"Sun"	"Evening"	"890"	8	9	0	17
11864	2013-10-20	"Sun"	"Midday"	"325"	3	2	5	10
11863	2013-10-19	"Sat"	"Evening"	"050"	0	5	0	5
11862	2013-10-19	"Sat"	"Midday"	"099"	0	9	9	18
11861	2013-10-18	"Fri"	"Evening"	"053"	0	5	3	8
11860	2013-10-18	"Fri"	"Midday"	"430"	4	3	0	7
11859	2013-10-17	"Thu"	"Evening"	"122"	1	2	2	5
11858	2013-10-17	"Thu"	"Midday"	"332"	3	3	2	8
11857	2013-10-16	"Wed"	"Evening"	"234"	2	3	4	9
11856	2013-10-16	"Wed"	"Midday"	"002"	0	0	2	2
11855	2013-10-15	"Tue"	"Evening"	"022"	0	2	2	4
11854	2013-10-15	"Tue"	"Midday"	"533"	5	3	3	11
11853	2013-10-14	"Mon"	"Evening"	"348"	3	4	8	15
11852	2013-10-14	"Mon"	"Midday"	"983"	9	8	3	20
11851	2013-10-13	"Sun"	"Evening"	"980"	9	8	0	17
11850	2013-10-13	"Sun"	"Midday"	"921"	9	2	1	12
11849	2013-10-12	"Sat"	"Evening"	"430"	4	3	0	7
11848	2013-10-12	"Sat"	"Midday"	"927"	9	2	7	18
11847	2013-10-11	"Fri"	"Evening"	"271"	2	7	1	10
11846	2013-10-11	"Fri"	"Midday"	"945"	9	4	5	18
11845	2013-10-10	"Thu"	"Evening"	"528"	5	2	8	15
11844	2013-10-10	"Thu"	"Midday"	"495"	4	9	5	18
11843	2013-10-09	"Wed"	"Evening"	"126"	1	2	6	9
11842	2013-10-09	"Wed"	"Midday"	"084"	0	8	4	12
11841	2013-10-08	"Tue"	"Evening"	"048"	0	4	8	12
11840	2013-10-08	"Tue"	"Midday"	"828"	8	2	8	18
11839	2013-10-07	"Mon"	"Evening"	"946"	9	4	6	19
11838	2013-10-07	"Mon"	"Midday"	"255"	2	5	5	12
11837	2013-10-06	"Sun"	"Evening"	"556"	5	5	6	16
11836	2013-10-06	"Sun"	"Midday"	"385"	3	8	5	16
11835	2013-10-05	"Sat"	"Evening"	"020"	0	2	0	2
11834	2013-10-05	"Sat"	"Midday"	"327"	3	2	7	12
11833	2013-10-04	"Fri"	"Evening"	"407"	4	0	7	11
11832	2013-10-04	"Fri"	"Midday"	"159"	1	5	9	15
11831	2013-10-03	"Thu"	"Evening"	"862"	8	6	2	16
11830	2013-10-03	"Thu"	"Midday"	"888"	8	8	8	24
11829	2013-10-02	"Wed"	"Evening"	"385"	3	8	5	16
11828	2013-10-02	"Wed"	"Midday"	"803"	8	0	3	11
11827	2013-10-01	"Tue"	"Evening"	"984"	9	8	4	21
11826	2013-10-01	"Tue"	"Midday"	"765"	7	6	5	18
11825	2013-09-30	"Mon"	"Evening"	"726"	7	2	6	15
11824	2013-09-30	"Mon"	"Midday"	"711"	7	1	1	9
11823	2013-09-29	"Sun"	"Evening"	"306"	3	0	6	9
11822	2013-09-29	"Sun"	"Midday"	"641"	6	4	1	11
11821	2013-09-28	"Sat"	"Evening"	"048"	0	4	8	12
11820	2013-09-28	"Sat"	"Midday"	"359"	3	5	9	17
11819	2013-09-27	"Fri"	"Evening"	"908"	9	0	8	17
11818	2013-09-27	"Fri"	"Midday"	"068"	0	6	8	14
11817	2013-09-26	"Thu"	"Evening"	"971"	9	7	1	17
11816	2013-09-26	"Thu"	"Midday"	"826"	8	2	6	16
11815	2013-09-25	"Wed"	"Evening"	"577"	5	7	7	19
11814	2013-09-25	"Wed"	"Midday"	"778"	7	7	8	22
11813	2013-09-24	"Tue"	"Evening"	"885"	8	8	5	21
11812	2013-09-24	"Tue"	"Midday"	"392"	3	9	2	14
11811	2013-09-23	"Mon"	"Evening"	"818"	8	1	8	17
11810	2013-09-23	"Mon"	"Midday"	"739"	7	3	9	19
11809	2013-09-22	"Sun"	"Evening"	"694"	6	9	4	19
11808	2013-09-22	"Sun"	"Midday"	"330"	3	3	0	6
11807	2013-09-21	"Sat"	"Evening"	"174"	1	7	4	12
11806	2013-09-21	"Sat"	"Midday"	"307"	3	0	7	10
11805	2013-09-20	"Fri"	"Evening"	"975"	9	7	5	21
11804	2013-09-20	"Fri"	"Midday"	"254"	2	5	4	11
11803	2013-09-19	"Thu"	"Evening"	"492"	4	9	2	15
11802	2013-09-19	"Thu"	"Midday"	"611"	6	1	1	8
11801	2013-09-18	"Wed"	"Evening"	"807"	8	0	7	15
11800	2013-09-18	"Wed"	"Midday"	"091"	0	9	1	10
11799	2013-09-17	"Tue"	"Evening"	"696"	6	9	6	21
11798	2013-09-17	"Tue"	"Midday"	"908"	9	0	8	17
11797	2013-09-16	"Mon"	"Evening"	"991"	9	9	1	19
11796	2013-09-16	"Mon"	"Midday"	"388"	3	8	8	19
11795	2013-09-15	"Sun"	"Evening"	"873"	8	7	3	18
11794	2013-09-15	"Sun"	"Midday"	"097"	0	9	7	16
11793	2013-09-14	"Sat"	"Evening"	"402"	4	0	2	6
11792	2013-09-14	"Sat"	"Midday"	"164"	1	6	4	11
11791	2013-09-13	"Fri"	"Evening"	"399"	3	9	9	21
11790	2013-09-13	"Fri"	"Midday"	"310"	3	1	0	4
11789	2013-09-12	"Thu"	"Evening"	"928"	9	2	8	19
11788	2013-09-12	"Thu"	"Midday"	"548"	5	4	8	17
11787	2013-09-11	"Wed"	"Evening"	"590"	5	9	0	14
11786	2013-09-11	"Wed"	"Midday"	"779"	7	7	9	23
11785	2013-09-10	"Tue"	"Evening"	"339"	3	3	9	15
11784	2013-09-10	"Tue"	"Midday"	"418"	4	1	8	13
11783	2013-09-09	"Mon"	"Evening"	"919"	9	1	9	19
11782	2013-09-09	"Mon"	"Midday"	"660"	6	6	0	12
11781	2013-09-08	"Sun"	"Evening"	"693"	6	9	3	18
11780	2013-09-08	"Sun"	"Midday"	"423"	4	2	3	9
11779	2013-09-07	"Sat"	"Evening"	"611"	6	1	1	8
11778	2013-09-07	"Sat"	"Midday"	"656"	6	5	6	17
11777	2013-09-06	"Fri"	"Evening"	"541"	5	4	1	10
11776	2013-09-06	"Fri"	"Midday"	"543"	5	4	3	12
11775	2013-09-05	"Thu"	"Evening"	"492"	4	9	2	15
11774	2013-09-05	"Thu"	"Midday"	"308"	3	0	8	11
11773	2013-09-04	"Wed"	"Evening"	"089"	0	8	9	17
11772	2013-09-04	"Wed"	"Midday"	"193"	1	9	3	13
11771	2013-09-03	"Tue"	"Evening"	"865"	8	6	5	19
11770	2013-09-03	"Tue"	"Midday"	"870"	8	7	0	15
11769	2013-09-02	"Mon"	"Evening"	"116"	1	1	6	8
11768	2013-09-02	"Mon"	"Midday"	"621"	6	2	1	9
11767	2013-09-01	"Sun"	"Evening"	"264"	2	6	4	12
11766	2013-09-01	"Sun"	"Midday"	"957"	9	5	7	21
11765	2013-08-31	"Sat"	"Evening"	"292"	2	9	2	13
11764	2013-08-31	"Sat"	"Midday"	"550"	5	5	0	10
11763	2013-08-30	"Fri"	"Evening"	"955"	9	5	5	19
11762	2013-08-30	"Fri"	"Midday"	"523"	5	2	3	10
11761	2013-08-29	"Thu"	"Evening"	"932"	9	3	2	14
11760	2013-08-29	"Thu"	"Midday"	"903"	9	0	3	12
11759	2013-08-28	"Wed"	"Evening"	"387"	3	8	7	18
11758	2013-08-28	"Wed"	"Midday"	"545"	5	4	5	14
11757	2013-08-27	"Tue"	"Evening"	"039"	0	3	9	12
11756	2013-08-27	"Tue"	"Midday"	"809"	8	0	9	17
11755	2013-08-26	"Mon"	"Evening"	"938"	9	3	8	20
11754	2013-08-26	"Mon"	"Midday"	"255"	2	5	5	12
11753	2013-08-25	"Sun"	"Evening"	"655"	6	5	5	16
11752	2013-08-25	"Sun"	"Midday"	"681"	6	8	1	15
11751	2013-08-24	"Sat"	"Evening"	"466"	4	6	6	16
11750	2013-08-24	"Sat"	"Midday"	"423"	4	2	3	9
11749	2013-08-23	"Fri"	"Evening"	"207"	2	0	7	9
11748	2013-08-23	"Fri"	"Midday"	"619"	6	1	9	16
11747	2013-08-22	"Thu"	"Evening"	"554"	5	5	4	14
11746	2013-08-22	"Thu"	"Midday"	"830"	8	3	0	11
11745	2013-08-21	"Wed"	"Evening"	"090"	0	9	0	9
11744	2013-08-21	"Wed"	"Midday"	"250"	2	5	0	7
11743	2013-08-20	"Tue"	"Evening"	"501"	5	0	1	6
11742	2013-08-20	"Tue"	"Midday"	"358"	3	5	8	16
11741	2013-08-19	"Mon"	"Evening"	"118"	1	1	8	10
11740	2013-08-19	"Mon"	"Midday"	"519"	5	1	9	15
11739	2013-08-18	"Sun"	"Evening"	"073"	0	7	3	10
11738	2013-08-18	"Sun"	"Midday"	"265"	2	6	5	13
11737	2013-08-17	"Sat"	"Evening"	"004"	0	0	4	4
11736	2013-08-17	"Sat"	"Midday"	"346"	3	4	6	13
11735	2013-08-16	"Fri"	"Evening"	"006"	0	0	6	6
11734	2013-08-16	"Fri"	"Midday"	"644"	6	4	4	14
11733	2013-08-15	"Thu"	"Evening"	"607"	6	0	7	13
11732	2013-08-15	"Thu"	"Midday"	"094"	0	9	4	13
11731	2013-08-14	"Wed"	"Evening"	"673"	6	7	3	16
11730	2013-08-14	"Wed"	"Midday"	"348"	3	4	8	15
11729	2013-08-13	"Tue"	"Evening"	"185"	1	8	5	14
11728	2013-08-13	"Tue"	"Midday"	"765"	7	6	5	18
11727	2013-08-12	"Mon"	"Evening"	"339"	3	3	9	15
11726	2013-08-12	"Mon"	"Midday"	"773"	7	7	3	17
11725	2013-08-11	"Sun"	"Evening"	"197"	1	9	7	17
11724	2013-08-11	"Sun"	"Midday"	"181"	1	8	1	10
11723	2013-08-10	"Sat"	"Evening"	"507"	5	0	7	12
11722	2013-08-10	"Sat"	"Midday"	"555"	5	5	5	15
11721	2013-08-09	"Fri"	"Evening"	"424"	4	2	4	10
11720	2013-08-09	"Fri"	"Midday"	"068"	0	6	8	14
11719	2013-08-08	"Thu"	"Evening"	"731"	7	3	1	11
11718	2013-08-08	"Thu"	"Midday"	"739"	7	3	9	19
11717	2013-08-07	"Wed"	"Evening"	"201"	2	0	1	3
11716	2013-08-07	"Wed"	"Midday"	"386"	3	8	6	17
11715	2013-08-06	"Tue"	"Evening"	"129"	1	2	9	12
11714	2013-08-06	"Tue"	"Midday"	"033"	0	3	3	6
11713	2013-08-05	"Mon"	"Evening"	"752"	7	5	2	14
11712	2013-08-05	"Mon"	"Midday"	"078"	0	7	8	15
11711	2013-08-04	"Sun"	"Evening"	"578"	5	7	8	20
11710	2013-08-04	"Sun"	"Midday"	"576"	5	7	6	18
11709	2013-08-03	"Sat"	"Evening"	"028"	0	2	8	10
11708	2013-08-03	"Sat"	"Midday"	"486"	4	8	6	18
11707	2013-08-02	"Fri"	"Evening"	"088"	0	8	8	16
11706	2013-08-02	"Fri"	"Midday"	"840"	8	4	0	12
11705	2013-08-01	"Thu"	"Evening"	"779"	7	7	9	23
11704	2013-08-01	"Thu"	"Midday"	"031"	0	3	1	4
11703	2013-07-31	"Wed"	"Evening"	"206"	2	0	6	8
11702	2013-07-31	"Wed"	"Midday"	"992"	9	9	2	20
11701	2013-07-30	"Tue"	"Evening"	"613"	6	1	3	10
11700	2013-07-30	"Tue"	"Midday"	"020"	0	2	0	2
11699	2013-07-29	"Mon"	"Evening"	"643"	6	4	3	13
11698	2013-07-29	"Mon"	"Midday"	"521"	5	2	1	8
11697	2013-07-28	"Sun"	"Evening"	"128"	1	2	8	11
11696	2013-07-28	"Sun"	"Midday"	"783"	7	8	3	18
11695	2013-07-27	"Sat"	"Evening"	"555"	5	5	5	15
11694	2013-07-27	"Sat"	"Midday"	"471"	4	7	1	12
11693	2013-07-26	"Fri"	"Evening"	"614"	6	1	4	11
11692	2013-07-26	"Fri"	"Midday"	"957"	9	5	7	21
11691	2013-07-25	"Thu"	"Evening"	"163"	1	6	3	10
11690	2013-07-25	"Thu"	"Midday"	"157"	1	5	7	13
11689	2013-07-24	"Wed"	"Evening"	"038"	0	3	8	11
11688	2013-07-24	"Wed"	"Midday"	"782"	7	8	2	17
11687	2013-07-23	"Tue"	"Evening"	"762"	7	6	2	15
11686	2013-07-23	"Tue"	"Midday"	"159"	1	5	9	15
11685	2013-07-22	"Mon"	"Evening"	"577"	5	7	7	19
11684	2013-07-22	"Mon"	"Midday"	"502"	5	0	2	7
11683	2013-07-21	"Sun"	"Evening"	"971"	9	7	1	17
11682	2013-07-21	"Sun"	"Midday"	"922"	9	2	2	13
11681	2013-07-20	"Sat"	"Evening"	"215"	2	1	5	8
11680	2013-07-20	"Sat"	"Midday"	"930"	9	3	0	12
11679	2013-07-19	"Fri"	"Evening"	"075"	0	7	5	12
11678	2013-07-19	"Fri"	"Midday"	"806"	8	0	6	14
11677	2013-07-18	"Thu"	"Evening"	"519"	5	1	9	15
11676	2013-07-18	"Thu"	"Midday"	"341"	3	4	1	8
11675	2013-07-17	"Wed"	"Evening"	"259"	2	5	9	16
11674	2013-07-17	"Wed"	"Midday"	"203"	2	0	3	5
11673	2013-07-16	"Tue"	"Evening"	"558"	5	5	8	18
11672	2013-07-16	"Tue"	"Midday"	"603"	6	0	3	9
11671	2013-07-15	"Mon"	"Evening"	"254"	2	5	4	11
11670	2013-07-15	"Mon"	"Midday"	"399"	3	9	9	21
11669	2013-07-14	"Sun"	"Evening"	"202"	2	0	2	4
11668	2013-07-14	"Sun"	"Midday"	"798"	7	9	8	24
11667	2013-07-13	"Sat"	"Evening"	"677"	6	7	7	20
11666	2013-07-13	"Sat"	"Midday"	"008"	0	0	8	8
11665	2013-07-12	"Fri"	"Evening"	"442"	4	4	2	10
11664	2013-07-12	"Fri"	"Midday"	"869"	8	6	9	23
11663	2013-07-11	"Thu"	"Evening"	"014"	0	1	4	5
11662	2013-07-11	"Thu"	"Midday"	"402"	4	0	2	6
11661	2013-07-10	"Wed"	"Evening"	"180"	1	8	0	9
11660	2013-07-10	"Wed"	"Midday"	"607"	6	0	7	13
11659	2013-07-09	"Tue"	"Evening"	"885"	8	8	5	21
11658	2013-07-09	"Tue"	"Midday"	"581"	5	8	1	14
11657	2013-07-08	"Mon"	"Evening"	"824"	8	2	4	14
11656	2013-07-08	"Mon"	"Midday"	"554"	5	5	4	14
11655	2013-07-07	"Sun"	"Evening"	"965"	9	6	5	20
11654	2013-07-07	"Sun"	"Midday"	"132"	1	3	2	6
11653	2013-07-06	"Sat"	"Evening"	"518"	5	1	8	14
11652	2013-07-06	"Sat"	"Midday"	"796"	7	9	6	22
11651	2013-07-05	"Fri"	"Evening"	"299"	2	9	9	20
11650	2013-07-05	"Fri"	"Midday"	"303"	3	0	3	6
11649	2013-07-04	"Thu"	"Evening"	"161"	1	6	1	8
11648	2013-07-04	"Thu"	"Midday"	"326"	3	2	6	11
11647	2013-07-03	"Wed"	"Evening"	"499"	4	9	9	22
11646	2013-07-03	"Wed"	"Midday"	"934"	9	3	4	16
11645	2013-07-02	"Tue"	"Evening"	"940"	9	4	0	13
11644	2013-07-02	"Tue"	"Midday"	"171"	1	7	1	9
11643	2013-07-01	"Mon"	"Evening"	"501"	5	0	1	6
11642	2013-07-01	"Mon"	"Midday"	"238"	2	3	8	13
11641	2013-06-30	"Sun"	"Evening"	"002"	0	0	2	2
11640	2013-06-30	"Sun"	"Midday"	"537"	5	3	7	15
11639	2013-06-29	"Sat"	"Evening"	"684"	6	8	4	18
11638	2013-06-29	"Sat"	"Midday"	"250"	2	5	0	7
11637	2013-06-28	"Fri"	"Evening"	"770"	7	7	0	14
11636	2013-06-28	"Fri"	"Midday"	"921"	9	2	1	12
11635	2013-06-27	"Thu"	"Evening"	"252"	2	5	2	9
11634	2013-06-27	"Thu"	"Midday"	"858"	8	5	8	21
11633	2013-06-26	"Wed"	"Evening"	"032"	0	3	2	5
11632	2013-06-26	"Wed"	"Midday"	"871"	8	7	1	16
11631	2013-06-25	"Tue"	"Evening"	"362"	3	6	2	11
11630	2013-06-25	"Tue"	"Midday"	"118"	1	1	8	10
11629	2013-06-24	"Mon"	"Evening"	"857"	8	5	7	20
11628	2013-06-24	"Mon"	"Midday"	"730"	7	3	0	10
11627	2013-06-23	"Sun"	"Evening"	"716"	7	1	6	14
11626	2013-06-23	"Sun"	"Midday"	"885"	8	8	5	21
11625	2013-06-22	"Sat"	"Evening"	"894"	8	9	4	21
11624	2013-06-22	"Sat"	"Midday"	"502"	5	0	2	7
11623	2013-06-21	"Fri"	"Evening"	"907"	9	0	7	16
11622	2013-06-21	"Fri"	"Midday"	"079"	0	7	9	16
11621	2013-06-20	"Thu"	"Evening"	"564"	5	6	4	15
11620	2013-06-20	"Thu"	"Midday"	"483"	4	8	3	15
11619	2013-06-19	"Wed"	"Evening"	"793"	7	9	3	19
11618	2013-06-19	"Wed"	"Midday"	"214"	2	1	4	7
11617	2013-06-18	"Tue"	"Evening"	"041"	0	4	1	5
11616	2013-06-18	"Tue"	"Midday"	"358"	3	5	8	16
11615	2013-06-17	"Mon"	"Evening"	"928"	9	2	8	19
11614	2013-06-17	"Mon"	"Midday"	"328"	3	2	8	13
11613	2013-06-16	"Sun"	"Evening"	"489"	4	8	9	21
11612	2013-06-16	"Sun"	"Midday"	"999"	9	9	9	27
11611	2013-06-15	"Sat"	"Evening"	"641"	6	4	1	11
11610	2013-06-15	"Sat"	"Midday"	"817"	8	1	7	16
11609	2013-06-14	"Fri"	"Evening"	"807"	8	0	7	15
11608	2013-06-14	"Fri"	"Midday"	"742"	7	4	2	13
11607	2013-06-13	"Thu"	"Evening"	"279"	2	7	9	18
11606	2013-06-13	"Thu"	"Midday"	"313"	3	1	3	7
11605	2013-06-12	"Wed"	"Evening"	"778"	7	7	8	22
11604	2013-06-12	"Wed"	"Midday"	"207"	2	0	7	9
11603	2013-06-11	"Tue"	"Evening"	"173"	1	7	3	11
11602	2013-06-11	"Tue"	"Midday"	"558"	5	5	8	18
11601	2013-06-10	"Mon"	"Evening"	"656"	6	5	6	17
11600	2013-06-10	"Mon"	"Midday"	"541"	5	4	1	10
11599	2013-06-09	"Sun"	"Evening"	"705"	7	0	5	12
11598	2013-06-09	"Sun"	"Midday"	"836"	8	3	6	17
11597	2013-06-08	"Sat"	"Evening"	"250"	2	5	0	7
11596	2013-06-08	"Sat"	"Midday"	"667"	6	6	7	19
11595	2013-06-07	"Fri"	"Evening"	"663"	6	6	3	15
11594	2013-06-07	"Fri"	"Midday"	"837"	8	3	7	18
11593	2013-06-06	"Thu"	"Evening"	"223"	2	2	3	7
11592	2013-06-06	"Thu"	"Midday"	"583"	5	8	3	16
11591	2013-06-05	"Wed"	"Evening"	"280"	2	8	0	10
11590	2013-06-05	"Wed"	"Midday"	"787"	7	8	7	22
11589	2013-06-04	"Tue"	"Evening"	"638"	6	3	8	17
11588	2013-06-04	"Tue"	"Midday"	"039"	0	3	9	12
11587	2013-06-03	"Mon"	"Evening"	"602"	6	0	2	8
11586	2013-06-03	"Mon"	"Midday"	"312"	3	1	2	6
11585	2013-06-02	"Sun"	"Evening"	"350"	3	5	0	8
11584	2013-06-02	"Sun"	"Midday"	"804"	8	0	4	12
11583	2013-06-01	"Sat"	"Evening"	"439"	4	3	9	16
11582	2013-06-01	"Sat"	"Midday"	"635"	6	3	5	14
11581	2013-05-31	"Fri"	"Evening"	"341"	3	4	1	8
11580	2013-05-31	"Fri"	"Midday"	"715"	7	1	5	13
11579	2013-05-30	"Thu"	"Evening"	"566"	5	6	6	17
11578	2013-05-30	"Thu"	"Midday"	"312"	3	1	2	6
11577	2013-05-29	"Wed"	"Evening"	"450"	4	5	0	9
11576	2013-05-29	"Wed"	"Midday"	"333"	3	3	3	9
11575	2013-05-28	"Tue"	"Evening"	"679"	6	7	9	22
11574	2013-05-28	"Tue"	"Midday"	"428"	4	2	8	14
11573	2013-05-27	"Mon"	"Evening"	"551"	5	5	1	11
11572	2013-05-27	"Mon"	"Midday"	"729"	7	2	9	18
11571	2013-05-26	"Sun"	"Evening"	"689"	6	8	9	23
11570	2013-05-26	"Sun"	"Midday"	"469"	4	6	9	19
11569	2013-05-25	"Sat"	"Evening"	"011"	0	1	1	2
11568	2013-05-25	"Sat"	"Midday"	"066"	0	6	6	12
11567	2013-05-24	"Fri"	"Evening"	"912"	9	1	2	12
11566	2013-05-24	"Fri"	"Midday"	"508"	5	0	8	13
11565	2013-05-23	"Thu"	"Evening"	"940"	9	4	0	13
11564	2013-05-23	"Thu"	"Midday"	"733"	7	3	3	13
11563	2013-05-22	"Wed"	"Evening"	"035"	0	3	5	8
11562	2013-05-22	"Wed"	"Midday"	"583"	5	8	3	16
11561	2013-05-21	"Tue"	"Evening"	"865"	8	6	5	19
11560	2013-05-21	"Tue"	"Midday"	"175"	1	7	5	13
11559	2013-05-20	"Mon"	"Evening"	"847"	8	4	7	19
11558	2013-05-20	"Mon"	"Midday"	"339"	3	3	9	15
11557	2013-05-19	"Sun"	"Evening"	"364"	3	6	4	13
11556	2013-05-19	"Sun"	"Midday"	"328"	3	2	8	13
11555	2013-05-18	"Sat"	"Evening"	"810"	8	1	0	9
11554	2013-05-18	"Sat"	"Midday"	"010"	0	1	0	1
11553	2013-05-17	"Fri"	"Evening"	"356"	3	5	6	14
11552	2013-05-17	"Fri"	"Midday"	"652"	6	5	2	13
11551	2013-05-16	"Thu"	"Evening"	"842"	8	4	2	14
11550	2013-05-16	"Thu"	"Midday"	"679"	6	7	9	22
11549	2013-05-15	"Wed"	"Evening"	"438"	4	3	8	15
11548	2013-05-15	"Wed"	"Midday"	"232"	2	3	2	7
11547	2013-05-14	"Tue"	"Evening"	"411"	4	1	1	6
11546	2013-05-14	"Tue"	"Midday"	"108"	1	0	8	9
11545	2013-05-13	"Mon"	"Evening"	"848"	8	4	8	20
11544	2013-05-13	"Mon"	"Midday"	"547"	5	4	7	16
11543	2013-05-12	"Sun"	"Evening"	"976"	9	7	6	22
11542	2013-05-12	"Sun"	"Midday"	"021"	0	2	1	3
11541	2013-05-11	"Sat"	"Evening"	"922"	9	2	2	13
11540	2013-05-11	"Sat"	"Midday"	"171"	1	7	1	9
11539	2013-05-10	"Fri"	"Evening"	"737"	7	3	7	17
11538	2013-05-10	"Fri"	"Midday"	"204"	2	0	4	6
11537	2013-05-09	"Thu"	"Evening"	"387"	3	8	7	18
11536	2013-05-09	"Thu"	"Midday"	"357"	3	5	7	15
11535	2013-05-08	"Wed"	"Evening"	"438"	4	3	8	15
11534	2013-05-08	"Wed"	"Midday"	"390"	3	9	0	12
11533	2013-05-07	"Tue"	"Evening"	"579"	5	7	9	21
11532	2013-05-07	"Tue"	"Midday"	"368"	3	6	8	17
11531	2013-05-06	"Mon"	"Evening"	"428"	4	2	8	14
11530	2013-05-06	"Mon"	"Midday"	"187"	1	8	7	16
11529	2013-05-05	"Sun"	"Evening"	"379"	3	7	9	19
11528	2013-05-05	"Sun"	"Midday"	"257"	2	5	7	14
11527	2013-05-04	"Sat"	"Evening"	"594"	5	9	4	18
11526	2013-05-04	"Sat"	"Midday"	"177"	1	7	7	15
11525	2013-05-03	"Fri"	"Evening"	"088"	0	8	8	16
11524	2013-05-03	"Fri"	"Midday"	"103"	1	0	3	4
11523	2013-05-02	"Thu"	"Evening"	"562"	5	6	2	13
11522	2013-05-02	"Thu"	"Midday"	"732"	7	3	2	12
11521	2013-05-01	"Wed"	"Evening"	"141"	1	4	1	6
11520	2013-05-01	"Wed"	"Midday"	"133"	1	3	3	7
11519	2013-04-30	"Tue"	"Evening"	"834"	8	3	4	15
11518	2013-04-30	"Tue"	"Midday"	"809"	8	0	9	17
11517	2013-04-29	"Mon"	"Evening"	"027"	0	2	7	9
11516	2013-04-29	"Mon"	"Midday"	"551"	5	5	1	11
11515	2013-04-28	"Sun"	"Evening"	"685"	6	8	5	19
11514	2013-04-28	"Sun"	"Midday"	"545"	5	4	5	14
11513	2013-04-27	"Sat"	"Evening"	"962"	9	6	2	17
11512	2013-04-27	"Sat"	"Midday"	"028"	0	2	8	10
11511	2013-04-26	"Fri"	"Evening"	"990"	9	9	0	18
11510	2013-04-26	"Fri"	"Midday"	"157"	1	5	7	13
11509	2013-04-25	"Thu"	"Evening"	"129"	1	2	9	12
11508	2013-04-25	"Thu"	"Midday"	"966"	9	6	6	21
11507	2013-04-24	"Wed"	"Evening"	"979"	9	7	9	25
11506	2013-04-24	"Wed"	"Midday"	"705"	7	0	5	12
11505	2013-04-23	"Tue"	"Evening"	"422"	4	2	2	8
11504	2013-04-23	"Tue"	"Midday"	"828"	8	2	8	18
11503	2013-04-22	"Mon"	"Evening"	"045"	0	4	5	9
11502	2013-04-22	"Mon"	"Midday"	"069"	0	6	9	15
11501	2013-04-21	"Sun"	"Evening"	"472"	4	7	2	13
11500	2013-04-21	"Sun"	"Midday"	"936"	9	3	6	18
11499	2013-04-20	"Sat"	"Evening"	"666"	6	6	6	18
11498	2013-04-20	"Sat"	"Midday"	"813"	8	1	3	12
11497	2013-04-19	"Fri"	"Evening"	"638"	6	3	8	17
11496	2013-04-19	"Fri"	"Midday"	"898"	8	9	8	25
11495	2013-04-18	"Thu"	"Evening"	"015"	0	1	5	6
11494	2013-04-18	"Thu"	"Midday"	"328"	3	2	8	13
11493	2013-04-17	"Wed"	"Evening"	"710"	7	1	0	8
11492	2013-04-17	"Wed"	"Midday"	"953"	9	5	3	17
11491	2013-04-16	"Tue"	"Evening"	"745"	7	4	5	16
11490	2013-04-16	"Tue"	"Midday"	"832"	8	3	2	13
11489	2013-04-15	"Mon"	"Evening"	"825"	8	2	5	15
11488	2013-04-15	"Mon"	"Midday"	"108"	1	0	8	9
11487	2013-04-14	"Sun"	"Evening"	"095"	0	9	5	14
11486	2013-04-14	"Sun"	"Midday"	"130"	1	3	0	4
11485	2013-04-13	"Sat"	"Evening"	"434"	4	3	4	11
11484	2013-04-13	"Sat"	"Midday"	"447"	4	4	7	15
11483	2013-04-12	"Fri"	"Evening"	"414"	4	1	4	9
11482	2013-04-12	"Fri"	"Midday"	"520"	5	2	0	7
11481	2013-04-11	"Thu"	"Evening"	"174"	1	7	4	12
11480	2013-04-11	"Thu"	"Midday"	"372"	3	7	2	12
11479	2013-04-10	"Wed"	"Evening"	"404"	4	0	4	8
11478	2013-04-10	"Wed"	"Midday"	"661"	6	6	1	13
11477	2013-04-09	"Tue"	"Evening"	"187"	1	8	7	16
11476	2013-04-09	"Tue"	"Midday"	"104"	1	0	4	5
11475	2013-04-08	"Mon"	"Evening"	"119"	1	1	9	11
11474	2013-04-08	"Mon"	"Midday"	"404"	4	0	4	8
11473	2013-04-07	"Sun"	"Evening"	"149"	1	4	9	14
11472	2013-04-07	"Sun"	"Midday"	"504"	5	0	4	9
11471	2013-04-06	"Sat"	"Evening"	"507"	5	0	7	12
11470	2013-04-06	"Sat"	"Midday"	"232"	2	3	2	7
11469	2013-04-05	"Fri"	"Evening"	"739"	7	3	9	19
11468	2013-04-05	"Fri"	"Midday"	"241"	2	4	1	7
11467	2013-04-04	"Thu"	"Evening"	"207"	2	0	7	9
11466	2013-04-04	"Thu"	"Midday"	"678"	6	7	8	21
11465	2013-04-03	"Wed"	"Evening"	"060"	0	6	0	6
11464	2013-04-03	"Wed"	"Midday"	"907"	9	0	7	16
11463	2013-04-02	"Tue"	"Evening"	"674"	6	7	4	17
11462	2013-04-02	"Tue"	"Midday"	"432"	4	3	2	9
11461	2013-04-01	"Mon"	"Evening"	"768"	7	6	8	21
11460	2013-04-01	"Mon"	"Midday"	"962"	9	6	2	17
11459	2013-03-31	"Sun"	"Evening"	"901"	9	0	1	10
11458	2013-03-31	"Sun"	"Midday"	"868"	8	6	8	22
11457	2013-03-30	"Sat"	"Evening"	"262"	2	6	2	10
11456	2013-03-30	"Sat"	"Midday"	"621"	6	2	1	9
11455	2013-03-29	"Fri"	"Evening"	"994"	9	9	4	22
11454	2013-03-29	"Fri"	"Midday"	"561"	5	6	1	12
11453	2013-03-28	"Thu"	"Evening"	"261"	2	6	1	9
11452	2013-03-28	"Thu"	"Midday"	"083"	0	8	3	11
11451	2013-03-27	"Wed"	"Evening"	"096"	0	9	6	15
11450	2013-03-27	"Wed"	"Midday"	"206"	2	0	6	8
11449	2013-03-26	"Tue"	"Evening"	"263"	2	6	3	11
11448	2013-03-26	"Tue"	"Midday"	"929"	9	2	9	20
11447	2013-03-25	"Mon"	"Evening"	"662"	6	6	2	14
11446	2013-03-25	"Mon"	"Midday"	"194"	1	9	4	14
11445	2013-03-24	"Sun"	"Evening"	"531"	5	3	1	9
11444	2013-03-24	"Sun"	"Midday"	"068"	0	6	8	14
11443	2013-03-23	"Sat"	"Evening"	"235"	2	3	5	10
11442	2013-03-23	"Sat"	"Midday"	"366"	3	6	6	15
11441	2013-03-22	"Fri"	"Evening"	"395"	3	9	5	17
11440	2013-03-22	"Fri"	"Midday"	"972"	9	7	2	18
11439	2013-03-21	"Thu"	"Evening"	"654"	6	5	4	15
11438	2013-03-21	"Thu"	"Midday"	"649"	6	4	9	19
11437	2013-03-20	"Wed"	"Evening"	"973"	9	7	3	19
11436	2013-03-20	"Wed"	"Midday"	"916"	9	1	6	16
11435	2013-03-19	"Tue"	"Evening"	"843"	8	4	3	15
11434	2013-03-19	"Tue"	"Midday"	"494"	4	9	4	17
11433	2013-03-18	"Mon"	"Evening"	"886"	8	8	6	22
11432	2013-03-18	"Mon"	"Midday"	"323"	3	2	3	8
11431	2013-03-17	"Sun"	"Evening"	"141"	1	4	1	6
11430	2013-03-17	"Sun"	"Midday"	"962"	9	6	2	17
11429	2013-03-16	"Sat"	"Evening"	"589"	5	8	9	22
11428	2013-03-16	"Sat"	"Midday"	"100"	1	0	0	1
11427	2013-03-15	"Fri"	"Evening"	"951"	9	5	1	15
11426	2013-03-15	"Fri"	"Midday"	"329"	3	2	9	14
11425	2013-03-14	"Thu"	"Evening"	"693"	6	9	3	18
11424	2013-03-14	"Thu"	"Midday"	"067"	0	6	7	13
11423	2013-03-13	"Wed"	"Evening"	"603"	6	0	3	9
11422	2013-03-13	"Wed"	"Midday"	"799"	7	9	9	25
11421	2013-03-12	"Tue"	"Evening"	"746"	7	4	6	17
11420	2013-03-12	"Tue"	"Midday"	"194"	1	9	4	14
11419	2013-03-11	"Mon"	"Evening"	"857"	8	5	7	20
11418	2013-03-11	"Mon"	"Midday"	"444"	4	4	4	12
11417	2013-03-10	"Sun"	"Evening"	"549"	5	4	9	18
11416	2013-03-10	"Sun"	"Midday"	"638"	6	3	8	17
11415	2013-03-09	"Sat"	"Evening"	"677"	6	7	7	20
11414	2013-03-09	"Sat"	"Midday"	"443"	4	4	3	11
11413	2013-03-08	"Fri"	"Evening"	"795"	7	9	5	21
11412	2013-03-08	"Fri"	"Midday"	"544"	5	4	4	13
11411	2013-03-07	"Thu"	"Evening"	"582"	5	8	2	15
11410	2013-03-07	"Thu"	"Midday"	"823"	8	2	3	13
11409	2013-03-06	"Wed"	"Evening"	"773"	7	7	3	17
11408	2013-03-06	"Wed"	"Midday"	"088"	0	8	8	16
11407	2013-03-05	"Tue"	"Evening"	"801"	8	0	1	9
11406	2013-03-05	"Tue"	"Midday"	"600"	6	0	0	6
11405	2013-03-04	"Mon"	"Evening"	"415"	4	1	5	10
11404	2013-03-04	"Mon"	"Midday"	"976"	9	7	6	22
11403	2013-03-03	"Sun"	"Evening"	"355"	3	5	5	13
11402	2013-03-03	"Sun"	"Midday"	"189"	1	8	9	18
11401	2013-03-02	"Sat"	"Evening"	"300"	3	0	0	3
11400	2013-03-02	"Sat"	"Midday"	"397"	3	9	7	19
11399	2013-03-01	"Fri"	"Evening"	"137"	1	3	7	11
11398	2013-03-01	"Fri"	"Midday"	"637"	6	3	7	16
11397	2013-02-28	"Thu"	"Evening"	"550"	5	5	0	10
11396	2013-02-28	"Thu"	"Midday"	"586"	5	8	6	19
11395	2013-02-27	"Wed"	"Evening"	"925"	9	2	5	16
11394	2013-02-27	"Wed"	"Midday"	"058"	0	5	8	13
11393	2013-02-26	"Tue"	"Evening"	"532"	5	3	2	10
11392	2013-02-26	"Tue"	"Midday"	"225"	2	2	5	9
11391	2013-02-25	"Mon"	"Evening"	"521"	5	2	1	8
11390	2013-02-25	"Mon"	"Midday"	"400"	4	0	0	4
11389	2013-02-24	"Sun"	"Evening"	"627"	6	2	7	15
11388	2013-02-24	"Sun"	"Midday"	"394"	3	9	4	16
11387	2013-02-23	"Sat"	"Evening"	"484"	4	8	4	16
11386	2013-02-23	"Sat"	"Midday"	"218"	2	1	8	11
11385	2013-02-22	"Fri"	"Evening"	"076"	0	7	6	13
11384	2013-02-22	"Fri"	"Midday"	"411"	4	1	1	6
11383	2013-02-21	"Thu"	"Evening"	"383"	3	8	3	14
11382	2013-02-21	"Thu"	"Midday"	"650"	6	5	0	11
11381	2013-02-20	"Wed"	"Evening"	"035"	0	3	5	8
11380	2013-02-20	"Wed"	"Midday"	"228"	2	2	8	12
11379	2013-02-19	"Tue"	"Evening"	"018"	0	1	8	9
11378	2013-02-19	"Tue"	"Midday"	"731"	7	3	1	11
11377	2013-02-18	"Mon"	"Evening"	"179"	1	7	9	17
11376	2013-02-18	"Mon"	"Midday"	"186"	1	8	6	15
11375	2013-02-17	"Sun"	"Evening"	"374"	3	7	4	14
11374	2013-02-17	"Sun"	"Midday"	"958"	9	5	8	22
11373	2013-02-16	"Sat"	"Evening"	"645"	6	4	5	15
11372	2013-02-16	"Sat"	"Midday"	"546"	5	4	6	15
11371	2013-02-15	"Fri"	"Evening"	"086"	0	8	6	14
11370	2013-02-15	"Fri"	"Midday"	"335"	3	3	5	11
11369	2013-02-14	"Thu"	"Evening"	"561"	5	6	1	12
11368	2013-02-14	"Thu"	"Midday"	"864"	8	6	4	18
11367	2013-02-13	"Wed"	"Evening"	"493"	4	9	3	16
11366	2013-02-13	"Wed"	"Midday"	"069"	0	6	9	15
11365	2013-02-12	"Tue"	"Evening"	"054"	0	5	4	9
11364	2013-02-12	"Tue"	"Midday"	"492"	4	9	2	15
11363	2013-02-11	"Mon"	"Evening"	"015"	0	1	5	6
11362	2013-02-11	"Mon"	"Midday"	"099"	0	9	9	18
11361	2013-02-10	"Sun"	"Evening"	"492"	4	9	2	15
11360	2013-02-10	"Sun"	"Midday"	"455"	4	5	5	14
11359	2013-02-09	"Sat"	"Evening"	"702"	7	0	2	9
11358	2013-02-09	"Sat"	"Midday"	"353"	3	5	3	11
11357	2013-02-08	"Fri"	"Evening"	"267"	2	6	7	15
11356	2013-02-08	"Fri"	"Midday"	"614"	6	1	4	11
11355	2013-02-07	"Thu"	"Evening"	"092"	0	9	2	11
11354	2013-02-07	"Thu"	"Midday"	"845"	8	4	5	17
11353	2013-02-06	"Wed"	"Evening"	"077"	0	7	7	14
11352	2013-02-06	"Wed"	"Midday"	"289"	2	8	9	19
11351	2013-02-05	"Tue"	"Evening"	"409"	4	0	9	13
11350	2013-02-05	"Tue"	"Midday"	"887"	8	8	7	23
11349	2013-02-04	"Mon"	"Evening"	"929"	9	2	9	20
11348	2013-02-04	"Mon"	"Midday"	"639"	6	3	9	18
11347	2013-02-03	"Sun"	"Evening"	"754"	7	5	4	16
11346	2013-02-03	"Sun"	"Midday"	"283"	2	8	3	13
11345	2013-02-02	"Sat"	"Evening"	"714"	7	1	4	12
11344	2013-02-02	"Sat"	"Midday"	"994"	9	9	4	22
11343	2013-02-01	"Fri"	"Evening"	"289"	2	8	9	19
11342	2013-02-01	"Fri"	"Midday"	"747"	7	4	7	18
11341	2013-01-31	"Thu"	"Evening"	"036"	0	3	6	9
11340	2013-01-31	"Thu"	"Midday"	"342"	3	4	2	9
11339	2013-01-30	"Wed"	"Evening"	"019"	0	1	9	10
11338	2013-01-30	"Wed"	"Midday"	"346"	3	4	6	13
11337	2013-01-29	"Tue"	"Evening"	"958"	9	5	8	22
11336	2013-01-29	"Tue"	"Midday"	"623"	6	2	3	11
11335	2013-01-28	"Mon"	"Evening"	"775"	7	7	5	19
11334	2013-01-28	"Mon"	"Midday"	"196"	1	9	6	16
11333	2013-01-27	"Sun"	"Evening"	"784"	7	8	4	19
11332	2013-01-27	"Sun"	"Midday"	"055"	0	5	5	10
11331	2013-01-26	"Sat"	"Evening"	"894"	8	9	4	21
11330	2013-01-26	"Sat"	"Midday"	"183"	1	8	3	12
11329	2013-01-25	"Fri"	"Evening"	"890"	8	9	0	17
11328	2013-01-25	"Fri"	"Midday"	"937"	9	3	7	19
11327	2013-01-24	"Thu"	"Evening"	"278"	2	7	8	17
11326	2013-01-24	"Thu"	"Midday"	"431"	4	3	1	8
11325	2013-01-23	"Wed"	"Evening"	"269"	2	6	9	17
11324	2013-01-23	"Wed"	"Midday"	"550"	5	5	0	10
11323	2013-01-22	"Tue"	"Evening"	"810"	8	1	0	9
11322	2013-01-22	"Tue"	"Midday"	"121"	1	2	1	4
11321	2013-01-21	"Mon"	"Evening"	"772"	7	7	2	16
11320	2013-01-21	"Mon"	"Midday"	"604"	6	0	4	10
11319	2013-01-20	"Sun"	"Evening"	"941"	9	4	1	14
11318	2013-01-20	"Sun"	"Midday"	"880"	8	8	0	16
11317	2013-01-19	"Sat"	"Evening"	"574"	5	7	4	16
11316	2013-01-19	"Sat"	"Midday"	"586"	5	8	6	19
11315	2013-01-18	"Fri"	"Evening"	"797"	7	9	7	23
11314	2013-01-18	"Fri"	"Midday"	"338"	3	3	8	14
11313	2013-01-17	"Thu"	"Evening"	"631"	6	3	1	10
11312	2013-01-17	"Thu"	"Midday"	"680"	6	8	0	14
11311	2013-01-16	"Wed"	"Evening"	"386"	3	8	6	17
11310	2013-01-16	"Wed"	"Midday"	"043"	0	4	3	7
11309	2013-01-15	"Tue"	"Evening"	"932"	9	3	2	14
11308	2013-01-15	"Tue"	"Midday"	"866"	8	6	6	20
11307	2013-01-14	"Mon"	"Evening"	"422"	4	2	2	8
11306	2013-01-14	"Mon"	"Midday"	"027"	0	2	7	9
11305	2013-01-13	"Sun"	"Evening"	"956"	9	5	6	20
11304	2013-01-13	"Sun"	"Midday"	"361"	3	6	1	10
11303	2013-01-12	"Sat"	"Evening"	"285"	2	8	5	15
11302	2013-01-12	"Sat"	"Midday"	"210"	2	1	0	3
11301	2013-01-11	"Fri"	"Evening"	"391"	3	9	1	13
11300	2013-01-11	"Fri"	"Midday"	"170"	1	7	0	8
11299	2013-01-10	"Thu"	"Evening"	"156"	1	5	6	12
11298	2013-01-10	"Thu"	"Midday"	"436"	4	3	6	13
11297	2013-01-09	"Wed"	"Evening"	"597"	5	9	7	21
11296	2013-01-09	"Wed"	"Midday"	"156"	1	5	6	12
11295	2013-01-08	"Tue"	"Evening"	"669"	6	6	9	21
11294	2013-01-08	"Tue"	"Midday"	"577"	5	7	7	19
11293	2013-01-07	"Mon"	"Evening"	"753"	7	5	3	15
11292	2013-01-07	"Mon"	"Midday"	"235"	2	3	5	10
11291	2013-01-06	"Sun"	"Evening"	"531"	5	3	1	9
11290	2013-01-06	"Sun"	"Midday"	"964"	9	6	4	19
11289	2013-01-05	"Sat"	"Evening"	"849"	8	4	9	21
11288	2013-01-05	"Sat"	"Midday"	"984"	9	8	4	21
11287	2013-01-04	"Fri"	"Evening"	"347"	3	4	7	14
11286	2013-01-04	"Fri"	"Midday"	"393"	3	9	3	15
11285	2013-01-03	"Thu"	"Evening"	"449"	4	4	9	17
11284	2013-01-03	"Thu"	"Midday"	"850"	8	5	0	13
11283	2013-01-02	"Wed"	"Evening"	"453"	4	5	3	12
11282	2013-01-02	"Wed"	"Midday"	"190"	1	9	0	10
11281	2013-01-01	"Tue"	"Evening"	"762"	7	6	2	15
11280	2013-01-01	"Tue"	"Midday"	"711"	7	1	1	9
11279	2012-12-31	"Mon"	"Evening"	"535"	5	3	5	13
11278	2012-12-31	"Mon"	"Midday"	"855"	8	5	5	18
11277	2012-12-30	"Sun"	"Evening"	"547"	5	4	7	16
11276	2012-12-30	"Sun"	"Midday"	"063"	0	6	3	9
11275	2012-12-29	"Sat"	"Evening"	"781"	7	8	1	16
11274	2012-12-29	"Sat"	"Midday"	"779"	7	7	9	23
11273	2012-12-28	"Fri"	"Evening"	"913"	9	1	3	13
11272	2012-12-28	"Fri"	"Midday"	"237"	2	3	7	12
11271	2012-12-27	"Thu"	"Evening"	"144"	1	4	4	9
11270	2012-12-27	"Thu"	"Midday"	"790"	7	9	0	16
11269	2012-12-26	"Wed"	"Evening"	"899"	8	9	9	26
11268	2012-12-26	"Wed"	"Midday"	"959"	9	5	9	23
11267	2012-12-25	"Tue"	"Evening"	"704"	7	0	4	11
11266	2012-12-25	"Tue"	"Midday"	"758"	7	5	8	20
11265	2012-12-24	"Mon"	"Evening"	"452"	4	5	2	11
11264	2012-12-24	"Mon"	"Midday"	"993"	9	9	3	21
11263	2012-12-23	"Sun"	"Evening"	"842"	8	4	2	14
11262	2012-12-23	"Sun"	"Midday"	"941"	9	4	1	14
11261	2012-12-22	"Sat"	"Evening"	"433"	4	3	3	10
11260	2012-12-22	"Sat"	"Midday"	"737"	7	3	7	17
11259	2012-12-21	"Fri"	"Evening"	"996"	9	9	6	24
11258	2012-12-21	"Fri"	"Midday"	"751"	7	5	1	13
11257	2012-12-20	"Thu"	"Evening"	"460"	4	6	0	10
11256	2012-12-20	"Thu"	"Midday"	"025"	0	2	5	7
11255	2012-12-19	"Wed"	"Evening"	"919"	9	1	9	19
11254	2012-12-19	"Wed"	"Midday"	"895"	8	9	5	22
11253	2012-12-18	"Tue"	"Evening"	"259"	2	5	9	16
11252	2012-12-18	"Tue"	"Midday"	"377"	3	7	7	17
11251	2012-12-17	"Mon"	"Evening"	"239"	2	3	9	14
11250	2012-12-17	"Mon"	"Midday"	"375"	3	7	5	15
11249	2012-12-16	"Sun"	"Evening"	"947"	9	4	7	20
11248	2012-12-16	"Sun"	"Midday"	"096"	0	9	6	15
11247	2012-12-15	"Sat"	"Evening"	"138"	1	3	8	12
11246	2012-12-15	"Sat"	"Midday"	"037"	0	3	7	10
11245	2012-12-14	"Fri"	"Evening"	"370"	3	7	0	10
11244	2012-12-14	"Fri"	"Midday"	"472"	4	7	2	13
11243	2012-12-13	"Thu"	"Evening"	"170"	1	7	0	8
11242	2012-12-13	"Thu"	"Midday"	"189"	1	8	9	18
11241	2012-12-12	"Wed"	"Evening"	"077"	0	7	7	14
11240	2012-12-12	"Wed"	"Midday"	"044"	0	4	4	8
11239	2012-12-11	"Tue"	"Evening"	"110"	1	1	0	2
11238	2012-12-11	"Tue"	"Midday"	"247"	2	4	7	13
11237	2012-12-10	"Mon"	"Evening"	"148"	1	4	8	13
11236	2012-12-10	"Mon"	"Midday"	"977"	9	7	7	23
11235	2012-12-09	"Sun"	"Evening"	"879"	8	7	9	24
11234	2012-12-09	"Sun"	"Midday"	"536"	5	3	6	14
11233	2012-12-08	"Sat"	"Evening"	"424"	4	2	4	10
11232	2012-12-08	"Sat"	"Midday"	"059"	0	5	9	14
11231	2012-12-07	"Fri"	"Evening"	"671"	6	7	1	14
11230	2012-12-07	"Fri"	"Midday"	"755"	7	5	5	17
11229	2012-12-06	"Thu"	"Evening"	"684"	6	8	4	18
11228	2012-12-06	"Thu"	"Midday"	"998"	9	9	8	26
11227	2012-12-05	"Wed"	"Evening"	"424"	4	2	4	10
11226	2012-12-05	"Wed"	"Midday"	"891"	8	9	1	18
11225	2012-12-04	"Tue"	"Evening"	"087"	0	8	7	15
11224	2012-12-04	"Tue"	"Midday"	"630"	6	3	0	9
11223	2012-12-03	"Mon"	"Evening"	"473"	4	7	3	14
11222	2012-12-03	"Mon"	"Midday"	"384"	3	8	4	15
11221	2012-12-02	"Sun"	"Evening"	"823"	8	2	3	13
11220	2012-12-02	"Sun"	"Midday"	"773"	7	7	3	17
11219	2012-12-01	"Sat"	"Evening"	"079"	0	7	9	16
11218	2012-12-01	"Sat"	"Midday"	"382"	3	8	2	13
11217	2012-11-30	"Fri"	"Evening"	"342"	3	4	2	9
11216	2012-11-30	"Fri"	"Midday"	"454"	4	5	4	13
11215	2012-11-29	"Thu"	"Evening"	"007"	0	0	7	7
11214	2012-11-29	"Thu"	"Midday"	"671"	6	7	1	14
11213	2012-11-28	"Wed"	"Evening"	"428"	4	2	8	14
11212	2012-11-28	"Wed"	"Midday"	"611"	6	1	1	8
11211	2012-11-27	"Tue"	"Evening"	"320"	3	2	0	5
11210	2012-11-27	"Tue"	"Midday"	"304"	3	0	4	7
11209	2012-11-26	"Mon"	"Evening"	"056"	0	5	6	11
11208	2012-11-26	"Mon"	"Midday"	"963"	9	6	3	18
11207	2012-11-25	"Sun"	"Evening"	"327"	3	2	7	12
11206	2012-11-25	"Sun"	"Midday"	"766"	7	6	6	19
11205	2012-11-24	"Sat"	"Evening"	"587"	5	8	7	20
11204	2012-11-24	"Sat"	"Midday"	"377"	3	7	7	17
11203	2012-11-23	"Fri"	"Evening"	"822"	8	2	2	12
11202	2012-11-23	"Fri"	"Midday"	"217"	2	1	7	10
11201	2012-11-22	"Thu"	"Evening"	"924"	9	2	4	15
11200	2012-11-22	"Thu"	"Midday"	"839"	8	3	9	20
11199	2012-11-21	"Wed"	"Evening"	"080"	0	8	0	8
11198	2012-11-21	"Wed"	"Midday"	"540"	5	4	0	9
11197	2012-11-20	"Tue"	"Evening"	"758"	7	5	8	20
11196	2012-11-20	"Tue"	"Midday"	"937"	9	3	7	19
11195	2012-11-19	"Mon"	"Evening"	"732"	7	3	2	12
11194	2012-11-19	"Mon"	"Midday"	"008"	0	0	8	8
11193	2012-11-18	"Sun"	"Evening"	"487"	4	8	7	19
11192	2012-11-18	"Sun"	"Midday"	"052"	0	5	2	7
11191	2012-11-17	"Sat"	"Evening"	"937"	9	3	7	19
11190	2012-11-17	"Sat"	"Midday"	"119"	1	1	9	11
11189	2012-11-16	"Fri"	"Evening"	"088"	0	8	8	16
11188	2012-11-16	"Fri"	"Midday"	"145"	1	4	5	10
11187	2012-11-15	"Thu"	"Evening"	"628"	6	2	8	16
11186	2012-11-15	"Thu"	"Midday"	"399"	3	9	9	21
11185	2012-11-14	"Wed"	"Evening"	"373"	3	7	3	13
11184	2012-11-14	"Wed"	"Midday"	"468"	4	6	8	18
11183	2012-11-13	"Tue"	"Evening"	"835"	8	3	5	16
11182	2012-11-13	"Tue"	"Midday"	"258"	2	5	8	15
11181	2012-11-12	"Mon"	"Evening"	"750"	7	5	0	12
11180	2012-11-12	"Mon"	"Midday"	"015"	0	1	5	6
11179	2012-11-11	"Sun"	"Evening"	"580"	5	8	0	13
11178	2012-11-11	"Sun"	"Midday"	"824"	8	2	4	14
11177	2012-11-10	"Sat"	"Evening"	"339"	3	3	9	15
11176	2012-11-10	"Sat"	"Midday"	"990"	9	9	0	18
11175	2012-11-09	"Fri"	"Evening"	"300"	3	0	0	3
11174	2012-11-09	"Fri"	"Midday"	"562"	5	6	2	13
11173	2012-11-08	"Thu"	"Evening"	"859"	8	5	9	22
11172	2012-11-08	"Thu"	"Midday"	"275"	2	7	5	14
11171	2012-11-07	"Wed"	"Evening"	"070"	0	7	0	7
11170	2012-11-07	"Wed"	"Midday"	"296"	2	9	6	17
11169	2012-11-06	"Tue"	"Evening"	"117"	1	1	7	9
11168	2012-11-06	"Tue"	"Midday"	"752"	7	5	2	14
11167	2012-11-05	"Mon"	"Evening"	"096"	0	9	6	15
11166	2012-11-05	"Mon"	"Midday"	"375"	3	7	5	15
11165	2012-11-04	"Sun"	"Evening"	"556"	5	5	6	16
11164	2012-11-04	"Sun"	"Midday"	"995"	9	9	5	23
11163	2012-11-03	"Sat"	"Evening"	"347"	3	4	7	14
11162	2012-11-03	"Sat"	"Midday"	"617"	6	1	7	14
11161	2012-11-02	"Fri"	"Evening"	"105"	1	0	5	6
11160	2012-11-02	"Fri"	"Midday"	"551"	5	5	1	11
11159	2012-11-01	"Thu"	"Evening"	"662"	6	6	2	14
11158	2012-11-01	"Thu"	"Midday"	"024"	0	2	4	6
11157	2012-10-31	"Wed"	"Evening"	"466"	4	6	6	16
11156	2012-10-31	"Wed"	"Midday"	"241"	2	4	1	7
11155	2012-10-30	"Tue"	"Evening"	"098"	0	9	8	17
11154	2012-10-30	"Tue"	"Midday"	"025"	0	2	5	7
11153	2012-10-29	"Mon"	"Evening"	"956"	9	5	6	20
11152	2012-10-29	"Mon"	"Midday"	"857"	8	5	7	20
11151	2012-10-28	"Sun"	"Evening"	"012"	0	1	2	3
11150	2012-10-28	"Sun"	"Midday"	"216"	2	1	6	9
11149	2012-10-27	"Sat"	"Evening"	"293"	2	9	3	14
11148	2012-10-27	"Sat"	"Midday"	"641"	6	4	1	11
11147	2012-10-26	"Fri"	"Evening"	"940"	9	4	0	13
11146	2012-10-26	"Fri"	"Midday"	"989"	9	8	9	26
11145	2012-10-25	"Thu"	"Evening"	"728"	7	2	8	17
11144	2012-10-25	"Thu"	"Midday"	"207"	2	0	7	9
11143	2012-10-24	"Wed"	"Evening"	"135"	1	3	5	9
11142	2012-10-24	"Wed"	"Midday"	"838"	8	3	8	19
11141	2012-10-23	"Tue"	"Evening"	"378"	3	7	8	18
11140	2012-10-23	"Tue"	"Midday"	"871"	8	7	1	16
11139	2012-10-22	"Mon"	"Evening"	"832"	8	3	2	13
11138	2012-10-22	"Mon"	"Midday"	"748"	7	4	8	19
11137	2012-10-21	"Sun"	"Evening"	"393"	3	9	3	15
11136	2012-10-21	"Sun"	"Midday"	"397"	3	9	7	19
11135	2012-10-20	"Sat"	"Evening"	"038"	0	3	8	11
11134	2012-10-20	"Sat"	"Midday"	"704"	7	0	4	11
11133	2012-10-19	"Fri"	"Evening"	"100"	1	0	0	1
11132	2012-10-19	"Fri"	"Midday"	"964"	9	6	4	19
11131	2012-10-18	"Thu"	"Evening"	"197"	1	9	7	17
11130	2012-10-18	"Thu"	"Midday"	"388"	3	8	8	19
11129	2012-10-17	"Wed"	"Evening"	"344"	3	4	4	11
11128	2012-10-17	"Wed"	"Midday"	"182"	1	8	2	11
11127	2012-10-16	"Tue"	"Evening"	"915"	9	1	5	15
11126	2012-10-16	"Tue"	"Midday"	"647"	6	4	7	17
11125	2012-10-15	"Mon"	"Evening"	"307"	3	0	7	10
11124	2012-10-15	"Mon"	"Midday"	"165"	1	6	5	12
11123	2012-10-14	"Sun"	"Evening"	"075"	0	7	5	12
11122	2012-10-14	"Sun"	"Midday"	"236"	2	3	6	11
11121	2012-10-13	"Sat"	"Evening"	"981"	9	8	1	18
11120	2012-10-13	"Sat"	"Midday"	"521"	5	2	1	8
11119	2012-10-12	"Fri"	"Evening"	"094"	0	9	4	13
11118	2012-10-12	"Fri"	"Midday"	"762"	7	6	2	15
11117	2012-10-11	"Thu"	"Evening"	"292"	2	9	2	13
11116	2012-10-11	"Thu"	"Midday"	"395"	3	9	5	17
11115	2012-10-10	"Wed"	"Evening"	"111"	1	1	1	3
11114	2012-10-10	"Wed"	"Midday"	"251"	2	5	1	8
11113	2012-10-09	"Tue"	"Evening"	"357"	3	5	7	15
11112	2012-10-09	"Tue"	"Midday"	"988"	9	8	8	25
11111	2012-10-08	"Mon"	"Evening"	"388"	3	8	8	19
11110	2012-10-08	"Mon"	"Midday"	"561"	5	6	1	12
11109	2012-10-07	"Sun"	"Evening"	"953"	9	5	3	17
11108	2012-10-07	"Sun"	"Midday"	"647"	6	4	7	17
11107	2012-10-06	"Sat"	"Evening"	"016"	0	1	6	7
11106	2012-10-06	"Sat"	"Midday"	"154"	1	5	4	10
11105	2012-10-05	"Fri"	"Evening"	"064"	0	6	4	10
11104	2012-10-05	"Fri"	"Midday"	"934"	9	3	4	16
11103	2012-10-04	"Thu"	"Evening"	"878"	8	7	8	23
11102	2012-10-04	"Thu"	"Midday"	"961"	9	6	1	16
11101	2012-10-03	"Wed"	"Evening"	"209"	2	0	9	11
11100	2012-10-03	"Wed"	"Midday"	"832"	8	3	2	13
11099	2012-10-02	"Tue"	"Evening"	"243"	2	4	3	9
11098	2012-10-02	"Tue"	"Midday"	"143"	1	4	3	8
11097	2012-10-01	"Mon"	"Evening"	"444"	4	4	4	12
11096	2012-10-01	"Mon"	"Midday"	"859"	8	5	9	22
11095	2012-09-30	"Sun"	"Evening"	"300"	3	0	0	3
11094	2012-09-30	"Sun"	"Midday"	"378"	3	7	8	18
11093	2012-09-29	"Sat"	"Evening"	"017"	0	1	7	8
11092	2012-09-29	"Sat"	"Midday"	"731"	7	3	1	11
11091	2012-09-28	"Fri"	"Evening"	"406"	4	0	6	10
11090	2012-09-28	"Fri"	"Midday"	"620"	6	2	0	8
11089	2012-09-27	"Thu"	"Evening"	"584"	5	8	4	17
11088	2012-09-27	"Thu"	"Midday"	"855"	8	5	5	18
11087	2012-09-26	"Wed"	"Evening"	"170"	1	7	0	8
11086	2012-09-26	"Wed"	"Midday"	"146"	1	4	6	11
11085	2012-09-25	"Tue"	"Evening"	"103"	1	0	3	4
11084	2012-09-25	"Tue"	"Midday"	"601"	6	0	1	7
11083	2012-09-24	"Mon"	"Evening"	"313"	3	1	3	7
11082	2012-09-24	"Mon"	"Midday"	"085"	0	8	5	13
11081	2012-09-23	"Sun"	"Evening"	"727"	7	2	7	16
11080	2012-09-23	"Sun"	"Midday"	"073"	0	7	3	10
11079	2012-09-22	"Sat"	"Evening"	"083"	0	8	3	11
11078	2012-09-22	"Sat"	"Midday"	"497"	4	9	7	20
11077	2012-09-21	"Fri"	"Evening"	"240"	2	4	0	6
11076	2012-09-21	"Fri"	"Midday"	"220"	2	2	0	4
11075	2012-09-20	"Thu"	"Evening"	"736"	7	3	6	16
11074	2012-09-20	"Thu"	"Midday"	"980"	9	8	0	17
11073	2012-09-19	"Wed"	"Evening"	"585"	5	8	5	18
11072	2012-09-19	"Wed"	"Midday"	"928"	9	2	8	19
11071	2012-09-18	"Tue"	"Evening"	"297"	2	9	7	18
11070	2012-09-18	"Tue"	"Midday"	"228"	2	2	8	12
11069	2012-09-17	"Mon"	"Evening"	"149"	1	4	9	14
11068	2012-09-17	"Mon"	"Midday"	"092"	0	9	2	11
11067	2012-09-16	"Sun"	"Evening"	"511"	5	1	1	7
11066	2012-09-16	"Sun"	"Midday"	"461"	4	6	1	11
11065	2012-09-15	"Sat"	"Evening"	"224"	2	2	4	8
11064	2012-09-15	"Sat"	"Midday"	"429"	4	2	9	15
11063	2012-09-14	"Fri"	"Evening"	"738"	7	3	8	18
11062	2012-09-14	"Fri"	"Midday"	"375"	3	7	5	15
11061	2012-09-13	"Thu"	"Evening"	"532"	5	3	2	10
11060	2012-09-13	"Thu"	"Midday"	"123"	1	2	3	6
11059	2012-09-12	"Wed"	"Evening"	"822"	8	2	2	12
11058	2012-09-12	"Wed"	"Midday"	"357"	3	5	7	15
11057	2012-09-11	"Tue"	"Evening"	"545"	5	4	5	14
11056	2012-09-11	"Tue"	"Midday"	"908"	9	0	8	17
11055	2012-09-10	"Mon"	"Evening"	"692"	6	9	2	17
11054	2012-09-10	"Mon"	"Midday"	"780"	7	8	0	15
11053	2012-09-09	"Sun"	"Evening"	"192"	1	9	2	12
11052	2012-09-09	"Sun"	"Midday"	"131"	1	3	1	5
11051	2012-09-08	"Sat"	"Evening"	"758"	7	5	8	20
11050	2012-09-08	"Sat"	"Midday"	"683"	6	8	3	17
11049	2012-09-07	"Fri"	"Evening"	"403"	4	0	3	7
11048	2012-09-07	"Fri"	"Midday"	"384"	3	8	4	15
11047	2012-09-06	"Thu"	"Evening"	"720"	7	2	0	9
11046	2012-09-06	"Thu"	"Midday"	"463"	4	6	3	13
11045	2012-09-05	"Wed"	"Evening"	"388"	3	8	8	19
11044	2012-09-05	"Wed"	"Midday"	"112"	1	1	2	4
11043	2012-09-04	"Tue"	"Evening"	"530"	5	3	0	8
11042	2012-09-04	"Tue"	"Midday"	"347"	3	4	7	14
11041	2012-09-03	"Mon"	"Evening"	"754"	7	5	4	16
11040	2012-09-03	"Mon"	"Midday"	"024"	0	2	4	6
11039	2012-09-02	"Sun"	"Evening"	"981"	9	8	1	18
11038	2012-09-02	"Sun"	"Midday"	"279"	2	7	9	18
11037	2012-09-01	"Sat"	"Evening"	"806"	8	0	6	14
11036	2012-09-01	"Sat"	"Midday"	"906"	9	0	6	15
11035	2012-08-31	"Fri"	"Evening"	"740"	7	4	0	11
11034	2012-08-31	"Fri"	"Midday"	"382"	3	8	2	13
11033	2012-08-30	"Thu"	"Evening"	"005"	0	0	5	5
11032	2012-08-30	"Thu"	"Midday"	"359"	3	5	9	17
11031	2012-08-29	"Wed"	"Evening"	"386"	3	8	6	17
11030	2012-08-29	"Wed"	"Midday"	"664"	6	6	4	16
11029	2012-08-28	"Tue"	"Evening"	"554"	5	5	4	14
11028	2012-08-28	"Tue"	"Midday"	"949"	9	4	9	22
11027	2012-08-27	"Mon"	"Evening"	"012"	0	1	2	3
11026	2012-08-27	"Mon"	"Midday"	"640"	6	4	0	10
11025	2012-08-26	"Sun"	"Evening"	"759"	7	5	9	21
11024	2012-08-26	"Sun"	"Midday"	"453"	4	5	3	12
11023	2012-08-25	"Sat"	"Evening"	"480"	4	8	0	12
11022	2012-08-25	"Sat"	"Midday"	"471"	4	7	1	12
11021	2012-08-24	"Fri"	"Evening"	"204"	2	0	4	6
11020	2012-08-24	"Fri"	"Midday"	"858"	8	5	8	21
11019	2012-08-23	"Thu"	"Evening"	"579"	5	7	9	21
11018	2012-08-23	"Thu"	"Midday"	"579"	5	7	9	21
11017	2012-08-22	"Wed"	"Evening"	"141"	1	4	1	6
11016	2012-08-22	"Wed"	"Midday"	"740"	7	4	0	11
11015	2012-08-21	"Tue"	"Evening"	"244"	2	4	4	10
11014	2012-08-21	"Tue"	"Midday"	"849"	8	4	9	21
11013	2012-08-20	"Mon"	"Evening"	"915"	9	1	5	15
11012	2012-08-20	"Mon"	"Midday"	"163"	1	6	3	10
11011	2012-08-19	"Sun"	"Evening"	"949"	9	4	9	22
11010	2012-08-19	"Sun"	"Midday"	"906"	9	0	6	15
11009	2012-08-18	"Sat"	"Evening"	"489"	4	8	9	21
11008	2012-08-18	"Sat"	"Midday"	"941"	9	4	1	14
11007	2012-08-17	"Fri"	"Evening"	"794"	7	9	4	20
11006	2012-08-17	"Fri"	"Midday"	"384"	3	8	4	15
11005	2012-08-16	"Thu"	"Evening"	"768"	7	6	8	21
11004	2012-08-16	"Thu"	"Midday"	"625"	6	2	5	13
11003	2012-08-15	"Wed"	"Evening"	"248"	2	4	8	14
11002	2012-08-15	"Wed"	"Midday"	"831"	8	3	1	12
11001	2012-08-14	"Tue"	"Evening"	"955"	9	5	5	19
11000	2012-08-14	"Tue"	"Midday"	"409"	4	0	9	13
10999	2012-08-13	"Mon"	"Evening"	"669"	6	6	9	21
10998	2012-08-13	"Mon"	"Midday"	"242"	2	4	2	8
10997	2012-08-12	"Sun"	"Evening"	"486"	4	8	6	18
10996	2012-08-12	"Sun"	"Midday"	"848"	8	4	8	20
10995	2012-08-11	"Sat"	"Evening"	"914"	9	1	4	14
10994	2012-08-11	"Sat"	"Midday"	"864"	8	6	4	18
10993	2012-08-10	"Fri"	"Evening"	"286"	2	8	6	16
10992	2012-08-10	"Fri"	"Midday"	"470"	4	7	0	11
10991	2012-08-09	"Thu"	"Evening"	"694"	6	9	4	19
10990	2012-08-09	"Thu"	"Midday"	"665"	6	6	5	17
10989	2012-08-08	"Wed"	"Evening"	"175"	1	7	5	13
10988	2012-08-08	"Wed"	"Midday"	"029"	0	2	9	11
10987	2012-08-07	"Tue"	"Evening"	"993"	9	9	3	21
10986	2012-08-07	"Tue"	"Midday"	"085"	0	8	5	13
10985	2012-08-06	"Mon"	"Evening"	"911"	9	1	1	11
10984	2012-08-06	"Mon"	"Midday"	"463"	4	6	3	13
10983	2012-08-05	"Sun"	"Evening"	"028"	0	2	8	10
10982	2012-08-05	"Sun"	"Midday"	"649"	6	4	9	19
10981	2012-08-04	"Sat"	"Evening"	"681"	6	8	1	15
10980	2012-08-04	"Sat"	"Midday"	"802"	8	0	2	10
10979	2012-08-03	"Fri"	"Evening"	"808"	8	0	8	16
10978	2012-08-03	"Fri"	"Midday"	"383"	3	8	3	14
10977	2012-08-02	"Thu"	"Evening"	"277"	2	7	7	16
10976	2012-08-02	"Thu"	"Midday"	"848"	8	4	8	20
10975	2012-08-01	"Wed"	"Evening"	"416"	4	1	6	11
10974	2012-08-01	"Wed"	"Midday"	"887"	8	8	7	23
10973	2012-07-31	"Tue"	"Evening"	"221"	2	2	1	5
10972	2012-07-31	"Tue"	"Midday"	"096"	0	9	6	15
10971	2012-07-30	"Mon"	"Evening"	"772"	7	7	2	16
10970	2012-07-30	"Mon"	"Midday"	"519"	5	1	9	15
10969	2012-07-29	"Sun"	"Evening"	"872"	8	7	2	17
10968	2012-07-29	"Sun"	"Midday"	"444"	4	4	4	12
10967	2012-07-28	"Sat"	"Evening"	"729"	7	2	9	18
10966	2012-07-28	"Sat"	"Midday"	"334"	3	3	4	10
10965	2012-07-27	"Fri"	"Evening"	"773"	7	7	3	17
10964	2012-07-27	"Fri"	"Midday"	"349"	3	4	9	16
10963	2012-07-26	"Thu"	"Evening"	"154"	1	5	4	10
10962	2012-07-26	"Thu"	"Midday"	"073"	0	7	3	10
10961	2012-07-25	"Wed"	"Evening"	"474"	4	7	4	15
10960	2012-07-25	"Wed"	"Midday"	"032"	0	3	2	5
10959	2012-07-24	"Tue"	"Evening"	"374"	3	7	4	14
10958	2012-07-24	"Tue"	"Midday"	"982"	9	8	2	19
10957	2012-07-23	"Mon"	"Evening"	"821"	8	2	1	11
10956	2012-07-23	"Mon"	"Midday"	"023"	0	2	3	5
10955	2012-07-22	"Sun"	"Evening"	"097"	0	9	7	16
10954	2012-07-22	"Sun"	"Midday"	"712"	7	1	2	10
10953	2012-07-21	"Sat"	"Evening"	"461"	4	6	1	11
10952	2012-07-21	"Sat"	"Midday"	"815"	8	1	5	14
10951	2012-07-20	"Fri"	"Evening"	"877"	8	7	7	22
10950	2012-07-20	"Fri"	"Midday"	"866"	8	6	6	20
10949	2012-07-19	"Thu"	"Evening"	"276"	2	7	6	15
10948	2012-07-19	"Thu"	"Midday"	"607"	6	0	7	13
10947	2012-07-18	"Wed"	"Evening"	"236"	2	3	6	11
10946	2012-07-18	"Wed"	"Midday"	"839"	8	3	9	20
10945	2012-07-17	"Tue"	"Evening"	"744"	7	4	4	15
10944	2012-07-17	"Tue"	"Midday"	"631"	6	3	1	10
10943	2012-07-16	"Mon"	"Evening"	"444"	4	4	4	12
10942	2012-07-16	"Mon"	"Midday"	"396"	3	9	6	18
10941	2012-07-15	"Sun"	"Evening"	"671"	6	7	1	14
10940	2012-07-15	"Sun"	"Midday"	"661"	6	6	1	13
10939	2012-07-14	"Sat"	"Evening"	"510"	5	1	0	6
10938	2012-07-14	"Sat"	"Midday"	"830"	8	3	0	11
10937	2012-07-13	"Fri"	"Evening"	"134"	1	3	4	8
10936	2012-07-13	"Fri"	"Midday"	"510"	5	1	0	6
10935	2012-07-12	"Thu"	"Evening"	"917"	9	1	7	17
10934	2012-07-12	"Thu"	"Midday"	"053"	0	5	3	8
10933	2012-07-11	"Wed"	"Evening"	"460"	4	6	0	10
10932	2012-07-11	"Wed"	"Midday"	"148"	1	4	8	13
10931	2012-07-10	"Tue"	"Evening"	"527"	5	2	7	14
10930	2012-07-10	"Tue"	"Midday"	"171"	1	7	1	9
10929	2012-07-09	"Mon"	"Evening"	"151"	1	5	1	7
10928	2012-07-09	"Mon"	"Midday"	"052"	0	5	2	7
10927	2012-07-08	"Sun"	"Evening"	"932"	9	3	2	14
10926	2012-07-08	"Sun"	"Midday"	"996"	9	9	6	24
10925	2012-07-07	"Sat"	"Evening"	"107"	1	0	7	8
10924	2012-07-07	"Sat"	"Midday"	"343"	3	4	3	10
10923	2012-07-06	"Fri"	"Evening"	"309"	3	0	9	12
10922	2012-07-06	"Fri"	"Midday"	"936"	9	3	6	18
10921	2012-07-05	"Thu"	"Evening"	"840"	8	4	0	12
10920	2012-07-05	"Thu"	"Midday"	"006"	0	0	6	6
10919	2012-07-04	"Wed"	"Evening"	"627"	6	2	7	15
10918	2012-07-04	"Wed"	"Midday"	"014"	0	1	4	5
10917	2012-07-03	"Tue"	"Evening"	"715"	7	1	5	13
10916	2012-07-03	"Tue"	"Midday"	"476"	4	7	6	17
10915	2012-07-02	"Mon"	"Evening"	"845"	8	4	5	17
10914	2012-07-02	"Mon"	"Midday"	"474"	4	7	4	15
10913	2012-07-01	"Sun"	"Evening"	"075"	0	7	5	12
10912	2012-07-01	"Sun"	"Midday"	"713"	7	1	3	11
10911	2012-06-30	"Sat"	"Evening"	"130"	1	3	0	4
10910	2012-06-30	"Sat"	"Midday"	"036"	0	3	6	9
10909	2012-06-29	"Fri"	"Evening"	"849"	8	4	9	21
10908	2012-06-29	"Fri"	"Midday"	"477"	4	7	7	18
10907	2012-06-28	"Thu"	"Evening"	"644"	6	4	4	14
10906	2012-06-28	"Thu"	"Midday"	"575"	5	7	5	17
10905	2012-06-27	"Wed"	"Evening"	"001"	0	0	1	1
10904	2012-06-27	"Wed"	"Midday"	"210"	2	1	0	3
10903	2012-06-26	"Tue"	"Evening"	"662"	6	6	2	14
10902	2012-06-26	"Tue"	"Midday"	"833"	8	3	3	14
10901	2012-06-25	"Mon"	"Evening"	"912"	9	1	2	12
10900	2012-06-25	"Mon"	"Midday"	"294"	2	9	4	15
10899	2012-06-24	"Sun"	"Evening"	"498"	4	9	8	21
10898	2012-06-24	"Sun"	"Midday"	"410"	4	1	0	5
10897	2012-06-23	"Sat"	"Evening"	"556"	5	5	6	16
10896	2012-06-23	"Sat"	"Midday"	"518"	5	1	8	14
10895	2012-06-22	"Fri"	"Evening"	"197"	1	9	7	17
10894	2012-06-22	"Fri"	"Midday"	"657"	6	5	7	18
10893	2012-06-21	"Thu"	"Evening"	"052"	0	5	2	7
10892	2012-06-21	"Thu"	"Midday"	"402"	4	0	2	6
10891	2012-06-20	"Wed"	"Evening"	"212"	2	1	2	5
10890	2012-06-20	"Wed"	"Midday"	"618"	6	1	8	15
10889	2012-06-19	"Tue"	"Evening"	"969"	9	6	9	24
10888	2012-06-19	"Tue"	"Midday"	"691"	6	9	1	16
10887	2012-06-18	"Mon"	"Evening"	"115"	1	1	5	7
10886	2012-06-18	"Mon"	"Midday"	"902"	9	0	2	11
10885	2012-06-17	"Sun"	"Evening"	"860"	8	6	0	14
10884	2012-06-17	"Sun"	"Midday"	"032"	0	3	2	5
10883	2012-06-16	"Sat"	"Evening"	"389"	3	8	9	20
10882	2012-06-16	"Sat"	"Midday"	"840"	8	4	0	12
10881	2012-06-15	"Fri"	"Evening"	"259"	2	5	9	16
10880	2012-06-15	"Fri"	"Midday"	"395"	3	9	5	17
10879	2012-06-14	"Thu"	"Evening"	"266"	2	6	6	14
10878	2012-06-14	"Thu"	"Midday"	"780"	7	8	0	15
10877	2012-06-13	"Wed"	"Evening"	"867"	8	6	7	21
10876	2012-06-13	"Wed"	"Midday"	"184"	1	8	4	13
10875	2012-06-12	"Tue"	"Evening"	"809"	8	0	9	17
10874	2012-06-12	"Tue"	"Midday"	"406"	4	0	6	10
10873	2012-06-11	"Mon"	"Evening"	"455"	4	5	5	14
10872	2012-06-11	"Mon"	"Midday"	"542"	5	4	2	11
10871	2012-06-10	"Sun"	"Evening"	"026"	0	2	6	8
10870	2012-06-10	"Sun"	"Midday"	"666"	6	6	6	18
10869	2012-06-09	"Sat"	"Evening"	"263"	2	6	3	11
10868	2012-06-09	"Sat"	"Midday"	"637"	6	3	7	16
10867	2012-06-08	"Fri"	"Evening"	"930"	9	3	0	12
10866	2012-06-08	"Fri"	"Midday"	"699"	6	9	9	24
10865	2012-06-07	"Thu"	"Evening"	"583"	5	8	3	16
10864	2012-06-07	"Thu"	"Midday"	"249"	2	4	9	15
10863	2012-06-06	"Wed"	"Evening"	"873"	8	7	3	18
10862	2012-06-06	"Wed"	"Midday"	"426"	4	2	6	12
10861	2012-06-05	"Tue"	"Evening"	"994"	9	9	4	22
10860	2012-06-05	"Tue"	"Midday"	"358"	3	5	8	16
10859	2012-06-04	"Mon"	"Evening"	"942"	9	4	2	15
10858	2012-06-04	"Mon"	"Midday"	"555"	5	5	5	15
10857	2012-06-03	"Sun"	"Evening"	"854"	8	5	4	17
10856	2012-06-03	"Sun"	"Midday"	"937"	9	3	7	19
10855	2012-06-02	"Sat"	"Evening"	"715"	7	1	5	13
10854	2012-06-02	"Sat"	"Midday"	"881"	8	8	1	17
10853	2012-06-01	"Fri"	"Evening"	"943"	9	4	3	16
10852	2012-06-01	"Fri"	"Midday"	"392"	3	9	2	14
10851	2012-05-31	"Thu"	"Evening"	"123"	1	2	3	6
10850	2012-05-31	"Thu"	"Midday"	"573"	5	7	3	15
10849	2012-05-30	"Wed"	"Evening"	"006"	0	0	6	6
10848	2012-05-30	"Wed"	"Midday"	"067"	0	6	7	13
10847	2012-05-29	"Tue"	"Evening"	"368"	3	6	8	17
10846	2012-05-29	"Tue"	"Midday"	"089"	0	8	9	17
10845	2012-05-28	"Mon"	"Evening"	"304"	3	0	4	7
10844	2012-05-28	"Mon"	"Midday"	"789"	7	8	9	24
10843	2012-05-27	"Sun"	"Evening"	"369"	3	6	9	18
10842	2012-05-27	"Sun"	"Midday"	"835"	8	3	5	16
10841	2012-05-26	"Sat"	"Evening"	"593"	5	9	3	17
10840	2012-05-26	"Sat"	"Midday"	"332"	3	3	2	8
10839	2012-05-25	"Fri"	"Evening"	"107"	1	0	7	8
10838	2012-05-25	"Fri"	"Midday"	"469"	4	6	9	19
10837	2012-05-24	"Thu"	"Evening"	"490"	4	9	0	13
10836	2012-05-24	"Thu"	"Midday"	"186"	1	8	6	15
10835	2012-05-23	"Wed"	"Evening"	"448"	4	4	8	16
10834	2012-05-23	"Wed"	"Midday"	"118"	1	1	8	10
10833	2012-05-22	"Tue"	"Evening"	"478"	4	7	8	19
10832	2012-05-22	"Tue"	"Midday"	"502"	5	0	2	7
10831	2012-05-21	"Mon"	"Evening"	"038"	0	3	8	11
10830	2012-05-21	"Mon"	"Midday"	"367"	3	6	7	16
10829	2012-05-20	"Sun"	"Evening"	"101"	1	0	1	2
10828	2012-05-20	"Sun"	"Midday"	"854"	8	5	4	17
10827	2012-05-19	"Sat"	"Evening"	"478"	4	7	8	19
10826	2012-05-19	"Sat"	"Midday"	"251"	2	5	1	8
10825	2012-05-18	"Fri"	"Evening"	"060"	0	6	0	6
10824	2012-05-18	"Fri"	"Midday"	"955"	9	5	5	19
10823	2012-05-17	"Thu"	"Evening"	"125"	1	2	5	8
10822	2012-05-17	"Thu"	"Midday"	"725"	7	2	5	14
10821	2012-05-16	"Wed"	"Evening"	"617"	6	1	7	14
10820	2012-05-16	"Wed"	"Midday"	"384"	3	8	4	15
10819	2012-05-15	"Tue"	"Evening"	"798"	7	9	8	24
10818	2012-05-15	"Tue"	"Midday"	"314"	3	1	4	8
10817	2012-05-14	"Mon"	"Evening"	"571"	5	7	1	13
10816	2012-05-14	"Mon"	"Midday"	"480"	4	8	0	12
10815	2012-05-13	"Sun"	"Evening"	"087"	0	8	7	15
10814	2012-05-13	"Sun"	"Midday"	"309"	3	0	9	12
10813	2012-05-12	"Sat"	"Evening"	"435"	4	3	5	12
10812	2012-05-12	"Sat"	"Midday"	"648"	6	4	8	18
10811	2012-05-11	"Fri"	"Evening"	"077"	0	7	7	14
10810	2012-05-11	"Fri"	"Midday"	"520"	5	2	0	7
10809	2012-05-10	"Thu"	"Evening"	"514"	5	1	4	10
10808	2012-05-10	"Thu"	"Midday"	"105"	1	0	5	6
10807	2012-05-09	"Wed"	"Evening"	"317"	3	1	7	11
10806	2012-05-09	"Wed"	"Midday"	"201"	2	0	1	3
10805	2012-05-08	"Tue"	"Evening"	"002"	0	0	2	2
10804	2012-05-08	"Tue"	"Midday"	"730"	7	3	0	10
10803	2012-05-07	"Mon"	"Evening"	"745"	7	4	5	16
10802	2012-05-07	"Mon"	"Midday"	"791"	7	9	1	17
10801	2012-05-06	"Sun"	"Evening"	"484"	4	8	4	16
10800	2012-05-06	"Sun"	"Midday"	"215"	2	1	5	8
10799	2012-05-05	"Sat"	"Evening"	"976"	9	7	6	22
10798	2012-05-05	"Sat"	"Midday"	"731"	7	3	1	11
10797	2012-05-04	"Fri"	"Evening"	"958"	9	5	8	22
10796	2012-05-04	"Fri"	"Midday"	"459"	4	5	9	18
10795	2012-05-03	"Thu"	"Evening"	"474"	4	7	4	15
10794	2012-05-03	"Thu"	"Midday"	"977"	9	7	7	23
10793	2012-05-02	"Wed"	"Evening"	"416"	4	1	6	11
10792	2012-05-02	"Wed"	"Midday"	"510"	5	1	0	6
10791	2012-05-01	"Tue"	"Evening"	"082"	0	8	2	10
10790	2012-05-01	"Tue"	"Midday"	"931"	9	3	1	13
10789	2012-04-30	"Mon"	"Evening"	"729"	7	2	9	18
10788	2012-04-30	"Mon"	"Midday"	"496"	4	9	6	19
10787	2012-04-29	"Sun"	"Evening"	"250"	2	5	0	7
10786	2012-04-29	"Sun"	"Midday"	"227"	2	2	7	11
10785	2012-04-28	"Sat"	"Evening"	"009"	0	0	9	9
10784	2012-04-28	"Sat"	"Midday"	"102"	1	0	2	3
10783	2012-04-27	"Fri"	"Evening"	"666"	6	6	6	18
10782	2012-04-27	"Fri"	"Midday"	"721"	7	2	1	10
10781	2012-04-26	"Thu"	"Evening"	"486"	4	8	6	18
10780	2012-04-26	"Thu"	"Midday"	"784"	7	8	4	19
10779	2012-04-25	"Wed"	"Evening"	"835"	8	3	5	16
10778	2012-04-25	"Wed"	"Midday"	"303"	3	0	3	6
10777	2012-04-24	"Tue"	"Evening"	"373"	3	7	3	13
10776	2012-04-24	"Tue"	"Midday"	"072"	0	7	2	9
10775	2012-04-23	"Mon"	"Evening"	"979"	9	7	9	25
10774	2012-04-23	"Mon"	"Midday"	"329"	3	2	9	14
10773	2012-04-22	"Sun"	"Evening"	"762"	7	6	2	15
10772	2012-04-22	"Sun"	"Midday"	"540"	5	4	0	9
10771	2012-04-21	"Sat"	"Evening"	"698"	6	9	8	23
10770	2012-04-21	"Sat"	"Midday"	"292"	2	9	2	13
10769	2012-04-20	"Fri"	"Evening"	"057"	0	5	7	12
10768	2012-04-20	"Fri"	"Midday"	"485"	4	8	5	17
10767	2012-04-19	"Thu"	"Evening"	"819"	8	1	9	18
10766	2012-04-19	"Thu"	"Midday"	"728"	7	2	8	17
10765	2012-04-18	"Wed"	"Evening"	"896"	8	9	6	23
10764	2012-04-18	"Wed"	"Midday"	"217"	2	1	7	10
10763	2012-04-17	"Tue"	"Evening"	"188"	1	8	8	17
10762	2012-04-17	"Tue"	"Midday"	"818"	8	1	8	17
10761	2012-04-16	"Mon"	"Evening"	"237"	2	3	7	12
10760	2012-04-16	"Mon"	"Midday"	"527"	5	2	7	14
10759	2012-04-15	"Sun"	"Evening"	"197"	1	9	7	17
10758	2012-04-15	"Sun"	"Midday"	"002"	0	0	2	2
10757	2012-04-14	"Sat"	"Evening"	"452"	4	5	2	11
10756	2012-04-14	"Sat"	"Midday"	"906"	9	0	6	15
10755	2012-04-13	"Fri"	"Evening"	"303"	3	0	3	6
10754	2012-04-13	"Fri"	"Midday"	"254"	2	5	4	11
10753	2012-04-12	"Thu"	"Evening"	"808"	8	0	8	16
10752	2012-04-12	"Thu"	"Midday"	"043"	0	4	3	7
10751	2012-04-11	"Wed"	"Evening"	"541"	5	4	1	10
10750	2012-04-11	"Wed"	"Midday"	"087"	0	8	7	15
10749	2012-04-10	"Tue"	"Evening"	"838"	8	3	8	19
10748	2012-04-10	"Tue"	"Midday"	"772"	7	7	2	16
10747	2012-04-09	"Mon"	"Evening"	"555"	5	5	5	15
10746	2012-04-09	"Mon"	"Midday"	"896"	8	9	6	23
10745	2012-04-08	"Sun"	"Evening"	"464"	4	6	4	14
10744	2012-04-08	"Sun"	"Midday"	"194"	1	9	4	14
10743	2012-04-07	"Sat"	"Evening"	"110"	1	1	0	2
10742	2012-04-07	"Sat"	"Midday"	"022"	0	2	2	4
10741	2012-04-06	"Fri"	"Evening"	"509"	5	0	9	14
10740	2012-04-06	"Fri"	"Midday"	"395"	3	9	5	17
10739	2012-04-05	"Thu"	"Evening"	"534"	5	3	4	12
10738	2012-04-05	"Thu"	"Midday"	"442"	4	4	2	10
10737	2012-04-04	"Wed"	"Evening"	"775"	7	7	5	19
10736	2012-04-04	"Wed"	"Midday"	"750"	7	5	0	12
10735	2012-04-03	"Tue"	"Evening"	"245"	2	4	5	11
10734	2012-04-03	"Tue"	"Midday"	"677"	6	7	7	20
10733	2012-04-02	"Mon"	"Evening"	"835"	8	3	5	16
10732	2012-04-02	"Mon"	"Midday"	"728"	7	2	8	17
10731	2012-04-01	"Sun"	"Evening"	"623"	6	2	3	11
10730	2012-04-01	"Sun"	"Midday"	"018"	0	1	8	9
10729	2012-03-31	"Sat"	"Evening"	"414"	4	1	4	9
10728	2012-03-31	"Sat"	"Midday"	"473"	4	7	3	14
10727	2012-03-30	"Fri"	"Evening"	"964"	9	6	4	19
10726	2012-03-30	"Fri"	"Midday"	"555"	5	5	5	15
10725	2012-03-29	"Thu"	"Evening"	"017"	0	1	7	8
10724	2012-03-29	"Thu"	"Midday"	"308"	3	0	8	11
10723	2012-03-28	"Wed"	"Evening"	"971"	9	7	1	17
10722	2012-03-28	"Wed"	"Midday"	"645"	6	4	5	15
10721	2012-03-27	"Tue"	"Evening"	"751"	7	5	1	13
10720	2012-03-27	"Tue"	"Midday"	"758"	7	5	8	20
10719	2012-03-26	"Mon"	"Evening"	"450"	4	5	0	9
10718	2012-03-26	"Mon"	"Midday"	"375"	3	7	5	15
10717	2012-03-25	"Sun"	"Evening"	"018"	0	1	8	9
10716	2012-03-25	"Sun"	"Midday"	"281"	2	8	1	11
10715	2012-03-24	"Sat"	"Evening"	"781"	7	8	1	16
10714	2012-03-24	"Sat"	"Midday"	"938"	9	3	8	20
10713	2012-03-23	"Fri"	"Evening"	"521"	5	2	1	8
10712	2012-03-23	"Fri"	"Midday"	"527"	5	2	7	14
10711	2012-03-22	"Thu"	"Evening"	"029"	0	2	9	11
10710	2012-03-22	"Thu"	"Midday"	"638"	6	3	8	17
10709	2012-03-21	"Wed"	"Evening"	"199"	1	9	9	19
10708	2012-03-21	"Wed"	"Midday"	"189"	1	8	9	18
10707	2012-03-20	"Tue"	"Evening"	"707"	7	0	7	14
10706	2012-03-20	"Tue"	"Midday"	"209"	2	0	9	11
10705	2012-03-19	"Mon"	"Evening"	"180"	1	8	0	9
10704	2012-03-19	"Mon"	"Midday"	"539"	5	3	9	17
10703	2012-03-18	"Sun"	"Evening"	"454"	4	5	4	13
10702	2012-03-18	"Sun"	"Midday"	"483"	4	8	3	15
10701	2012-03-17	"Sat"	"Evening"	"454"	4	5	4	13
10700	2012-03-17	"Sat"	"Midday"	"074"	0	7	4	11
10699	2012-03-16	"Fri"	"Evening"	"615"	6	1	5	12
10698	2012-03-16	"Fri"	"Midday"	"606"	6	0	6	12
10697	2012-03-15	"Thu"	"Evening"	"813"	8	1	3	12
10696	2012-03-15	"Thu"	"Midday"	"498"	4	9	8	21
10695	2012-03-14	"Wed"	"Evening"	"643"	6	4	3	13
10694	2012-03-14	"Wed"	"Midday"	"928"	9	2	8	19
10693	2012-03-13	"Tue"	"Evening"	"507"	5	0	7	12
10692	2012-03-13	"Tue"	"Midday"	"857"	8	5	7	20
10691	2012-03-12	"Mon"	"Evening"	"996"	9	9	6	24
10690	2012-03-12	"Mon"	"Midday"	"124"	1	2	4	7
10689	2012-03-11	"Sun"	"Evening"	"389"	3	8	9	20
10688	2012-03-11	"Sun"	"Midday"	"034"	0	3	4	7
10687	2012-03-10	"Sat"	"Evening"	"265"	2	6	5	13
10686	2012-03-10	"Sat"	"Midday"	"319"	3	1	9	13
10685	2012-03-09	"Fri"	"Evening"	"704"	7	0	4	11
10684	2012-03-09	"Fri"	"Midday"	"228"	2	2	8	12
10683	2012-03-08	"Thu"	"Evening"	"806"	8	0	6	14
10682	2012-03-08	"Thu"	"Midday"	"576"	5	7	6	18
10681	2012-03-07	"Wed"	"Evening"	"796"	7	9	6	22
10680	2012-03-07	"Wed"	"Midday"	"573"	5	7	3	15
10679	2012-03-06	"Tue"	"Evening"	"621"	6	2	1	9
10678	2012-03-06	"Tue"	"Midday"	"933"	9	3	3	15
10677	2012-03-05	"Mon"	"Evening"	"628"	6	2	8	16
10676	2012-03-05	"Mon"	"Midday"	"960"	9	6	0	15
10675	2012-03-04	"Sun"	"Evening"	"385"	3	8	5	16
10674	2012-03-04	"Sun"	"Midday"	"043"	0	4	3	7
10673	2012-03-03	"Sat"	"Evening"	"531"	5	3	1	9
10672	2012-03-03	"Sat"	"Midday"	"328"	3	2	8	13
10671	2012-03-02	"Fri"	"Evening"	"259"	2	5	9	16
10670	2012-03-02	"Fri"	"Midday"	"305"	3	0	5	8
10669	2012-03-01	"Thu"	"Evening"	"041"	0	4	1	5
10668	2012-03-01	"Thu"	"Midday"	"822"	8	2	2	12
10667	2012-02-29	"Wed"	"Evening"	"070"	0	7	0	7
10666	2012-02-29	"Wed"	"Midday"	"560"	5	6	0	11
10665	2012-02-28	"Tue"	"Evening"	"482"	4	8	2	14
10664	2012-02-28	"Tue"	"Midday"	"421"	4	2	1	7
10663	2012-02-27	"Mon"	"Evening"	"416"	4	1	6	11
10662	2012-02-27	"Mon"	"Midday"	"804"	8	0	4	12
10661	2012-02-26	"Sun"	"Evening"	"000"	0	0	0	0
10660	2012-02-26	"Sun"	"Midday"	"376"	3	7	6	16
10659	2012-02-25	"Sat"	"Evening"	"141"	1	4	1	6
10658	2012-02-25	"Sat"	"Midday"	"323"	3	2	3	8
10657	2012-02-24	"Fri"	"Evening"	"953"	9	5	3	17
10656	2012-02-24	"Fri"	"Midday"	"107"	1	0	7	8
10655	2012-02-23	"Thu"	"Evening"	"630"	6	3	0	9
10654	2012-02-23	"Thu"	"Midday"	"573"	5	7	3	15
10653	2012-02-22	"Wed"	"Evening"	"317"	3	1	7	11
10652	2012-02-22	"Wed"	"Midday"	"023"	0	2	3	5
10651	2012-02-21	"Tue"	"Evening"	"480"	4	8	0	12
10650	2012-02-21	"Tue"	"Midday"	"843"	8	4	3	15
10649	2012-02-20	"Mon"	"Evening"	"697"	6	9	7	22
10648	2012-02-20	"Mon"	"Midday"	"103"	1	0	3	4
10647	2012-02-19	"Sun"	"Evening"	"622"	6	2	2	10
10646	2012-02-19	"Sun"	"Midday"	"203"	2	0	3	5
10645	2012-02-18	"Sat"	"Evening"	"535"	5	3	5	13
10644	2012-02-18	"Sat"	"Midday"	"145"	1	4	5	10
10643	2012-02-17	"Fri"	"Evening"	"983"	9	8	3	20
10642	2012-02-17	"Fri"	"Midday"	"633"	6	3	3	12
10641	2012-02-16	"Thu"	"Evening"	"565"	5	6	5	16
10640	2012-02-16	"Thu"	"Midday"	"077"	0	7	7	14
10639	2012-02-15	"Wed"	"Evening"	"659"	6	5	9	20
10638	2012-02-15	"Wed"	"Midday"	"437"	4	3	7	14
10637	2012-02-14	"Tue"	"Evening"	"435"	4	3	5	12
10636	2012-02-14	"Tue"	"Midday"	"465"	4	6	5	15
10635	2012-02-13	"Mon"	"Evening"	"469"	4	6	9	19
10634	2012-02-13	"Mon"	"Midday"	"651"	6	5	1	12
10633	2012-02-12	"Sun"	"Evening"	"199"	1	9	9	19
10632	2012-02-12	"Sun"	"Midday"	"234"	2	3	4	9
10631	2012-02-11	"Sat"	"Evening"	"202"	2	0	2	4
10630	2012-02-11	"Sat"	"Midday"	"066"	0	6	6	12
10629	2012-02-10	"Fri"	"Evening"	"173"	1	7	3	11
10628	2012-02-10	"Fri"	"Midday"	"440"	4	4	0	8
10627	2012-02-09	"Thu"	"Evening"	"147"	1	4	7	12
10626	2012-02-09	"Thu"	"Midday"	"412"	4	1	2	7
10625	2012-02-08	"Wed"	"Evening"	"709"	7	0	9	16
10624	2012-02-08	"Wed"	"Midday"	"873"	8	7	3	18
10623	2012-02-07	"Tue"	"Evening"	"845"	8	4	5	17
10622	2012-02-07	"Tue"	"Midday"	"284"	2	8	4	14
10621	2012-02-06	"Mon"	"Evening"	"122"	1	2	2	5
10620	2012-02-06	"Mon"	"Midday"	"714"	7	1	4	12
10619	2012-02-05	"Sun"	"Evening"	"220"	2	2	0	4
10618	2012-02-05	"Sun"	"Midday"	"366"	3	6	6	15
10617	2012-02-04	"Sat"	"Evening"	"451"	4	5	1	10
10616	2012-02-04	"Sat"	"Midday"	"818"	8	1	8	17
10615	2012-02-03	"Fri"	"Evening"	"130"	1	3	0	4
10614	2012-02-03	"Fri"	"Midday"	"454"	4	5	4	13
10613	2012-02-02	"Thu"	"Evening"	"138"	1	3	8	12
10612	2012-02-02	"Thu"	"Midday"	"447"	4	4	7	15
10611	2012-02-01	"Wed"	"Evening"	"623"	6	2	3	11
10610	2012-02-01	"Wed"	"Midday"	"711"	7	1	1	9
10609	2012-01-31	"Tue"	"Evening"	"934"	9	3	4	16
10608	2012-01-31	"Tue"	"Midday"	"728"	7	2	8	17
10607	2012-01-30	"Mon"	"Evening"	"940"	9	4	0	13
10606	2012-01-30	"Mon"	"Midday"	"168"	1	6	8	15
10605	2012-01-29	"Sun"	"Evening"	"598"	5	9	8	22
10604	2012-01-29	"Sun"	"Midday"	"917"	9	1	7	17
10603	2012-01-28	"Sat"	"Evening"	"270"	2	7	0	9
10602	2012-01-28	"Sat"	"Midday"	"161"	1	6	1	8
10601	2012-01-27	"Fri"	"Evening"	"404"	4	0	4	8
10600	2012-01-27	"Fri"	"Midday"	"751"	7	5	1	13
10599	2012-01-26	"Thu"	"Evening"	"600"	6	0	0	6
10598	2012-01-26	"Thu"	"Midday"	"770"	7	7	0	14
10597	2012-01-25	"Wed"	"Evening"	"891"	8	9	1	18
10596	2012-01-25	"Wed"	"Midday"	"646"	6	4	6	16
10595	2012-01-24	"Tue"	"Evening"	"850"	8	5	0	13
10594	2012-01-24	"Tue"	"Midday"	"222"	2	2	2	6
10593	2012-01-23	"Mon"	"Evening"	"229"	2	2	9	13
10592	2012-01-23	"Mon"	"Midday"	"102"	1	0	2	3
10591	2012-01-22	"Sun"	"Evening"	"070"	0	7	0	7
10590	2012-01-22	"Sun"	"Midday"	"155"	1	5	5	11
10589	2012-01-21	"Sat"	"Evening"	"303"	3	0	3	6
10588	2012-01-21	"Sat"	"Midday"	"400"	4	0	0	4
10587	2012-01-20	"Fri"	"Evening"	"107"	1	0	7	8
10586	2012-01-20	"Fri"	"Midday"	"376"	3	7	6	16
10585	2012-01-19	"Thu"	"Evening"	"720"	7	2	0	9
10584	2012-01-19	"Thu"	"Midday"	"258"	2	5	8	15
10583	2012-01-18	"Wed"	"Evening"	"041"	0	4	1	5
10582	2012-01-18	"Wed"	"Midday"	"058"	0	5	8	13
10581	2012-01-17	"Tue"	"Evening"	"434"	4	3	4	11
10580	2012-01-17	"Tue"	"Midday"	"610"	6	1	0	7
10579	2012-01-16	"Mon"	"Evening"	"063"	0	6	3	9
10578	2012-01-16	"Mon"	"Midday"	"547"	5	4	7	16
10577	2012-01-15	"Sun"	"Evening"	"432"	4	3	2	9
10576	2012-01-15	"Sun"	"Midday"	"722"	7	2	2	11
10575	2012-01-14	"Sat"	"Evening"	"214"	2	1	4	7
10574	2012-01-14	"Sat"	"Midday"	"747"	7	4	7	18
10573	2012-01-13	"Fri"	"Evening"	"362"	3	6	2	11
10572	2012-01-13	"Fri"	"Midday"	"526"	5	2	6	13
10571	2012-01-12	"Thu"	"Evening"	"078"	0	7	8	15
10570	2012-01-12	"Thu"	"Midday"	"408"	4	0	8	12
10569	2012-01-11	"Wed"	"Evening"	"187"	1	8	7	16
10568	2012-01-11	"Wed"	"Midday"	"159"	1	5	9	15
10567	2012-01-10	"Tue"	"Evening"	"802"	8	0	2	10
10566	2012-01-10	"Tue"	"Midday"	"733"	7	3	3	13
10565	2012-01-09	"Mon"	"Evening"	"531"	5	3	1	9
10564	2012-01-09	"Mon"	"Midday"	"577"	5	7	7	19
10563	2012-01-08	"Sun"	"Evening"	"569"	5	6	9	20
10562	2012-01-08	"Sun"	"Midday"	"323"	3	2	3	8
10561	2012-01-07	"Sat"	"Evening"	"958"	9	5	8	22
10560	2012-01-07	"Sat"	"Midday"	"009"	0	0	9	9
10559	2012-01-06	"Fri"	"Evening"	"082"	0	8	2	10
10558	2012-01-06	"Fri"	"Midday"	"762"	7	6	2	15
10557	2012-01-05	"Thu"	"Evening"	"346"	3	4	6	13
10556	2012-01-05	"Thu"	"Midday"	"891"	8	9	1	18
10555	2012-01-04	"Wed"	"Evening"	"523"	5	2	3	10
10554	2012-01-04	"Wed"	"Midday"	"467"	4	6	7	17
10553	2012-01-03	"Tue"	"Evening"	"653"	6	5	3	14
10552	2012-01-03	"Tue"	"Midday"	"008"	0	0	8	8
10551	2012-01-02	"Mon"	"Evening"	"106"	1	0	6	7
10550	2012-01-02	"Mon"	"Midday"	"930"	9	3	0	12
10549	2012-01-01	"Sun"	"Evening"	"877"	8	7	7	22
10548	2012-01-01	"Sun"	"Midday"	"102"	1	0	2	3
10547	2011-12-31	"Sat"	"Evening"	"458"	4	5	8	17
10546	2011-12-31	"Sat"	"Midday"	"040"	0	4	0	4
10545	2011-12-30	"Fri"	"Evening"	"873"	8	7	3	18
10544	2011-12-30	"Fri"	"Midday"	"655"	6	5	5	16
10543	2011-12-29	"Thu"	"Evening"	"572"	5	7	2	14
10542	2011-12-29	"Thu"	"Midday"	"480"	4	8	0	12
10541	2011-12-28	"Wed"	"Evening"	"279"	2	7	9	18
10540	2011-12-28	"Wed"	"Midday"	"236"	2	3	6	11
10539	2011-12-27	"Tue"	"Evening"	"908"	9	0	8	17
10538	2011-12-27	"Tue"	"Midday"	"123"	1	2	3	6
10537	2011-12-26	"Mon"	"Evening"	"165"	1	6	5	12
10536	2011-12-26	"Mon"	"Midday"	"669"	6	6	9	21
10535	2011-12-25	"Sun"	"Evening"	"131"	1	3	1	5
10534	2011-12-25	"Sun"	"Midday"	"795"	7	9	5	21
10533	2011-12-24	"Sat"	"Evening"	"631"	6	3	1	10
10532	2011-12-24	"Sat"	"Midday"	"675"	6	7	5	18
10531	2011-12-23	"Fri"	"Evening"	"743"	7	4	3	14
10530	2011-12-23	"Fri"	"Midday"	"918"	9	1	8	18
10529	2011-12-22	"Thu"	"Evening"	"316"	3	1	6	10
10528	2011-12-22	"Thu"	"Midday"	"671"	6	7	1	14
10527	2011-12-21	"Wed"	"Evening"	"244"	2	4	4	10
10526	2011-12-21	"Wed"	"Midday"	"864"	8	6	4	18
10525	2011-12-20	"Tue"	"Evening"	"265"	2	6	5	13
10524	2011-12-20	"Tue"	"Midday"	"655"	6	5	5	16
10523	2011-12-19	"Mon"	"Evening"	"387"	3	8	7	18
10522	2011-12-19	"Mon"	"Midday"	"147"	1	4	7	12
10521	2011-12-18	"Sun"	"Evening"	"009"	0	0	9	9
10520	2011-12-18	"Sun"	"Midday"	"435"	4	3	5	12
10519	2011-12-17	"Sat"	"Evening"	"012"	0	1	2	3
10518	2011-12-17	"Sat"	"Midday"	"213"	2	1	3	6
10517	2011-12-16	"Fri"	"Evening"	"455"	4	5	5	14
10516	2011-12-16	"Fri"	"Midday"	"182"	1	8	2	11
10515	2011-12-15	"Thu"	"Evening"	"353"	3	5	3	11
10514	2011-12-15	"Thu"	"Midday"	"060"	0	6	0	6
10513	2011-12-14	"Wed"	"Evening"	"766"	7	6	6	19
10512	2011-12-14	"Wed"	"Midday"	"935"	9	3	5	17
10511	2011-12-13	"Tue"	"Evening"	"610"	6	1	0	7
10510	2011-12-13	"Tue"	"Midday"	"575"	5	7	5	17
10509	2011-12-12	"Mon"	"Evening"	"171"	1	7	1	9
10508	2011-12-12	"Mon"	"Midday"	"754"	7	5	4	16
10507	2011-12-11	"Sun"	"Evening"	"387"	3	8	7	18
10506	2011-12-11	"Sun"	"Midday"	"622"	6	2	2	10
10505	2011-12-10	"Sat"	"Evening"	"231"	2	3	1	6
10504	2011-12-10	"Sat"	"Midday"	"961"	9	6	1	16
10503	2011-12-09	"Fri"	"Evening"	"311"	3	1	1	5
10502	2011-12-09	"Fri"	"Midday"	"444"	4	4	4	12
10501	2011-12-08	"Thu"	"Evening"	"752"	7	5	2	14
10500	2011-12-08	"Thu"	"Midday"	"431"	4	3	1	8
10499	2011-12-07	"Wed"	"Evening"	"994"	9	9	4	22
10498	2011-12-07	"Wed"	"Midday"	"239"	2	3	9	14
10497	2011-12-06	"Tue"	"Evening"	"632"	6	3	2	11
10496	2011-12-06	"Tue"	"Midday"	"558"	5	5	8	18
10495	2011-12-05	"Mon"	"Evening"	"915"	9	1	5	15
10494	2011-12-05	"Mon"	"Midday"	"511"	5	1	1	7
10493	2011-12-04	"Sun"	"Evening"	"806"	8	0	6	14
10492	2011-12-04	"Sun"	"Midday"	"158"	1	5	8	14
10491	2011-12-03	"Sat"	"Evening"	"106"	1	0	6	7
10490	2011-12-03	"Sat"	"Midday"	"056"	0	5	6	11
10489	2011-12-02	"Fri"	"Evening"	"963"	9	6	3	18
10488	2011-12-02	"Fri"	"Midday"	"352"	3	5	2	10
10487	2011-12-01	"Thu"	"Evening"	"228"	2	2	8	12
10486	2011-12-01	"Thu"	"Midday"	"601"	6	0	1	7
10485	2011-11-30	"Wed"	"Evening"	"668"	6	6	8	20
10484	2011-11-30	"Wed"	"Midday"	"503"	5	0	3	8
10483	2011-11-29	"Tue"	"Evening"	"746"	7	4	6	17
10482	2011-11-29	"Tue"	"Midday"	"359"	3	5	9	17
10481	2011-11-28	"Mon"	"Evening"	"580"	5	8	0	13
10480	2011-11-28	"Mon"	"Midday"	"445"	4	4	5	13
10479	2011-11-27	"Sun"	"Evening"	"976"	9	7	6	22
10478	2011-11-27	"Sun"	"Midday"	"595"	5	9	5	19
10477	2011-11-26	"Sat"	"Evening"	"421"	4	2	1	7
10476	2011-11-26	"Sat"	"Midday"	"964"	9	6	4	19
10475	2011-11-25	"Fri"	"Evening"	"677"	6	7	7	20
10474	2011-11-25	"Fri"	"Midday"	"464"	4	6	4	14
10473	2011-11-24	"Thu"	"Evening"	"139"	1	3	9	13
10472	2011-11-24	"Thu"	"Midday"	"483"	4	8	3	15
10471	2011-11-23	"Wed"	"Evening"	"391"	3	9	1	13
10470	2011-11-23	"Wed"	"Midday"	"269"	2	6	9	17
10469	2011-11-22	"Tue"	"Evening"	"379"	3	7	9	19
10468	2011-11-22	"Tue"	"Midday"	"594"	5	9	4	18
10467	2011-11-21	"Mon"	"Evening"	"646"	6	4	6	16
10466	2011-11-21	"Mon"	"Midday"	"705"	7	0	5	12
10465	2011-11-20	"Sun"	"Evening"	"091"	0	9	1	10
10464	2011-11-20	"Sun"	"Midday"	"835"	8	3	5	16
10463	2011-11-19	"Sat"	"Evening"	"943"	9	4	3	16
10462	2011-11-19	"Sat"	"Midday"	"430"	4	3	0	7
10461	2011-11-18	"Fri"	"Evening"	"106"	1	0	6	7
10460	2011-11-18	"Fri"	"Midday"	"944"	9	4	4	17
10459	2011-11-17	"Thu"	"Evening"	"930"	9	3	0	12
10458	2011-11-17	"Thu"	"Midday"	"823"	8	2	3	13
10457	2011-11-16	"Wed"	"Evening"	"966"	9	6	6	21
10456	2011-11-16	"Wed"	"Midday"	"831"	8	3	1	12
10455	2011-11-15	"Tue"	"Evening"	"953"	9	5	3	17
10454	2011-11-15	"Tue"	"Midday"	"789"	7	8	9	24
10453	2011-11-14	"Mon"	"Evening"	"571"	5	7	1	13
10452	2011-11-14	"Mon"	"Midday"	"365"	3	6	5	14
10451	2011-11-13	"Sun"	"Evening"	"215"	2	1	5	8
10450	2011-11-13	"Sun"	"Midday"	"049"	0	4	9	13
10449	2011-11-12	"Sat"	"Evening"	"960"	9	6	0	15
10448	2011-11-12	"Sat"	"Midday"	"655"	6	5	5	16
10447	2011-11-11	"Fri"	"Evening"	"715"	7	1	5	13
10446	2011-11-11	"Fri"	"Midday"	"660"	6	6	0	12
10445	2011-11-10	"Thu"	"Evening"	"282"	2	8	2	12
10444	2011-11-10	"Thu"	"Midday"	"565"	5	6	5	16
10443	2011-11-09	"Wed"	"Evening"	"635"	6	3	5	14
10442	2011-11-09	"Wed"	"Midday"	"110"	1	1	0	2
10441	2011-11-08	"Tue"	"Evening"	"966"	9	6	6	21
10440	2011-11-08	"Tue"	"Midday"	"825"	8	2	5	15
10439	2011-11-07	"Mon"	"Evening"	"252"	2	5	2	9
10438	2011-11-07	"Mon"	"Midday"	"671"	6	7	1	14
10438	2011-11-07	"Mon"	"Midday"	"671"	6	7	1	14
10437	2011-11-06	"Sun"	"Evening"	"938"	9	3	8	20
10436	2011-11-06	"Sun"	"Midday"	"834"	8	3	4	15
10435	2011-11-05	"Sat"	"Evening"	"010"	0	1	0	1
10434	2011-11-05	"Sat"	"Midday"	"730"	7	3	0	10
10433	2011-11-04	"Fri"	"Evening"	"378"	3	7	8	18
10432	2011-11-04	"Fri"	"Midday"	"407"	4	0	7	11
10431	2011-11-03	"Thu"	"Evening"	"201"	2	0	1	3
10430	2011-11-03	"Thu"	"Midday"	"479"	4	7	9	20
10429	2011-11-02	"Wed"	"Evening"	"982"	9	8	2	19
10428	2011-11-02	"Wed"	"Midday"	"045"	0	4	5	9
10427	2011-11-01	"Tue"	"Evening"	"677"	6	7	7	20
10426	2011-11-01	"Tue"	"Midday"	"237"	2	3	7	12
10425	2011-10-31	"Mon"	"Evening"	"966"	9	6	6	21
10424	2011-10-31	"Mon"	"Midday"	"164"	1	6	4	11
10423	2011-10-30	"Sun"	"Evening"	"418"	4	1	8	13
10422	2011-10-30	"Sun"	"Midday"	"738"	7	3	8	18
10421	2011-10-29	"Sat"	"Evening"	"104"	1	0	4	5
10420	2011-10-29	"Sat"	"Midday"	"921"	9	2	1	12
10419	2011-10-28	"Fri"	"Evening"	"770"	7	7	0	14
10418	2011-10-28	"Fri"	"Midday"	"068"	0	6	8	14
10417	2011-10-27	"Thu"	"Evening"	"326"	3	2	6	11
10416	2011-10-27	"Thu"	"Midday"	"216"	2	1	6	9
10415	2011-10-26	"Wed"	"Evening"	"490"	4	9	0	13
10414	2011-10-26	"Wed"	"Midday"	"611"	6	1	1	8
10413	2011-10-25	"Tue"	"Evening"	"837"	8	3	7	18
10412	2011-10-25	"Tue"	"Midday"	"635"	6	3	5	14
10411	2011-10-24	"Mon"	"Evening"	"429"	4	2	9	15
10410	2011-10-24	"Mon"	"Midday"	"529"	5	2	9	16
10409	2011-10-23	"Sun"	"Evening"	"623"	6	2	3	11
10408	2011-10-23	"Sun"	"Midday"	"742"	7	4	2	13
10407	2011-10-22	"Sat"	"Evening"	"199"	1	9	9	19
10406	2011-10-22	"Sat"	"Midday"	"716"	7	1	6	14
10405	2011-10-21	"Fri"	"Evening"	"336"	3	3	6	12
10404	2011-10-21	"Fri"	"Midday"	"624"	6	2	4	12
10403	2011-10-20	"Thu"	"Evening"	"950"	9	5	0	14
10402	2011-10-20	"Thu"	"Midday"	"065"	0	6	5	11
10401	2011-10-19	"Wed"	"Evening"	"032"	0	3	2	5
10400	2011-10-19	"Wed"	"Midday"	"756"	7	5	6	18
10399	2011-10-18	"Tue"	"Evening"	"723"	7	2	3	12
10398	2011-10-18	"Tue"	"Midday"	"390"	3	9	0	12
10397	2011-10-17	"Mon"	"Evening"	"883"	8	8	3	19
10396	2011-10-17	"Mon"	"Midday"	"652"	6	5	2	13
10395	2011-10-16	"Sun"	"Evening"	"157"	1	5	7	13
10394	2011-10-16	"Sun"	"Midday"	"572"	5	7	2	14
10393	2011-10-15	"Sat"	"Evening"	"087"	0	8	7	15
10392	2011-10-15	"Sat"	"Midday"	"077"	0	7	7	14
10391	2011-10-14	"Fri"	"Evening"	"485"	4	8	5	17
10390	2011-10-14	"Fri"	"Midday"	"825"	8	2	5	15
10389	2011-10-13	"Thu"	"Evening"	"227"	2	2	7	11
10388	2011-10-13	"Thu"	"Midday"	"295"	2	9	5	16
10387	2011-10-12	"Wed"	"Evening"	"799"	7	9	9	25
10386	2011-10-12	"Wed"	"Midday"	"879"	8	7	9	24
10385	2011-10-11	"Tue"	"Evening"	"497"	4	9	7	20
10384	2011-10-11	"Tue"	"Midday"	"165"	1	6	5	12
10383	2011-10-10	"Mon"	"Evening"	"317"	3	1	7	11
10382	2011-10-10	"Mon"	"Midday"	"930"	9	3	0	12
10381	2011-10-09	"Sun"	"Evening"	"440"	4	4	0	8
10380	2011-10-09	"Sun"	"Midday"	"927"	9	2	7	18
10379	2011-10-08	"Sat"	"Evening"	"725"	7	2	5	14
10378	2011-10-08	"Sat"	"Midday"	"885"	8	8	5	21
10377	2011-10-07	"Fri"	"Evening"	"473"	4	7	3	14
10376	2011-10-07	"Fri"	"Midday"	"649"	6	4	9	19
10375	2011-10-06	"Thu"	"Evening"	"917"	9	1	7	17
10374	2011-10-06	"Thu"	"Midday"	"367"	3	6	7	16
10373	2011-10-05	"Wed"	"Evening"	"903"	9	0	3	12
10372	2011-10-05	"Wed"	"Midday"	"556"	5	5	6	16
10371	2011-10-04	"Tue"	"Evening"	"465"	4	6	5	15
10370	2011-10-04	"Tue"	"Midday"	"081"	0	8	1	9
10369	2011-10-03	"Mon"	"Evening"	"133"	1	3	3	7
10368	2011-10-03	"Mon"	"Midday"	"074"	0	7	4	11
10367	2011-10-02	"Sun"	"Evening"	"234"	2	3	4	9
10366	2011-10-02	"Sun"	"Midday"	"619"	6	1	9	16
10365	2011-10-01	"Sat"	"Evening"	"262"	2	6	2	10
10364	2011-10-01	"Sat"	"Midday"	"282"	2	8	2	12
10363	2011-09-30	"Fri"	"Evening"	"319"	3	1	9	13
10362	2011-09-30	"Fri"	"Midday"	"940"	9	4	0	13
10361	2011-09-29	"Thu"	"Evening"	"415"	4	1	5	10
10360	2011-09-29	"Thu"	"Midday"	"909"	9	0	9	18
10359	2011-09-28	"Wed"	"Evening"	"052"	0	5	2	7
10358	2011-09-28	"Wed"	"Midday"	"199"	1	9	9	19
10357	2011-09-27	"Tue"	"Evening"	"357"	3	5	7	15
10356	2011-09-27	"Tue"	"Midday"	"807"	8	0	7	15
10355	2011-09-26	"Mon"	"Evening"	"809"	8	0	9	17
10354	2011-09-26	"Mon"	"Midday"	"515"	5	1	5	11
10353	2011-09-25	"Sun"	"Evening"	"465"	4	6	5	15
10352	2011-09-25	"Sun"	"Midday"	"532"	5	3	2	10
10351	2011-09-24	"Sat"	"Evening"	"615"	6	1	5	12
10350	2011-09-24	"Sat"	"Midday"	"013"	0	1	3	4
10349	2011-09-23	"Fri"	"Evening"	"863"	8	6	3	17
10348	2011-09-23	"Fri"	"Midday"	"411"	4	1	1	6
10347	2011-09-22	"Thu"	"Evening"	"269"	2	6	9	17
10346	2011-09-22	"Thu"	"Midday"	"486"	4	8	6	18
10345	2011-09-21	"Wed"	"Evening"	"739"	7	3	9	19
10344	2011-09-21	"Wed"	"Midday"	"282"	2	8	2	12
10343	2011-09-20	"Tue"	"Evening"	"366"	3	6	6	15
10342	2011-09-20	"Tue"	"Midday"	"728"	7	2	8	17
10341	2011-09-19	"Mon"	"Evening"	"340"	3	4	0	7
10340	2011-09-19	"Mon"	"Midday"	"750"	7	5	0	12
10339	2011-09-18	"Sun"	"Evening"	"235"	2	3	5	10
10338	2011-09-18	"Sun"	"Midday"	"691"	6	9	1	16
10337	2011-09-17	"Sat"	"Evening"	"225"	2	2	5	9
10336	2011-09-17	"Sat"	"Midday"	"831"	8	3	1	12
10335	2011-09-16	"Fri"	"Evening"	"483"	4	8	3	15
10334	2011-09-16	"Fri"	"Midday"	"732"	7	3	2	12
10333	2011-09-15	"Thu"	"Evening"	"453"	4	5	3	12
10332	2011-09-15	"Thu"	"Midday"	"619"	6	1	9	16
10331	2011-09-14	"Wed"	"Evening"	"563"	5	6	3	14
10330	2011-09-14	"Wed"	"Midday"	"966"	9	6	6	21
10329	2011-09-13	"Tue"	"Evening"	"592"	5	9	2	16
10328	2011-09-13	"Tue"	"Midday"	"395"	3	9	5	17
10327	2011-09-12	"Mon"	"Evening"	"976"	9	7	6	22
10326	2011-09-12	"Mon"	"Midday"	"552"	5	5	2	12
10325	2011-09-11	"Sun"	"Evening"	"443"	4	4	3	11
10324	2011-09-11	"Sun"	"Midday"	"026"	0	2	6	8
10323	2011-09-10	"Sat"	"Evening"	"670"	6	7	0	13
10322	2011-09-10	"Sat"	"Midday"	"937"	9	3	7	19
10321	2011-09-09	"Fri"	"Evening"	"117"	1	1	7	9
10320	2011-09-09	"Fri"	"Midday"	"925"	9	2	5	16
10319	2011-09-08	"Thu"	"Evening"	"364"	3	6	4	13
10318	2011-09-08	"Thu"	"Midday"	"549"	5	4	9	18
10317	2011-09-07	"Wed"	"Evening"	"474"	4	7	4	15
10316	2011-09-07	"Wed"	"Midday"	"766"	7	6	6	19
10315	2011-09-06	"Tue"	"Evening"	"088"	0	8	8	16
10314	2011-09-06	"Tue"	"Midday"	"348"	3	4	8	15
10313	2011-09-05	"Mon"	"Evening"	"796"	7	9	6	22
10312	2011-09-05	"Mon"	"Midday"	"673"	6	7	3	16
10311	2011-09-04	"Sun"	"Evening"	"996"	9	9	6	24
10310	2011-09-04	"Sun"	"Midday"	"100"	1	0	0	1
10309	2011-09-03	"Sat"	"Evening"	"578"	5	7	8	20
10308	2011-09-03	"Sat"	"Midday"	"471"	4	7	1	12
10307	2011-09-02	"Fri"	"Evening"	"512"	5	1	2	8
10306	2011-09-02	"Fri"	"Midday"	"805"	8	0	5	13
10305	2011-09-01	"Thu"	"Evening"	"454"	4	5	4	13
10304	2011-09-01	"Thu"	"Midday"	"791"	7	9	1	17
10303	2011-08-31	"Wed"	"Evening"	"312"	3	1	2	6
10302	2011-08-31	"Wed"	"Midday"	"231"	2	3	1	6
10301	2011-08-30	"Tue"	"Evening"	"900"	9	0	0	9
10300	2011-08-30	"Tue"	"Midday"	"922"	9	2	2	13
10299	2011-08-29	"Mon"	"Evening"	"145"	1	4	5	10
10298	2011-08-29	"Mon"	"Midday"	"968"	9	6	8	23
10297	2011-08-28	"Sun"	"Evening"	"640"	6	4	0	10
10296	2011-08-28	"Sun"	"Midday"	"814"	8	1	4	13
10295	2011-08-27	"Sat"	"Evening"	"026"	0	2	6	8
10294	2011-08-27	"Sat"	"Midday"	"651"	6	5	1	12
10293	2011-08-26	"Fri"	"Evening"	"069"	0	6	9	15
10292	2011-08-26	"Fri"	"Midday"	"323"	3	2	3	8
10291	2011-08-25	"Thu"	"Evening"	"401"	4	0	1	5
10290	2011-08-25	"Thu"	"Midday"	"847"	8	4	7	19
10289	2011-08-24	"Wed"	"Evening"	"514"	5	1	4	10
10288	2011-08-24	"Wed"	"Midday"	"936"	9	3	6	18
10287	2011-08-23	"Tue"	"Evening"	"173"	1	7	3	11
10286	2011-08-23	"Tue"	"Midday"	"237"	2	3	7	12
10285	2011-08-22	"Mon"	"Evening"	"436"	4	3	6	13
10284	2011-08-22	"Mon"	"Midday"	"448"	4	4	8	16
10283	2011-08-21	"Sun"	"Evening"	"182"	1	8	2	11
10282	2011-08-21	"Sun"	"Midday"	"915"	9	1	5	15
10281	2011-08-20	"Sat"	"Evening"	"038"	0	3	8	11
10280	2011-08-20	"Sat"	"Midday"	"358"	3	5	8	16
10279	2011-08-19	"Fri"	"Evening"	"870"	8	7	0	15
10278	2011-08-19	"Fri"	"Midday"	"841"	8	4	1	13
10277	2011-08-18	"Thu"	"Evening"	"250"	2	5	0	7
10276	2011-08-18	"Thu"	"Midday"	"302"	3	0	2	5
10275	2011-08-17	"Wed"	"Evening"	"701"	7	0	1	8
10274	2011-08-17	"Wed"	"Midday"	"528"	5	2	8	15
10273	2011-08-16	"Tue"	"Evening"	"161"	1	6	1	8
10272	2011-08-16	"Tue"	"Midday"	"461"	4	6	1	11
10271	2011-08-15	"Mon"	"Evening"	"312"	3	1	2	6
10270	2011-08-15	"Mon"	"Midday"	"408"	4	0	8	12
10269	2011-08-14	"Sun"	"Evening"	"718"	7	1	8	16
10268	2011-08-14	"Sun"	"Midday"	"193"	1	9	3	13
10267	2011-08-13	"Sat"	"Evening"	"672"	6	7	2	15
10266	2011-08-13	"Sat"	"Midday"	"916"	9	1	6	16
10265	2011-08-12	"Fri"	"Evening"	"250"	2	5	0	7
10264	2011-08-12	"Fri"	"Midday"	"362"	3	6	2	11
10263	2011-08-11	"Thu"	"Evening"	"212"	2	1	2	5
10262	2011-08-11	"Thu"	"Midday"	"703"	7	0	3	10
10261	2011-08-10	"Wed"	"Evening"	"489"	4	8	9	21
10260	2011-08-10	"Wed"	"Midday"	"146"	1	4	6	11
10259	2011-08-09	"Tue"	"Evening"	"046"	0	4	6	10
10258	2011-08-09	"Tue"	"Midday"	"640"	6	4	0	10
10257	2011-08-08	"Mon"	"Evening"	"312"	3	1	2	6
10256	2011-08-08	"Mon"	"Midday"	"020"	0	2	0	2
10255	2011-08-07	"Sun"	"Evening"	"858"	8	5	8	21
10254	2011-08-07	"Sun"	"Midday"	"938"	9	3	8	20
10253	2011-08-06	"Sat"	"Evening"	"517"	5	1	7	13
10252	2011-08-06	"Sat"	"Midday"	"233"	2	3	3	8
10251	2011-08-05	"Fri"	"Evening"	"685"	6	8	5	19
10250	2011-08-05	"Fri"	"Midday"	"124"	1	2	4	7
10249	2011-08-04	"Thu"	"Evening"	"274"	2	7	4	13
10248	2011-08-04	"Thu"	"Midday"	"275"	2	7	5	14
10247	2011-08-03	"Wed"	"Evening"	"820"	8	2	0	10
10246	2011-08-03	"Wed"	"Midday"	"767"	7	6	7	20
10245	2011-08-02	"Tue"	"Evening"	"043"	0	4	3	7
10244	2011-08-02	"Tue"	"Midday"	"406"	4	0	6	10
10243	2011-08-01	"Mon"	"Evening"	"870"	8	7	0	15
10242	2011-08-01	"Mon"	"Midday"	"160"	1	6	0	7
10241	2011-07-31	"Sun"	"Evening"	"937"	9	3	7	19
10240	2011-07-31	"Sun"	"Midday"	"820"	8	2	0	10
10239	2011-07-30	"Sat"	"Evening"	"698"	6	9	8	23
10238	2011-07-30	"Sat"	"Midday"	"280"	2	8	0	10
10237	2011-07-29	"Fri"	"Evening"	"459"	4	5	9	18
10236	2011-07-29	"Fri"	"Midday"	"318"	3	1	8	12
10235	2011-07-28	"Thu"	"Evening"	"973"	9	7	3	19
10234	2011-07-28	"Thu"	"Midday"	"496"	4	9	6	19
10233	2011-07-27	"Wed"	"Evening"	"470"	4	7	0	11
10232	2011-07-27	"Wed"	"Midday"	"117"	1	1	7	9
10231	2011-07-26	"Tue"	"Evening"	"775"	7	7	5	19
10230	2011-07-26	"Tue"	"Midday"	"582"	5	8	2	15
10229	2011-07-25	"Mon"	"Evening"	"553"	5	5	3	13
10228	2011-07-25	"Mon"	"Midday"	"896"	8	9	6	23
10227	2011-07-24	"Sun"	"Evening"	"332"	3	3	2	8
10226	2011-07-24	"Sun"	"Midday"	"995"	9	9	5	23
10225	2011-07-23	"Sat"	"Evening"	"348"	3	4	8	15
10224	2011-07-23	"Sat"	"Midday"	"488"	4	8	8	20
10223	2011-07-22	"Fri"	"Evening"	"234"	2	3	4	9
10222	2011-07-22	"Fri"	"Midday"	"830"	8	3	0	11
10221	2011-07-21	"Thu"	"Evening"	"002"	0	0	2	2
10220	2011-07-21	"Thu"	"Midday"	"192"	1	9	2	12
10219	2011-07-20	"Wed"	"Evening"	"623"	6	2	3	11
10218	2011-07-20	"Wed"	"Midday"	"281"	2	8	1	11
10217	2011-07-19	"Tue"	"Evening"	"371"	3	7	1	11
10216	2011-07-19	"Tue"	"Midday"	"586"	5	8	6	19
10215	2011-07-18	"Mon"	"Evening"	"873"	8	7	3	18
10214	2011-07-18	"Mon"	"Midday"	"217"	2	1	7	10
10213	2011-07-17	"Sun"	"Evening"	"421"	4	2	1	7
10212	2011-07-17	"Sun"	"Midday"	"372"	3	7	2	12
10211	2011-07-16	"Sat"	"Evening"	"749"	7	4	9	20
10210	2011-07-16	"Sat"	"Midday"	"849"	8	4	9	21
10209	2011-07-15	"Fri"	"Evening"	"659"	6	5	9	20
10208	2011-07-15	"Fri"	"Midday"	"069"	0	6	9	15
10207	2011-07-14	"Thu"	"Evening"	"362"	3	6	2	11
10206	2011-07-14	"Thu"	"Midday"	"446"	4	4	6	14
10205	2011-07-13	"Wed"	"Evening"	"973"	9	7	3	19
10204	2011-07-13	"Wed"	"Midday"	"282"	2	8	2	12
10203	2011-07-12	"Tue"	"Evening"	"267"	2	6	7	15
10202	2011-07-12	"Tue"	"Midday"	"818"	8	1	8	17
10201	2011-07-11	"Mon"	"Evening"	"676"	6	7	6	19
10200	2011-07-11	"Mon"	"Midday"	"351"	3	5	1	9
10199	2011-07-10	"Sun"	"Evening"	"266"	2	6	6	14
10198	2011-07-10	"Sun"	"Midday"	"458"	4	5	8	17
10197	2011-07-09	"Sat"	"Evening"	"878"	8	7	8	23
10196	2011-07-09	"Sat"	"Midday"	"853"	8	5	3	16
10195	2011-07-08	"Fri"	"Evening"	"155"	1	5	5	11
10194	2011-07-08	"Fri"	"Midday"	"121"	1	2	1	4
10193	2011-07-07	"Thu"	"Evening"	"406"	4	0	6	10
10192	2011-07-07	"Thu"	"Midday"	"204"	2	0	4	6
10191	2011-07-06	"Wed"	"Evening"	"101"	1	0	1	2
10190	2011-07-06	"Wed"	"Midday"	"423"	4	2	3	9
10189	2011-07-05	"Tue"	"Evening"	"299"	2	9	9	20
10188	2011-07-05	"Tue"	"Midday"	"159"	1	5	9	15
10187	2011-07-04	"Mon"	"Evening"	"158"	1	5	8	14
10186	2011-07-04	"Mon"	"Midday"	"243"	2	4	3	9
10185	2011-07-03	"Sun"	"Evening"	"767"	7	6	7	20
10184	2011-07-03	"Sun"	"Midday"	"716"	7	1	6	14
10183	2011-07-02	"Sat"	"Evening"	"696"	6	9	6	21
10182	2011-07-02	"Sat"	"Midday"	"318"	3	1	8	12
10181	2011-07-01	"Fri"	"Evening"	"655"	6	5	5	16
10180	2011-07-01	"Fri"	"Midday"	"327"	3	2	7	12
10179	2011-06-30	"Thu"	"Evening"	"339"	3	3	9	15
10178	2011-06-30	"Thu"	"Midday"	"398"	3	9	8	20
10177	2011-06-29	"Wed"	"Evening"	"437"	4	3	7	14
10176	2011-06-29	"Wed"	"Midday"	"968"	9	6	8	23
10175	2011-06-28	"Tue"	"Evening"	"941"	9	4	1	14
10174	2011-06-28	"Tue"	"Midday"	"655"	6	5	5	16
10173	2011-06-27	"Mon"	"Evening"	"906"	9	0	6	15
10172	2011-06-27	"Mon"	"Midday"	"014"	0	1	4	5
10171	2011-06-26	"Sun"	"Evening"	"448"	4	4	8	16
10170	2011-06-26	"Sun"	"Midday"	"316"	3	1	6	10
10169	2011-06-25	"Sat"	"Evening"	"101"	1	0	1	2
10168	2011-06-25	"Sat"	"Midday"	"489"	4	8	9	21
10167	2011-06-24	"Fri"	"Evening"	"047"	0	4	7	11
10166	2011-06-24	"Fri"	"Midday"	"063"	0	6	3	9
10165	2011-06-23	"Thu"	"Evening"	"957"	9	5	7	21
10164	2011-06-23	"Thu"	"Midday"	"306"	3	0	6	9
10163	2011-06-22	"Wed"	"Evening"	"448"	4	4	8	16
10162	2011-06-22	"Wed"	"Midday"	"391"	3	9	1	13
10161	2011-06-21	"Tue"	"Evening"	"314"	3	1	4	8
10160	2011-06-21	"Tue"	"Midday"	"000"	0	0	0	0
10159	2011-06-20	"Mon"	"Evening"	"272"	2	7	2	11
10158	2011-06-20	"Mon"	"Midday"	"579"	5	7	9	21
10157	2011-06-19	"Sun"	"Evening"	"331"	3	3	1	7
10156	2011-06-19	"Sun"	"Midday"	"815"	8	1	5	14
10155	2011-06-18	"Sat"	"Evening"	"987"	9	8	7	24
10154	2011-06-18	"Sat"	"Midday"	"304"	3	0	4	7
10153	2011-06-17	"Fri"	"Evening"	"439"	4	3	9	16
10152	2011-06-17	"Fri"	"Midday"	"479"	4	7	9	20
10151	2011-06-16	"Thu"	"Evening"	"952"	9	5	2	16
10150	2011-06-16	"Thu"	"Midday"	"296"	2	9	6	17
10149	2011-06-15	"Wed"	"Evening"	"020"	0	2	0	2
10148	2011-06-15	"Wed"	"Midday"	"302"	3	0	2	5
10147	2011-06-14	"Tue"	"Evening"	"936"	9	3	6	18
10146	2011-06-14	"Tue"	"Midday"	"065"	0	6	5	11
10145	2011-06-13	"Mon"	"Evening"	"460"	4	6	0	10
10144	2011-06-13	"Mon"	"Midday"	"044"	0	4	4	8
10143	2011-06-12	"Sun"	"Evening"	"288"	2	8	8	18
10142	2011-06-12	"Sun"	"Midday"	"358"	3	5	8	16
10141	2011-06-11	"Sat"	"Evening"	"374"	3	7	4	14
10140	2011-06-11	"Sat"	"Midday"	"378"	3	7	8	18
10139	2011-06-10	"Fri"	"Evening"	"072"	0	7	2	9
10138	2011-06-10	"Fri"	"Midday"	"434"	4	3	4	11
10137	2011-06-09	"Thu"	"Evening"	"970"	9	7	0	16
10136	2011-06-09	"Thu"	"Midday"	"923"	9	2	3	14
10135	2011-06-08	"Wed"	"Evening"	"747"	7	4	7	18
10134	2011-06-08	"Wed"	"Midday"	"289"	2	8	9	19
10133	2011-06-07	"Tue"	"Evening"	"985"	9	8	5	22
10132	2011-06-07	"Tue"	"Midday"	"468"	4	6	8	18
10131	2011-06-06	"Mon"	"Evening"	"097"	0	9	7	16
10130	2011-06-06	"Mon"	"Midday"	"756"	7	5	6	18
10129	2011-06-05	"Sun"	"Evening"	"306"	3	0	6	9
10128	2011-06-05	"Sun"	"Midday"	"536"	5	3	6	14
10127	2011-06-04	"Sat"	"Evening"	"694"	6	9	4	19
10126	2011-06-04	"Sat"	"Midday"	"303"	3	0	3	6
10125	2011-06-03	"Fri"	"Evening"	"595"	5	9	5	19
10124	2011-06-03	"Fri"	"Midday"	"266"	2	6	6	14
10123	2011-06-02	"Thu"	"Evening"	"260"	2	6	0	8
10122	2011-06-02	"Thu"	"Midday"	"732"	7	3	2	12
10121	2011-06-01	"Wed"	"Evening"	"852"	8	5	2	15
10120	2011-06-01	"Wed"	"Midday"	"698"	6	9	8	23
10119	2011-05-31	"Tue"	"Evening"	"034"	0	3	4	7
10118	2011-05-31	"Tue"	"Midday"	"220"	2	2	0	4
10117	2011-05-30	"Mon"	"Evening"	"636"	6	3	6	15
10116	2011-05-30	"Mon"	"Midday"	"864"	8	6	4	18
10115	2011-05-29	"Sun"	"Evening"	"161"	1	6	1	8
10114	2011-05-29	"Sun"	"Midday"	"118"	1	1	8	10
10113	2011-05-28	"Sat"	"Evening"	"108"	1	0	8	9
10112	2011-05-28	"Sat"	"Midday"	"729"	7	2	9	18
10111	2011-05-27	"Fri"	"Evening"	"400"	4	0	0	4
10110	2011-05-27	"Fri"	"Midday"	"118"	1	1	8	10
10109	2011-05-26	"Thu"	"Evening"	"769"	7	6	9	22
10108	2011-05-26	"Thu"	"Midday"	"361"	3	6	1	10
10107	2011-05-25	"Wed"	"Evening"	"526"	5	2	6	13
10106	2011-05-25	"Wed"	"Midday"	"532"	5	3	2	10
10105	2011-05-24	"Tue"	"Evening"	"404"	4	0	4	8
10104	2011-05-24	"Tue"	"Midday"	"703"	7	0	3	10
10103	2011-05-23	"Mon"	"Evening"	"393"	3	9	3	15
10102	2011-05-23	"Mon"	"Midday"	"101"	1	0	1	2
10101	2011-05-22	"Sun"	"Evening"	"176"	1	7	6	14
10100	2011-05-22	"Sun"	"Midday"	"083"	0	8	3	11
10099	2011-05-21	"Sat"	"Evening"	"806"	8	0	6	14
10098	2011-05-21	"Sat"	"Midday"	"506"	5	0	6	11
10097	2011-05-20	"Fri"	"Evening"	"889"	8	8	9	25
10096	2011-05-20	"Fri"	"Midday"	"617"	6	1	7	14
10095	2011-05-19	"Thu"	"Evening"	"376"	3	7	6	16
10094	2011-05-19	"Thu"	"Midday"	"173"	1	7	3	11
10093	2011-05-18	"Wed"	"Evening"	"912"	9	1	2	12
10092	2011-05-18	"Wed"	"Midday"	"655"	6	5	5	16
10091	2011-05-17	"Tue"	"Evening"	"412"	4	1	2	7
10090	2011-05-17	"Tue"	"Midday"	"714"	7	1	4	12
10089	2011-05-16	"Mon"	"Evening"	"103"	1	0	3	4
10088	2011-05-16	"Mon"	"Midday"	"342"	3	4	2	9
10087	2011-05-15	"Sun"	"Evening"	"411"	4	1	1	6
10086	2011-05-15	"Sun"	"Midday"	"833"	8	3	3	14
10085	2011-05-14	"Sat"	"Evening"	"374"	3	7	4	14
10084	2011-05-14	"Sat"	"Midday"	"975"	9	7	5	21
10083	2011-05-13	"Fri"	"Evening"	"512"	5	1	2	8
10082	2011-05-13	"Fri"	"Midday"	"361"	3	6	1	10
10081	2011-05-12	"Thu"	"Evening"	"194"	1	9	4	14
10080	2011-05-12	"Thu"	"Midday"	"049"	0	4	9	13
10079	2011-05-11	"Wed"	"Evening"	"624"	6	2	4	12
10078	2011-05-11	"Wed"	"Midday"	"151"	1	5	1	7
10077	2011-05-10	"Tue"	"Evening"	"483"	4	8	3	15
10076	2011-05-10	"Tue"	"Midday"	"982"	9	8	2	19
10075	2011-05-09	"Mon"	"Evening"	"223"	2	2	3	7
10074	2011-05-09	"Mon"	"Midday"	"452"	4	5	2	11
10073	2011-05-08	"Sun"	"Evening"	"399"	3	9	9	21
10072	2011-05-08	"Sun"	"Midday"	"135"	1	3	5	9
10071	2011-05-07	"Sat"	"Evening"	"078"	0	7	8	15
10070	2011-05-07	"Sat"	"Midday"	"534"	5	3	4	12
10069	2011-05-06	"Fri"	"Evening"	"336"	3	3	6	12
10068	2011-05-06	"Fri"	"Midday"	"444"	4	4	4	12
10067	2011-05-05	"Thu"	"Evening"	"118"	1	1	8	10
10066	2011-05-05	"Thu"	"Midday"	"785"	7	8	5	20
10065	2011-05-04	"Wed"	"Evening"	"221"	2	2	1	5
10064	2011-05-04	"Wed"	"Midday"	"814"	8	1	4	13
10063	2011-05-03	"Tue"	"Evening"	"076"	0	7	6	13
10062	2011-05-03	"Tue"	"Midday"	"998"	9	9	8	26
10061	2011-05-02	"Mon"	"Evening"	"335"	3	3	5	11
10060	2011-05-02	"Mon"	"Midday"	"146"	1	4	6	11
10059	2011-05-01	"Sun"	"Evening"	"081"	0	8	1	9
10058	2011-05-01	"Sun"	"Midday"	"790"	7	9	0	16
10057	2011-04-30	"Sat"	"Evening"	"124"	1	2	4	7
10056	2011-04-30	"Sat"	"Midday"	"867"	8	6	7	21
10055	2011-04-29	"Fri"	"Evening"	"746"	7	4	6	17
10054	2011-04-29	"Fri"	"Midday"	"096"	0	9	6	15
10053	2011-04-28	"Thu"	"Evening"	"427"	4	2	7	13
10052	2011-04-28	"Thu"	"Midday"	"393"	3	9	3	15
10051	2011-04-27	"Wed"	"Evening"	"759"	7	5	9	21
10050	2011-04-27	"Wed"	"Midday"	"823"	8	2	3	13
10049	2011-04-26	"Tue"	"Evening"	"374"	3	7	4	14
10048	2011-04-26	"Tue"	"Midday"	"972"	9	7	2	18
10047	2011-04-25	"Mon"	"Evening"	"884"	8	8	4	20
10046	2011-04-25	"Mon"	"Midday"	"599"	5	9	9	23
10045	2011-04-24	"Sun"	"Evening"	"502"	5	0	2	7
10044	2011-04-24	"Sun"	"Midday"	"674"	6	7	4	17
10043	2011-04-23	"Sat"	"Evening"	"583"	5	8	3	16
10042	2011-04-23	"Sat"	"Midday"	"399"	3	9	9	21
10041	2011-04-22	"Fri"	"Evening"	"878"	8	7	8	23
10040	2011-04-22	"Fri"	"Midday"	"708"	7	0	8	15
10039	2011-04-21	"Thu"	"Evening"	"048"	0	4	8	12
10038	2011-04-21	"Thu"	"Midday"	"492"	4	9	2	15
10037	2011-04-20	"Wed"	"Evening"	"280"	2	8	0	10
10036	2011-04-20	"Wed"	"Midday"	"753"	7	5	3	15
10035	2011-04-19	"Tue"	"Evening"	"828"	8	2	8	18
10034	2011-04-19	"Tue"	"Midday"	"369"	3	6	9	18
10033	2011-04-18	"Mon"	"Evening"	"876"	8	7	6	21
10032	2011-04-18	"Mon"	"Midday"	"862"	8	6	2	16
10031	2011-04-17	"Sun"	"Evening"	"956"	9	5	6	20
10030	2011-04-17	"Sun"	"Midday"	"253"	2	5	3	10
10029	2011-04-16	"Sat"	"Evening"	"824"	8	2	4	14
10028	2011-04-16	"Sat"	"Midday"	"489"	4	8	9	21
10027	2011-04-15	"Fri"	"Evening"	"147"	1	4	7	12
10026	2011-04-15	"Fri"	"Midday"	"797"	7	9	7	23
10025	2011-04-14	"Thu"	"Evening"	"900"	9	0	0	9
10024	2011-04-14	"Thu"	"Midday"	"445"	4	4	5	13
10023	2011-04-13	"Wed"	"Evening"	"114"	1	1	4	6
10022	2011-04-13	"Wed"	"Midday"	"864"	8	6	4	18
10021	2011-04-12	"Tue"	"Evening"	"007"	0	0	7	7
10020	2011-04-12	"Tue"	"Midday"	"579"	5	7	9	21
10019	2011-04-11	"Mon"	"Evening"	"361"	3	6	1	10
10018	2011-04-11	"Mon"	"Midday"	"058"	0	5	8	13
10017	2011-04-10	"Sun"	"Evening"	"691"	6	9	1	16
10016	2011-04-10	"Sun"	"Midday"	"070"	0	7	0	7
10015	2011-04-09	"Sat"	"Evening"	"279"	2	7	9	18
10014	2011-04-09	"Sat"	"Midday"	"646"	6	4	6	16
10013	2011-04-08	"Fri"	"Evening"	"963"	9	6	3	18
10012	2011-04-08	"Fri"	"Midday"	"866"	8	6	6	20
10011	2011-04-07	"Thu"	"Evening"	"180"	1	8	0	9
10010	2011-04-07	"Thu"	"Midday"	"063"	0	6	3	9
10009	2011-04-06	"Wed"	"Evening"	"655"	6	5	5	16
10008	2011-04-06	"Wed"	"Midday"	"072"	0	7	2	9
10007	2011-04-05	"Tue"	"Evening"	"070"	0	7	0	7
10006	2011-04-05	"Tue"	"Midday"	"382"	3	8	2	13
10005	2011-04-04	"Mon"	"Evening"	"294"	2	9	4	15
10004	2011-04-04	"Mon"	"Midday"	"527"	5	2	7	14
10003	2011-04-03	"Sun"	"Evening"	"801"	8	0	1	9
10002	2011-04-03	"Sun"	"Midday"	"045"	0	4	5	9
10001	2011-04-02	"Sat"	"Evening"	"958"	9	5	8	22
10000	2011-04-02	"Sat"	"Midday"	"219"	2	1	9	12
9999	2011-04-01	"Fri"	"Evening"	"646"	6	4	6	16
9998	2011-04-01	"Fri"	"Midday"	"671"	6	7	1	14
9997	2011-03-31	"Thu"	"Evening"	"509"	5	0	9	14
9996	2011-03-31	"Thu"	"Midday"	"961"	9	6	1	16
9995	2011-03-30	"Wed"	"Evening"	"015"	0	1	5	6
9994	2011-03-30	"Wed"	"Midday"	"445"	4	4	5	13
9993	2011-03-29	"Tue"	"Evening"	"475"	4	7	5	16
9992	2011-03-29	"Tue"	"Midday"	"892"	8	9	2	19
9991	2011-03-28	"Mon"	"Evening"	"216"	2	1	6	9
9990	2011-03-28	"Mon"	"Midday"	"613"	6	1	3	10
9989	2011-03-27	"Sun"	"Evening"	"146"	1	4	6	11
9988	2011-03-27	"Sun"	"Midday"	"377"	3	7	7	17
9987	2011-03-26	"Sat"	"Evening"	"475"	4	7	5	16
9986	2011-03-26	"Sat"	"Midday"	"159"	1	5	9	15
9985	2011-03-25	"Fri"	"Evening"	"462"	4	6	2	12
9984	2011-03-25	"Fri"	"Midday"	"398"	3	9	8	20
9983	2011-03-24	"Thu"	"Evening"	"702"	7	0	2	9
9982	2011-03-24	"Thu"	"Midday"	"150"	1	5	0	6
9981	2011-03-23	"Wed"	"Evening"	"100"	1	0	0	1
9980	2011-03-23	"Wed"	"Midday"	"254"	2	5	4	11
9979	2011-03-22	"Tue"	"Evening"	"233"	2	3	3	8
9978	2011-03-22	"Tue"	"Midday"	"966"	9	6	6	21
9977	2011-03-21	"Mon"	"Evening"	"273"	2	7	3	12
9976	2011-03-21	"Mon"	"Midday"	"187"	1	8	7	16
9975	2011-03-20	"Sun"	"Evening"	"667"	6	6	7	19
9974	2011-03-20	"Sun"	"Midday"	"460"	4	6	0	10
9973	2011-03-19	"Sat"	"Evening"	"101"	1	0	1	2
9972	2011-03-19	"Sat"	"Midday"	"009"	0	0	9	9
9971	2011-03-18	"Fri"	"Evening"	"451"	4	5	1	10
9970	2011-03-18	"Fri"	"Midday"	"163"	1	6	3	10
9969	2011-03-17	"Thu"	"Evening"	"354"	3	5	4	12
9968	2011-03-17	"Thu"	"Midday"	"848"	8	4	8	20
9967	2011-03-16	"Wed"	"Evening"	"079"	0	7	9	16
9966	2011-03-16	"Wed"	"Midday"	"590"	5	9	0	14
9965	2011-03-15	"Tue"	"Evening"	"609"	6	0	9	15
9964	2011-03-15	"Tue"	"Midday"	"537"	5	3	7	15
9963	2011-03-14	"Mon"	"Evening"	"897"	8	9	7	24
9962	2011-03-14	"Mon"	"Midday"	"095"	0	9	5	14
9961	2011-03-13	"Sun"	"Evening"	"370"	3	7	0	10
9960	2011-03-13	"Sun"	"Midday"	"026"	0	2	6	8
9959	2011-03-12	"Sat"	"Evening"	"541"	5	4	1	10
9958	2011-03-12	"Sat"	"Midday"	"935"	9	3	5	17
9957	2011-03-11	"Fri"	"Evening"	"789"	7	8	9	24
9956	2011-03-11	"Fri"	"Midday"	"285"	2	8	5	15
9955	2011-03-10	"Thu"	"Evening"	"108"	1	0	8	9
9954	2011-03-10	"Thu"	"Midday"	"248"	2	4	8	14
9953	2011-03-09	"Wed"	"Evening"	"688"	6	8	8	22
9952	2011-03-09	"Wed"	"Midday"	"397"	3	9	7	19
9951	2011-03-08	"Tue"	"Evening"	"387"	3	8	7	18
9950	2011-03-08	"Tue"	"Midday"	"831"	8	3	1	12
9949	2011-03-07	"Mon"	"Evening"	"061"	0	6	1	7
9948	2011-03-07	"Mon"	"Midday"	"342"	3	4	2	9
9947	2011-03-06	"Sun"	"Evening"	"603"	6	0	3	9
9946	2011-03-06	"Sun"	"Midday"	"158"	1	5	8	14
9945	2011-03-05	"Sat"	"Evening"	"992"	9	9	2	20
9944	2011-03-05	"Sat"	"Midday"	"463"	4	6	3	13
9943	2011-03-04	"Fri"	"Evening"	"568"	5	6	8	19
9942	2011-03-04	"Fri"	"Midday"	"773"	7	7	3	17
9941	2011-03-03	"Thu"	"Evening"	"062"	0	6	2	8
9940	2011-03-03	"Thu"	"Midday"	"962"	9	6	2	17
9939	2011-03-02	"Wed"	"Evening"	"374"	3	7	4	14
9938	2011-03-02	"Wed"	"Midday"	"722"	7	2	2	11
9937	2011-03-01	"Tue"	"Evening"	"294"	2	9	4	15
9936	2011-03-01	"Tue"	"Midday"	"327"	3	2	7	12
9935	2011-02-28	"Mon"	"Evening"	"735"	7	3	5	15
9934	2011-02-28	"Mon"	"Midday"	"383"	3	8	3	14
9933	2011-02-27	"Sun"	"Evening"	"872"	8	7	2	17
9932	2011-02-27	"Sun"	"Midday"	"483"	4	8	3	15
9931	2011-02-26	"Sat"	"Evening"	"167"	1	6	7	14
9930	2011-02-26	"Sat"	"Midday"	"167"	1	6	7	14
9929	2011-02-25	"Fri"	"Evening"	"686"	6	8	6	20
9928	2011-02-25	"Fri"	"Midday"	"130"	1	3	0	4
9927	2011-02-24	"Thu"	"Evening"	"067"	0	6	7	13
9926	2011-02-24	"Thu"	"Midday"	"918"	9	1	8	18
9925	2011-02-23	"Wed"	"Evening"	"443"	4	4	3	11
9924	2011-02-23	"Wed"	"Midday"	"783"	7	8	3	18
9923	2011-02-22	"Tue"	"Evening"	"271"	2	7	1	10
9922	2011-02-22	"Tue"	"Midday"	"245"	2	4	5	11
9921	2011-02-21	"Mon"	"Evening"	"976"	9	7	6	22
9920	2011-02-21	"Mon"	"Midday"	"900"	9	0	0	9
9919	2011-02-20	"Sun"	"Evening"	"533"	5	3	3	11
9918	2011-02-20	"Sun"	"Midday"	"263"	2	6	3	11
9917	2011-02-19	"Sat"	"Evening"	"347"	3	4	7	14
9916	2011-02-19	"Sat"	"Midday"	"633"	6	3	3	12
9915	2011-02-18	"Fri"	"Evening"	"821"	8	2	1	11
9914	2011-02-18	"Fri"	"Midday"	"096"	0	9	6	15
9913	2011-02-17	"Thu"	"Evening"	"806"	8	0	6	14
9912	2011-02-17	"Thu"	"Midday"	"221"	2	2	1	5
9911	2011-02-16	"Wed"	"Evening"	"131"	1	3	1	5
9910	2011-02-16	"Wed"	"Midday"	"746"	7	4	6	17
9909	2011-02-15	"Tue"	"Evening"	"688"	6	8	8	22
9908	2011-02-15	"Tue"	"Midday"	"869"	8	6	9	23
9907	2011-02-14	"Mon"	"Evening"	"173"	1	7	3	11
9906	2011-02-14	"Mon"	"Midday"	"928"	9	2	8	19
9905	2011-02-13	"Sun"	"Evening"	"839"	8	3	9	20
9904	2011-02-13	"Sun"	"Midday"	"560"	5	6	0	11
9903	2011-02-12	"Sat"	"Evening"	"928"	9	2	8	19
9902	2011-02-12	"Sat"	"Midday"	"457"	4	5	7	16
9901	2011-02-11	"Fri"	"Evening"	"802"	8	0	2	10
9900	2011-02-11	"Fri"	"Midday"	"957"	9	5	7	21
9899	2011-02-10	"Thu"	"Evening"	"868"	8	6	8	22
9898	2011-02-10	"Thu"	"Midday"	"943"	9	4	3	16
9897	2011-02-09	"Wed"	"Evening"	"700"	7	0	0	7
9896	2011-02-09	"Wed"	"Midday"	"888"	8	8	8	24
9895	2011-02-08	"Tue"	"Evening"	"046"	0	4	6	10
9894	2011-02-08	"Tue"	"Midday"	"260"	2	6	0	8
9893	2011-02-07	"Mon"	"Evening"	"021"	0	2	1	3
9892	2011-02-07	"Mon"	"Midday"	"458"	4	5	8	17
9891	2011-02-06	"Sun"	"Evening"	"811"	8	1	1	10
9890	2011-02-06	"Sun"	"Midday"	"169"	1	6	9	16
9889	2011-02-05	"Sat"	"Evening"	"358"	3	5	8	16
9888	2011-02-05	"Sat"	"Midday"	"081"	0	8	1	9
9887	2011-02-04	"Fri"	"Evening"	"122"	1	2	2	5
9886	2011-02-04	"Fri"	"Midday"	"065"	0	6	5	11
9885	2011-02-03	"Thu"	"Evening"	"672"	6	7	2	15
9884	2011-02-03	"Thu"	"Midday"	"502"	5	0	2	7
9883	2011-02-02	"Wed"	"Evening"	"418"	4	1	8	13
9882	2011-02-02	"Wed"	"Midday"	"390"	3	9	0	12
9881	2011-02-01	"Tue"	"Evening"	"873"	8	7	3	18
9880	2011-02-01	"Tue"	"Midday"	"150"	1	5	0	6
9879	2011-01-31	"Mon"	"Evening"	"041"	0	4	1	5
9878	2011-01-31	"Mon"	"Midday"	"165"	1	6	5	12
9877	2011-01-30	"Sun"	"Evening"	"204"	2	0	4	6
9876	2011-01-30	"Sun"	"Midday"	"651"	6	5	1	12
9875	2011-01-29	"Sat"	"Evening"	"392"	3	9	2	14
9874	2011-01-29	"Sat"	"Midday"	"061"	0	6	1	7
9873	2011-01-28	"Fri"	"Evening"	"401"	4	0	1	5
9872	2011-01-28	"Fri"	"Midday"	"802"	8	0	2	10
9871	2011-01-27	"Thu"	"Evening"	"886"	8	8	6	22
9870	2011-01-27	"Thu"	"Midday"	"563"	5	6	3	14
9869	2011-01-26	"Wed"	"Evening"	"868"	8	6	8	22
9868	2011-01-26	"Wed"	"Midday"	"669"	6	6	9	21
9867	2011-01-25	"Tue"	"Evening"	"901"	9	0	1	10
9866	2011-01-25	"Tue"	"Midday"	"805"	8	0	5	13
9865	2011-01-24	"Mon"	"Evening"	"323"	3	2	3	8
9864	2011-01-24	"Mon"	"Midday"	"294"	2	9	4	15
9863	2011-01-23	"Sun"	"Evening"	"810"	8	1	0	9
9862	2011-01-23	"Sun"	"Midday"	"400"	4	0	0	4
9861	2011-01-22	"Sat"	"Evening"	"795"	7	9	5	21
9860	2011-01-22	"Sat"	"Midday"	"918"	9	1	8	18
9859	2011-01-21	"Fri"	"Evening"	"710"	7	1	0	8
9858	2011-01-21	"Fri"	"Midday"	"101"	1	0	1	2
9857	2011-01-20	"Thu"	"Evening"	"158"	1	5	8	14
9856	2011-01-20	"Thu"	"Midday"	"239"	2	3	9	14
9855	2011-01-19	"Wed"	"Evening"	"066"	0	6	6	12
9854	2011-01-19	"Wed"	"Midday"	"628"	6	2	8	16
9853	2011-01-18	"Tue"	"Evening"	"022"	0	2	2	4
9852	2011-01-18	"Tue"	"Midday"	"065"	0	6	5	11
9851	2011-01-17	"Mon"	"Evening"	"219"	2	1	9	12
9850	2011-01-17	"Mon"	"Midday"	"075"	0	7	5	12
9849	2011-01-16	"Sun"	"Evening"	"377"	3	7	7	17
9848	2011-01-16	"Sun"	"Midday"	"528"	5	2	8	15
9847	2011-01-15	"Sat"	"Evening"	"013"	0	1	3	4
9846	2011-01-15	"Sat"	"Midday"	"514"	5	1	4	10
9845	2011-01-14	"Fri"	"Evening"	"991"	9	9	1	19
9844	2011-01-14	"Fri"	"Midday"	"019"	0	1	9	10
9843	2011-01-13	"Thu"	"Evening"	"277"	2	7	7	16
9842	2011-01-13	"Thu"	"Midday"	"819"	8	1	9	18
9841	2011-01-12	"Wed"	"Evening"	"409"	4	0	9	13
9840	2011-01-12	"Wed"	"Midday"	"166"	1	6	6	13
9839	2011-01-11	"Tue"	"Evening"	"880"	8	8	0	16
9838	2011-01-11	"Tue"	"Midday"	"331"	3	3	1	7
9837	2011-01-10	"Mon"	"Evening"	"322"	3	2	2	7
9836	2011-01-10	"Mon"	"Midday"	"867"	8	6	7	21
9835	2011-01-09	"Sun"	"Evening"	"462"	4	6	2	12
9834	2011-01-09	"Sun"	"Midday"	"988"	9	8	8	25
9833	2011-01-08	"Sat"	"Evening"	"044"	0	4	4	8
9832	2011-01-08	"Sat"	"Midday"	"953"	9	5	3	17
9831	2011-01-07	"Fri"	"Evening"	"867"	8	6	7	21
9830	2011-01-07	"Fri"	"Midday"	"131"	1	3	1	5
9829	2011-01-06	"Thu"	"Evening"	"376"	3	7	6	16
9828	2011-01-06	"Thu"	"Midday"	"932"	9	3	2	14
9827	2011-01-05	"Wed"	"Evening"	"144"	1	4	4	9
9826	2011-01-05	"Wed"	"Midday"	"910"	9	1	0	10
9825	2011-01-04	"Tue"	"Evening"	"116"	1	1	6	8
9824	2011-01-04	"Tue"	"Midday"	"369"	3	6	9	18
9823	2011-01-03	"Mon"	"Evening"	"697"	6	9	7	22
9822	2011-01-03	"Mon"	"Midday"	"526"	5	2	6	13
9821	2011-01-02	"Sun"	"Evening"	"666"	6	6	6	18
9820	2011-01-02	"Sun"	"Midday"	"761"	7	6	1	14
9819	2011-01-01	"Sat"	"Evening"	"247"	2	4	7	13
9818	2011-01-01	"Sat"	"Midday"	"626"	6	2	6	14
9817	2010-12-31	"Fri"	"Evening"	"270"	2	7	0	9
9816	2010-12-31	"Fri"	"Midday"	"105"	1	0	5	6
9815	2010-12-30	"Thu"	"Evening"	"215"	2	1	5	8
9814	2010-12-30	"Thu"	"Midday"	"773"	7	7	3	17
9813	2010-12-29	"Wed"	"Evening"	"212"	2	1	2	5
9812	2010-12-29	"Wed"	"Midday"	"534"	5	3	4	12
9811	2010-12-28	"Tue"	"Evening"	"517"	5	1	7	13
9810	2010-12-28	"Tue"	"Midday"	"258"	2	5	8	15
9809	2010-12-27	"Mon"	"Evening"	"481"	4	8	1	13
9808	2010-12-27	"Mon"	"Midday"	"687"	6	8	7	21
9807	2010-12-26	"Sun"	"Evening"	"690"	6	9	0	15
9806	2010-12-26	"Sun"	"Midday"	"900"	9	0	0	9
9805	2010-12-25	"Sat"	"Evening"	"862"	8	6	2	16
9804	2010-12-25	"Sat"	"Midday"	"449"	4	4	9	17
9803	2010-12-24	"Fri"	"Evening"	"343"	3	4	3	10
9802	2010-12-24	"Fri"	"Midday"	"234"	2	3	4	9
9801	2010-12-23	"Thu"	"Evening"	"283"	2	8	3	13
9800	2010-12-23	"Thu"	"Midday"	"611"	6	1	1	8
9799	2010-12-22	"Wed"	"Evening"	"921"	9	2	1	12
9798	2010-12-22	"Wed"	"Midday"	"112"	1	1	2	4
9797	2010-12-21	"Tue"	"Evening"	"445"	4	4	5	13
9796	2010-12-21	"Tue"	"Midday"	"553"	5	5	3	13
9795	2010-12-20	"Mon"	"Evening"	"072"	0	7	2	9
9794	2010-12-20	"Mon"	"Midday"	"506"	5	0	6	11
9793	2010-12-19	"Sun"	"Evening"	"594"	5	9	4	18
9792	2010-12-19	"Sun"	"Midday"	"168"	1	6	8	15
9791	2010-12-18	"Sat"	"Evening"	"827"	8	2	7	17
9790	2010-12-18	"Sat"	"Midday"	"397"	3	9	7	19
9789	2010-12-17	"Fri"	"Evening"	"448"	4	4	8	16
9788	2010-12-17	"Fri"	"Midday"	"737"	7	3	7	17
9787	2010-12-16	"Thu"	"Evening"	"621"	6	2	1	9
9786	2010-12-16	"Thu"	"Midday"	"091"	0	9	1	10
9785	2010-12-15	"Wed"	"Evening"	"217"	2	1	7	10
9784	2010-12-15	"Wed"	"Midday"	"539"	5	3	9	17
9783	2010-12-14	"Tue"	"Evening"	"130"	1	3	0	4
9782	2010-12-14	"Tue"	"Midday"	"521"	5	2	1	8
9781	2010-12-13	"Mon"	"Evening"	"604"	6	0	4	10
9780	2010-12-13	"Mon"	"Midday"	"677"	6	7	7	20
9779	2010-12-12	"Sun"	"Evening"	"518"	5	1	8	14
9778	2010-12-12	"Sun"	"Midday"	"459"	4	5	9	18
9777	2010-12-11	"Sat"	"Evening"	"273"	2	7	3	12
9776	2010-12-11	"Sat"	"Midday"	"804"	8	0	4	12
9775	2010-12-10	"Fri"	"Evening"	"618"	6	1	8	15
9774	2010-12-10	"Fri"	"Midday"	"244"	2	4	4	10
9773	2010-12-09	"Thu"	"Evening"	"056"	0	5	6	11
9772	2010-12-09	"Thu"	"Midday"	"680"	6	8	0	14
9771	2010-12-08	"Wed"	"Evening"	"943"	9	4	3	16
9770	2010-12-08	"Wed"	"Midday"	"323"	3	2	3	8
9769	2010-12-07	"Tue"	"Evening"	"511"	5	1	1	7
9768	2010-12-07	"Tue"	"Midday"	"696"	6	9	6	21
9767	2010-12-06	"Mon"	"Evening"	"390"	3	9	0	12
9766	2010-12-06	"Mon"	"Midday"	"504"	5	0	4	9
9765	2010-12-05	"Sun"	"Evening"	"636"	6	3	6	15
9764	2010-12-05	"Sun"	"Midday"	"872"	8	7	2	17
9763	2010-12-04	"Sat"	"Evening"	"845"	8	4	5	17
9762	2010-12-04	"Sat"	"Midday"	"523"	5	2	3	10
9761	2010-12-03	"Fri"	"Evening"	"213"	2	1	3	6
9760	2010-12-03	"Fri"	"Midday"	"175"	1	7	5	13
9759	2010-12-02	"Thu"	"Evening"	"863"	8	6	3	17
9758	2010-12-02	"Thu"	"Midday"	"667"	6	6	7	19
9757	2010-12-01	"Wed"	"Evening"	"445"	4	4	5	13
9756	2010-12-01	"Wed"	"Midday"	"495"	4	9	5	18
9755	2010-11-30	"Tue"	"Evening"	"447"	4	4	7	15
9754	2010-11-30	"Tue"	"Midday"	"021"	0	2	1	3
9753	2010-11-29	"Mon"	"Evening"	"726"	7	2	6	15
9752	2010-11-29	"Mon"	"Midday"	"974"	9	7	4	20
9751	2010-11-28	"Sun"	"Evening"	"338"	3	3	8	14
9750	2010-11-28	"Sun"	"Midday"	"637"	6	3	7	16
9749	2010-11-27	"Sat"	"Evening"	"235"	2	3	5	10
9748	2010-11-27	"Sat"	"Midday"	"655"	6	5	5	16
9747	2010-11-26	"Fri"	"Evening"	"089"	0	8	9	17
9746	2010-11-26	"Fri"	"Midday"	"069"	0	6	9	15
9745	2010-11-25	"Thu"	"Evening"	"426"	4	2	6	12
9744	2010-11-25	"Thu"	"Midday"	"244"	2	4	4	10
9743	2010-11-24	"Wed"	"Evening"	"855"	8	5	5	18
9742	2010-11-24	"Wed"	"Midday"	"716"	7	1	6	14
9741	2010-11-23	"Tue"	"Evening"	"043"	0	4	3	7
9740	2010-11-23	"Tue"	"Midday"	"738"	7	3	8	18
9739	2010-11-22	"Mon"	"Evening"	"418"	4	1	8	13
9738	2010-11-22	"Mon"	"Midday"	"696"	6	9	6	21
9737	2010-11-21	"Sun"	"Evening"	"346"	3	4	6	13
9736	2010-11-21	"Sun"	"Midday"	"752"	7	5	2	14
9735	2010-11-20	"Sat"	"Evening"	"608"	6	0	8	14
9734	2010-11-20	"Sat"	"Midday"	"080"	0	8	0	8
9733	2010-11-19	"Fri"	"Evening"	"850"	8	5	0	13
9732	2010-11-19	"Fri"	"Midday"	"134"	1	3	4	8
9731	2010-11-18	"Thu"	"Evening"	"327"	3	2	7	12
9730	2010-11-18	"Thu"	"Midday"	"840"	8	4	0	12
9729	2010-11-17	"Wed"	"Evening"	"773"	7	7	3	17
9728	2010-11-17	"Wed"	"Midday"	"608"	6	0	8	14
9727	2010-11-16	"Tue"	"Evening"	"125"	1	2	5	8
9726	2010-11-16	"Tue"	"Midday"	"017"	0	1	7	8
9725	2010-11-15	"Mon"	"Evening"	"636"	6	3	6	15
9724	2010-11-15	"Mon"	"Midday"	"255"	2	5	5	12
9723	2010-11-14	"Sun"	"Evening"	"776"	7	7	6	20
9722	2010-11-14	"Sun"	"Midday"	"341"	3	4	1	8
9721	2010-11-13	"Sat"	"Evening"	"803"	8	0	3	11
9720	2010-11-13	"Sat"	"Midday"	"993"	9	9	3	21
9719	2010-11-12	"Fri"	"Evening"	"141"	1	4	1	6
9718	2010-11-12	"Fri"	"Midday"	"759"	7	5	9	21
9717	2010-11-11	"Thu"	"Evening"	"155"	1	5	5	11
9716	2010-11-11	"Thu"	"Midday"	"985"	9	8	5	22
9715	2010-11-10	"Wed"	"Evening"	"241"	2	4	1	7
9714	2010-11-10	"Wed"	"Midday"	"998"	9	9	8	26
9713	2010-11-09	"Tue"	"Evening"	"389"	3	8	9	20
9712	2010-11-09	"Tue"	"Midday"	"876"	8	7	6	21
9711	2010-11-08	"Mon"	"Evening"	"812"	8	1	2	11
9710	2010-11-08	"Mon"	"Midday"	"274"	2	7	4	13
9709	2010-11-07	"Sun"	"Evening"	"812"	8	1	2	11
9708	2010-11-07	"Sun"	"Midday"	"045"	0	4	5	9
9707	2010-11-06	"Sat"	"Evening"	"548"	5	4	8	17
9706	2010-11-06	"Sat"	"Midday"	"879"	8	7	9	24
9705	2010-11-05	"Fri"	"Evening"	"737"	7	3	7	17
9704	2010-11-05	"Fri"	"Midday"	"907"	9	0	7	16
9703	2010-11-04	"Thu"	"Evening"	"117"	1	1	7	9
9702	2010-11-04	"Thu"	"Midday"	"551"	5	5	1	11
9701	2010-11-03	"Wed"	"Evening"	"395"	3	9	5	17
9700	2010-11-03	"Wed"	"Midday"	"410"	4	1	0	5
9699	2010-11-02	"Tue"	"Evening"	"793"	7	9	3	19
9698	2010-11-02	"Tue"	"Midday"	"720"	7	2	0	9
9697	2010-11-01	"Mon"	"Evening"	"674"	6	7	4	17
9696	2010-11-01	"Mon"	"Midday"	"951"	9	5	1	15
9695	2010-10-31	"Sun"	"Evening"	"076"	0	7	6	13
9694	2010-10-31	"Sun"	"Midday"	"803"	8	0	3	11
9693	2010-10-30	"Sat"	"Evening"	"956"	9	5	6	20
9692	2010-10-30	"Sat"	"Midday"	"962"	9	6	2	17
9691	2010-10-29	"Fri"	"Evening"	"729"	7	2	9	18
9690	2010-10-29	"Fri"	"Midday"	"881"	8	8	1	17
9689	2010-10-28	"Thu"	"Evening"	"746"	7	4	6	17
9688	2010-10-28	"Thu"	"Midday"	"614"	6	1	4	11
9687	2010-10-27	"Wed"	"Evening"	"058"	0	5	8	13
9686	2010-10-27	"Wed"	"Midday"	"991"	9	9	1	19
9685	2010-10-26	"Tue"	"Evening"	"390"	3	9	0	12
9684	2010-10-26	"Tue"	"Midday"	"368"	3	6	8	17
9683	2010-10-25	"Mon"	"Evening"	"990"	9	9	0	18
9682	2010-10-25	"Mon"	"Midday"	"755"	7	5	5	17
9681	2010-10-24	"Sun"	"Evening"	"190"	1	9	0	10
9680	2010-10-24	"Sun"	"Midday"	"958"	9	5	8	22
9679	2010-10-23	"Sat"	"Evening"	"180"	1	8	0	9
9678	2010-10-23	"Sat"	"Midday"	"712"	7	1	2	10
9677	2010-10-22	"Fri"	"Evening"	"533"	5	3	3	11
9676	2010-10-22	"Fri"	"Midday"	"438"	4	3	8	15
9675	2010-10-21	"Thu"	"Evening"	"239"	2	3	9	14
9674	2010-10-21	"Thu"	"Midday"	"439"	4	3	9	16
9673	2010-10-20	"Wed"	"Evening"	"983"	9	8	3	20
9672	2010-10-20	"Wed"	"Midday"	"659"	6	5	9	20
9671	2010-10-19	"Tue"	"Evening"	"760"	7	6	0	13
9670	2010-10-19	"Tue"	"Midday"	"341"	3	4	1	8
9669	2010-10-18	"Mon"	"Evening"	"948"	9	4	8	21
9668	2010-10-18	"Mon"	"Midday"	"909"	9	0	9	18
9667	2010-10-17	"Sun"	"Evening"	"863"	8	6	3	17
9666	2010-10-17	"Sun"	"Midday"	"164"	1	6	4	11
9665	2010-10-16	"Sat"	"Evening"	"999"	9	9	9	27
9664	2010-10-16	"Sat"	"Midday"	"236"	2	3	6	11
9663	2010-10-15	"Fri"	"Evening"	"402"	4	0	2	6
9662	2010-10-15	"Fri"	"Midday"	"036"	0	3	6	9
9661	2010-10-14	"Thu"	"Evening"	"517"	5	1	7	13
9660	2010-10-14	"Thu"	"Midday"	"593"	5	9	3	17
9659	2010-10-13	"Wed"	"Evening"	"140"	1	4	0	5
9658	2010-10-13	"Wed"	"Midday"	"710"	7	1	0	8
9657	2010-10-12	"Tue"	"Evening"	"621"	6	2	1	9
9656	2010-10-12	"Tue"	"Midday"	"116"	1	1	6	8
9655	2010-10-11	"Mon"	"Evening"	"916"	9	1	6	16
9654	2010-10-11	"Mon"	"Midday"	"677"	6	7	7	20
9653	2010-10-10	"Sun"	"Evening"	"976"	9	7	6	22
9652	2010-10-10	"Sun"	"Midday"	"761"	7	6	1	14
9651	2010-10-09	"Sat"	"Evening"	"479"	4	7	9	20
9650	2010-10-09	"Sat"	"Midday"	"215"	2	1	5	8
9649	2010-10-08	"Fri"	"Evening"	"525"	5	2	5	12
9648	2010-10-08	"Fri"	"Midday"	"594"	5	9	4	18
9647	2010-10-07	"Thu"	"Evening"	"530"	5	3	0	8
9646	2010-10-07	"Thu"	"Midday"	"395"	3	9	5	17
9645	2010-10-06	"Wed"	"Evening"	"776"	7	7	6	20
9644	2010-10-06	"Wed"	"Midday"	"137"	1	3	7	11
9643	2010-10-05	"Tue"	"Evening"	"284"	2	8	4	14
9642	2010-10-05	"Tue"	"Midday"	"720"	7	2	0	9
9641	2010-10-04	"Mon"	"Evening"	"651"	6	5	1	12
9640	2010-10-04	"Mon"	"Midday"	"425"	4	2	5	11
9639	2010-10-03	"Sun"	"Evening"	"413"	4	1	3	8
9638	2010-10-03	"Sun"	"Midday"	"004"	0	0	4	4
9637	2010-10-02	"Sat"	"Evening"	"191"	1	9	1	11
9636	2010-10-02	"Sat"	"Midday"	"101"	1	0	1	2
9635	2010-10-01	"Fri"	"Evening"	"806"	8	0	6	14
9634	2010-10-01	"Fri"	"Midday"	"177"	1	7	7	15
9633	2010-09-30	"Thu"	"Evening"	"944"	9	4	4	17
9632	2010-09-30	"Thu"	"Midday"	"597"	5	9	7	21
9631	2010-09-29	"Wed"	"Evening"	"868"	8	6	8	22
9630	2010-09-29	"Wed"	"Midday"	"813"	8	1	3	12
9629	2010-09-28	"Tue"	"Evening"	"546"	5	4	6	15
9628	2010-09-28	"Tue"	"Midday"	"618"	6	1	8	15
9627	2010-09-27	"Mon"	"Evening"	"854"	8	5	4	17
9626	2010-09-27	"Mon"	"Midday"	"456"	4	5	6	15
9625	2010-09-26	"Sun"	"Evening"	"178"	1	7	8	16
9624	2010-09-26	"Sun"	"Midday"	"790"	7	9	0	16
9623	2010-09-25	"Sat"	"Evening"	"380"	3	8	0	11
9622	2010-09-25	"Sat"	"Midday"	"772"	7	7	2	16
9621	2010-09-24	"Fri"	"Evening"	"677"	6	7	7	20
9620	2010-09-24	"Fri"	"Midday"	"445"	4	4	5	13
9619	2010-09-23	"Thu"	"Evening"	"868"	8	6	8	22
9618	2010-09-23	"Thu"	"Midday"	"299"	2	9	9	20
9617	2010-09-22	"Wed"	"Evening"	"122"	1	2	2	5
9616	2010-09-22	"Wed"	"Midday"	"899"	8	9	9	26
9615	2010-09-21	"Tue"	"Evening"	"655"	6	5	5	16
9614	2010-09-21	"Tue"	"Midday"	"233"	2	3	3	8
9613	2010-09-20	"Mon"	"Evening"	"075"	0	7	5	12
9612	2010-09-20	"Mon"	"Midday"	"172"	1	7	2	10
9611	2010-09-19	"Sun"	"Evening"	"259"	2	5	9	16
9610	2010-09-19	"Sun"	"Midday"	"074"	0	7	4	11
9609	2010-09-18	"Sat"	"Evening"	"261"	2	6	1	9
9608	2010-09-18	"Sat"	"Midday"	"451"	4	5	1	10
9607	2010-09-17	"Fri"	"Evening"	"626"	6	2	6	14
9606	2010-09-17	"Fri"	"Midday"	"406"	4	0	6	10
9605	2010-09-16	"Thu"	"Evening"	"004"	0	0	4	4
9604	2010-09-16	"Thu"	"Midday"	"754"	7	5	4	16
9603	2010-09-15	"Wed"	"Evening"	"142"	1	4	2	7
9602	2010-09-15	"Wed"	"Midday"	"672"	6	7	2	15
9601	2010-09-14	"Tue"	"Evening"	"458"	4	5	8	17
9600	2010-09-14	"Tue"	"Midday"	"322"	3	2	2	7
9599	2010-09-13	"Mon"	"Evening"	"344"	3	4	4	11
9598	2010-09-13	"Mon"	"Midday"	"357"	3	5	7	15
9597	2010-09-12	"Sun"	"Evening"	"783"	7	8	3	18
9596	2010-09-12	"Sun"	"Midday"	"121"	1	2	1	4
9595	2010-09-11	"Sat"	"Evening"	"265"	2	6	5	13
9594	2010-09-11	"Sat"	"Midday"	"391"	3	9	1	13
9593	2010-09-10	"Fri"	"Evening"	"798"	7	9	8	24
9592	2010-09-10	"Fri"	"Midday"	"203"	2	0	3	5
9591	2010-09-09	"Thu"	"Evening"	"673"	6	7	3	16
9590	2010-09-09	"Thu"	"Midday"	"871"	8	7	1	16
9589	2010-09-08	"Wed"	"Evening"	"923"	9	2	3	14
9588	2010-09-08	"Wed"	"Midday"	"322"	3	2	2	7
9587	2010-09-07	"Tue"	"Evening"	"247"	2	4	7	13
9586	2010-09-07	"Tue"	"Midday"	"736"	7	3	6	16
9585	2010-09-06	"Mon"	"Evening"	"174"	1	7	4	12
9584	2010-09-06	"Mon"	"Midday"	"307"	3	0	7	10
9583	2010-09-05	"Sun"	"Evening"	"247"	2	4	7	13
9582	2010-09-05	"Sun"	"Midday"	"629"	6	2	9	17
9581	2010-09-04	"Sat"	"Evening"	"955"	9	5	5	19
9580	2010-09-04	"Sat"	"Midday"	"932"	9	3	2	14
9579	2010-09-03	"Fri"	"Evening"	"158"	1	5	8	14
9578	2010-09-03	"Fri"	"Midday"	"109"	1	0	9	10
9577	2010-09-02	"Thu"	"Evening"	"736"	7	3	6	16
9576	2010-09-02	"Thu"	"Midday"	"624"	6	2	4	12
9575	2010-09-01	"Wed"	"Evening"	"781"	7	8	1	16
9574	2010-09-01	"Wed"	"Midday"	"447"	4	4	7	15
9573	2010-08-31	"Tue"	"Evening"	"246"	2	4	6	12
9572	2010-08-31	"Tue"	"Midday"	"082"	0	8	2	10
9571	2010-08-30	"Mon"	"Evening"	"145"	1	4	5	10
9570	2010-08-30	"Mon"	"Midday"	"818"	8	1	8	17
9569	2010-08-29	"Sun"	"Evening"	"606"	6	0	6	12
9568	2010-08-29	"Sun"	"Midday"	"839"	8	3	9	20
9567	2010-08-28	"Sat"	"Evening"	"357"	3	5	7	15
9566	2010-08-28	"Sat"	"Midday"	"325"	3	2	5	10
9565	2010-08-27	"Fri"	"Evening"	"916"	9	1	6	16
9564	2010-08-27	"Fri"	"Midday"	"139"	1	3	9	13
9563	2010-08-26	"Thu"	"Evening"	"926"	9	2	6	17
9562	2010-08-26	"Thu"	"Midday"	"789"	7	8	9	24
9561	2010-08-25	"Wed"	"Evening"	"398"	3	9	8	20
9560	2010-08-25	"Wed"	"Midday"	"354"	3	5	4	12
9559	2010-08-24	"Tue"	"Evening"	"580"	5	8	0	13
9558	2010-08-24	"Tue"	"Midday"	"346"	3	4	6	13
9557	2010-08-23	"Mon"	"Evening"	"571"	5	7	1	13
9556	2010-08-23	"Mon"	"Midday"	"791"	7	9	1	17
9555	2010-08-22	"Sun"	"Evening"	"422"	4	2	2	8
9554	2010-08-22	"Sun"	"Midday"	"388"	3	8	8	19
9553	2010-08-21	"Sat"	"Evening"	"988"	9	8	8	25
9552	2010-08-21	"Sat"	"Midday"	"579"	5	7	9	21
9551	2010-08-20	"Fri"	"Evening"	"755"	7	5	5	17
9550	2010-08-20	"Fri"	"Midday"	"377"	3	7	7	17
9549	2010-08-19	"Thu"	"Evening"	"116"	1	1	6	8
9548	2010-08-19	"Thu"	"Midday"	"429"	4	2	9	15
9547	2010-08-18	"Wed"	"Evening"	"468"	4	6	8	18
9546	2010-08-18	"Wed"	"Midday"	"547"	5	4	7	16
9545	2010-08-17	"Tue"	"Evening"	"470"	4	7	0	11
9544	2010-08-17	"Tue"	"Midday"	"886"	8	8	6	22
9543	2010-08-16	"Mon"	"Evening"	"903"	9	0	3	12
9542	2010-08-16	"Mon"	"Midday"	"339"	3	3	9	15
9541	2010-08-15	"Sun"	"Evening"	"714"	7	1	4	12
9540	2010-08-15	"Sun"	"Midday"	"415"	4	1	5	10
9539	2010-08-14	"Sat"	"Evening"	"713"	7	1	3	11
9538	2010-08-14	"Sat"	"Midday"	"289"	2	8	9	19
9537	2010-08-13	"Fri"	"Evening"	"092"	0	9	2	11
9536	2010-08-13	"Fri"	"Midday"	"303"	3	0	3	6
9535	2010-08-12	"Thu"	"Evening"	"006"	0	0	6	6
9534	2010-08-12	"Thu"	"Midday"	"320"	3	2	0	5
9533	2010-08-11	"Wed"	"Evening"	"888"	8	8	8	24
9532	2010-08-11	"Wed"	"Midday"	"261"	2	6	1	9
9531	2010-08-10	"Tue"	"Evening"	"394"	3	9	4	16
9530	2010-08-10	"Tue"	"Midday"	"343"	3	4	3	10
9529	2010-08-09	"Mon"	"Evening"	"892"	8	9	2	19
9528	2010-08-09	"Mon"	"Midday"	"155"	1	5	5	11
9527	2010-08-08	"Sun"	"Evening"	"078"	0	7	8	15
9526	2010-08-08	"Sun"	"Midday"	"730"	7	3	0	10
9525	2010-08-07	"Sat"	"Evening"	"246"	2	4	6	12
9524	2010-08-07	"Sat"	"Midday"	"756"	7	5	6	18
9523	2010-08-06	"Fri"	"Evening"	"730"	7	3	0	10
9522	2010-08-06	"Fri"	"Midday"	"453"	4	5	3	12
9521	2010-08-05	"Thu"	"Evening"	"405"	4	0	5	9
9520	2010-08-05	"Thu"	"Midday"	"767"	7	6	7	20
9519	2010-08-04	"Wed"	"Evening"	"165"	1	6	5	12
9518	2010-08-04	"Wed"	"Midday"	"585"	5	8	5	18
9517	2010-08-03	"Tue"	"Evening"	"489"	4	8	9	21
9516	2010-08-03	"Tue"	"Midday"	"107"	1	0	7	8
9515	2010-08-02	"Mon"	"Evening"	"633"	6	3	3	12
9514	2010-08-02	"Mon"	"Midday"	"588"	5	8	8	21
9513	2010-08-01	"Sun"	"Evening"	"582"	5	8	2	15
9512	2010-08-01	"Sun"	"Midday"	"595"	5	9	5	19
9511	2010-07-31	"Sat"	"Evening"	"333"	3	3	3	9
9510	2010-07-31	"Sat"	"Midday"	"201"	2	0	1	3
9509	2010-07-30	"Fri"	"Evening"	"329"	3	2	9	14
9508	2010-07-30	"Fri"	"Midday"	"350"	3	5	0	8
9507	2010-07-29	"Thu"	"Evening"	"004"	0	0	4	4
9506	2010-07-29	"Thu"	"Midday"	"794"	7	9	4	20
9505	2010-07-28	"Wed"	"Evening"	"960"	9	6	0	15
9504	2010-07-28	"Wed"	"Midday"	"167"	1	6	7	14
9503	2010-07-27	"Tue"	"Evening"	"661"	6	6	1	13
9502	2010-07-27	"Tue"	"Midday"	"321"	3	2	1	6
9501	2010-07-26	"Mon"	"Evening"	"227"	2	2	7	11
9500	2010-07-26	"Mon"	"Midday"	"843"	8	4	3	15
9499	2010-07-25	"Sun"	"Evening"	"593"	5	9	3	17
9498	2010-07-25	"Sun"	"Midday"	"340"	3	4	0	7
9497	2010-07-24	"Sat"	"Evening"	"989"	9	8	9	26
9496	2010-07-24	"Sat"	"Midday"	"484"	4	8	4	16
9495	2010-07-23	"Fri"	"Evening"	"602"	6	0	2	8
9494	2010-07-23	"Fri"	"Midday"	"266"	2	6	6	14
9493	2010-07-22	"Thu"	"Evening"	"220"	2	2	0	4
9492	2010-07-22	"Thu"	"Midday"	"037"	0	3	7	10
9491	2010-07-21	"Wed"	"Evening"	"364"	3	6	4	13
9490	2010-07-21	"Wed"	"Midday"	"653"	6	5	3	14
9489	2010-07-20	"Tue"	"Evening"	"938"	9	3	8	20
9488	2010-07-20	"Tue"	"Midday"	"130"	1	3	0	4
9487	2010-07-19	"Mon"	"Evening"	"958"	9	5	8	22
9486	2010-07-19	"Mon"	"Midday"	"218"	2	1	8	11
9485	2010-07-18	"Sun"	"Evening"	"968"	9	6	8	23
9484	2010-07-18	"Sun"	"Midday"	"656"	6	5	6	17
9483	2010-07-17	"Sat"	"Evening"	"736"	7	3	6	16
9482	2010-07-17	"Sat"	"Midday"	"543"	5	4	3	12
9481	2010-07-16	"Fri"	"Evening"	"866"	8	6	6	20
9480	2010-07-16	"Fri"	"Midday"	"225"	2	2	5	9
9479	2010-07-15	"Thu"	"Evening"	"580"	5	8	0	13
9478	2010-07-15	"Thu"	"Midday"	"793"	7	9	3	19
9477	2010-07-14	"Wed"	"Evening"	"788"	7	8	8	23
9476	2010-07-14	"Wed"	"Midday"	"174"	1	7	4	12
9475	2010-07-13	"Tue"	"Evening"	"997"	9	9	7	25
9474	2010-07-13	"Tue"	"Midday"	"059"	0	5	9	14
9473	2010-07-12	"Mon"	"Evening"	"195"	1	9	5	15
9472	2010-07-12	"Mon"	"Midday"	"084"	0	8	4	12
9471	2010-07-11	"Sun"	"Evening"	"203"	2	0	3	5
9470	2010-07-11	"Sun"	"Midday"	"940"	9	4	0	13
9469	2010-07-10	"Sat"	"Evening"	"191"	1	9	1	11
9468	2010-07-10	"Sat"	"Midday"	"315"	3	1	5	9
9467	2010-07-09	"Fri"	"Evening"	"051"	0	5	1	6
9466	2010-07-09	"Fri"	"Midday"	"940"	9	4	0	13
9465	2010-07-08	"Thu"	"Evening"	"726"	7	2	6	15
9464	2010-07-08	"Thu"	"Midday"	"585"	5	8	5	18
9463	2010-07-07	"Wed"	"Evening"	"779"	7	7	9	23
9462	2010-07-07	"Wed"	"Midday"	"677"	6	7	7	20
9461	2010-07-06	"Tue"	"Evening"	"402"	4	0	2	6
9460	2010-07-06	"Tue"	"Midday"	"330"	3	3	0	6
9459	2010-07-05	"Mon"	"Evening"	"043"	0	4	3	7
9458	2010-07-05	"Mon"	"Midday"	"157"	1	5	7	13
9457	2010-07-04	"Sun"	"Evening"	"039"	0	3	9	12
9456	2010-07-04	"Sun"	"Midday"	"967"	9	6	7	22
9455	2010-07-03	"Sat"	"Evening"	"494"	4	9	4	17
9454	2010-07-03	"Sat"	"Midday"	"172"	1	7	2	10
9453	2010-07-02	"Fri"	"Evening"	"835"	8	3	5	16
9452	2010-07-02	"Fri"	"Midday"	"098"	0	9	8	17
9451	2010-07-01	"Thu"	"Evening"	"372"	3	7	2	12
9450	2010-07-01	"Thu"	"Midday"	"675"	6	7	5	18
9449	2010-06-30	"Wed"	"Evening"	"888"	8	8	8	24
9448	2010-06-30	"Wed"	"Midday"	"121"	1	2	1	4
9447	2010-06-29	"Tue"	"Evening"	"474"	4	7	4	15
9446	2010-06-29	"Tue"	"Midday"	"827"	8	2	7	17
9445	2010-06-28	"Mon"	"Evening"	"246"	2	4	6	12
9444	2010-06-28	"Mon"	"Midday"	"674"	6	7	4	17
9443	2010-06-27	"Sun"	"Evening"	"053"	0	5	3	8
9442	2010-06-27	"Sun"	"Midday"	"546"	5	4	6	15
9441	2010-06-26	"Sat"	"Evening"	"482"	4	8	2	14
9440	2010-06-26	"Sat"	"Midday"	"247"	2	4	7	13
9439	2010-06-25	"Fri"	"Evening"	"811"	8	1	1	10
9438	2010-06-25	"Fri"	"Midday"	"771"	7	7	1	15
9437	2010-06-24	"Thu"	"Evening"	"928"	9	2	8	19
9436	2010-06-24	"Thu"	"Midday"	"680"	6	8	0	14
9435	2010-06-23	"Wed"	"Evening"	"914"	9	1	4	14
9434	2010-06-23	"Wed"	"Midday"	"696"	6	9	6	21
9433	2010-06-22	"Tue"	"Evening"	"252"	2	5	2	9
9432	2010-06-22	"Tue"	"Midday"	"886"	8	8	6	22
9431	2010-06-21	"Mon"	"Evening"	"287"	2	8	7	17
9430	2010-06-21	"Mon"	"Midday"	"145"	1	4	5	10
9429	2010-06-20	"Sun"	"Evening"	"230"	2	3	0	5
9428	2010-06-20	"Sun"	"Midday"	"286"	2	8	6	16
9427	2010-06-19	"Sat"	"Evening"	"683"	6	8	3	17
9426	2010-06-19	"Sat"	"Midday"	"495"	4	9	5	18
9425	2010-06-18	"Fri"	"Evening"	"152"	1	5	2	8
9424	2010-06-18	"Fri"	"Midday"	"188"	1	8	8	17
9423	2010-06-17	"Thu"	"Evening"	"133"	1	3	3	7
9422	2010-06-17	"Thu"	"Midday"	"712"	7	1	2	10
9421	2010-06-16	"Wed"	"Evening"	"689"	6	8	9	23
9420	2010-06-16	"Wed"	"Midday"	"535"	5	3	5	13
9419	2010-06-15	"Tue"	"Evening"	"256"	2	5	6	13
9418	2010-06-15	"Tue"	"Midday"	"723"	7	2	3	12
9417	2010-06-14	"Mon"	"Evening"	"108"	1	0	8	9
9416	2010-06-14	"Mon"	"Midday"	"326"	3	2	6	11
9415	2010-06-13	"Sun"	"Evening"	"326"	3	2	6	11
9414	2010-06-13	"Sun"	"Midday"	"344"	3	4	4	11
9413	2010-06-12	"Sat"	"Evening"	"279"	2	7	9	18
9412	2010-06-12	"Sat"	"Midday"	"923"	9	2	3	14
9411	2010-06-11	"Fri"	"Evening"	"800"	8	0	0	8
9410	2010-06-11	"Fri"	"Midday"	"476"	4	7	6	17
9409	2010-06-10	"Thu"	"Evening"	"603"	6	0	3	9
9408	2010-06-10	"Thu"	"Midday"	"303"	3	0	3	6
9407	2010-06-09	"Wed"	"Evening"	"494"	4	9	4	17
9406	2010-06-09	"Wed"	"Midday"	"479"	4	7	9	20
9405	2010-06-08	"Tue"	"Evening"	"691"	6	9	1	16
9404	2010-06-08	"Tue"	"Midday"	"891"	8	9	1	18
9403	2010-06-07	"Mon"	"Evening"	"393"	3	9	3	15
9402	2010-06-07	"Mon"	"Midday"	"578"	5	7	8	20
9401	2010-06-06	"Sun"	"Evening"	"397"	3	9	7	19
9400	2010-06-06	"Sun"	"Midday"	"934"	9	3	4	16
9399	2010-06-05	"Sat"	"Evening"	"945"	9	4	5	18
9398	2010-06-05	"Sat"	"Midday"	"781"	7	8	1	16
9397	2010-06-04	"Fri"	"Evening"	"527"	5	2	7	14
9396	2010-06-04	"Fri"	"Midday"	"076"	0	7	6	13
9395	2010-06-03	"Thu"	"Evening"	"918"	9	1	8	18
9394	2010-06-03	"Thu"	"Midday"	"160"	1	6	0	7
9393	2010-06-02	"Wed"	"Evening"	"828"	8	2	8	18
9392	2010-06-02	"Wed"	"Midday"	"752"	7	5	2	14
9391	2010-06-01	"Tue"	"Evening"	"585"	5	8	5	18
9390	2010-06-01	"Tue"	"Midday"	"627"	6	2	7	15
9389	2010-05-31	"Mon"	"Evening"	"812"	8	1	2	11
9388	2010-05-31	"Mon"	"Midday"	"465"	4	6	5	15
9387	2010-05-30	"Sun"	"Evening"	"662"	6	6	2	14
9386	2010-05-30	"Sun"	"Midday"	"007"	0	0	7	7
9385	2010-05-29	"Sat"	"Evening"	"992"	9	9	2	20
9384	2010-05-29	"Sat"	"Midday"	"790"	7	9	0	16
9383	2010-05-28	"Fri"	"Evening"	"333"	3	3	3	9
9382	2010-05-28	"Fri"	"Midday"	"381"	3	8	1	12
9381	2010-05-27	"Thu"	"Evening"	"318"	3	1	8	12
9380	2010-05-27	"Thu"	"Midday"	"201"	2	0	1	3
9379	2010-05-26	"Wed"	"Evening"	"335"	3	3	5	11
9378	2010-05-26	"Wed"	"Midday"	"591"	5	9	1	15
9377	2010-05-25	"Tue"	"Evening"	"543"	5	4	3	12
9376	2010-05-25	"Tue"	"Midday"	"014"	0	1	4	5
9375	2010-05-24	"Mon"	"Evening"	"867"	8	6	7	21
9374	2010-05-24	"Mon"	"Midday"	"251"	2	5	1	8
9373	2010-05-23	"Sun"	"Evening"	"334"	3	3	4	10
9372	2010-05-23	"Sun"	"Midday"	"454"	4	5	4	13
9371	2010-05-22	"Sat"	"Evening"	"431"	4	3	1	8
9370	2010-05-22	"Sat"	"Midday"	"092"	0	9	2	11
9369	2010-05-21	"Fri"	"Evening"	"582"	5	8	2	15
9368	2010-05-21	"Fri"	"Midday"	"825"	8	2	5	15
9367	2010-05-20	"Thu"	"Evening"	"251"	2	5	1	8
9366	2010-05-20	"Thu"	"Midday"	"756"	7	5	6	18
9365	2010-05-19	"Wed"	"Evening"	"196"	1	9	6	16
9364	2010-05-19	"Wed"	"Midday"	"675"	6	7	5	18
9363	2010-05-18	"Tue"	"Evening"	"874"	8	7	4	19
9362	2010-05-18	"Tue"	"Midday"	"668"	6	6	8	20
9361	2010-05-17	"Mon"	"Evening"	"851"	8	5	1	14
9360	2010-05-17	"Mon"	"Midday"	"702"	7	0	2	9
9359	2010-05-16	"Sun"	"Evening"	"695"	6	9	5	20
9358	2010-05-16	"Sun"	"Midday"	"976"	9	7	6	22
9357	2010-05-15	"Sat"	"Evening"	"250"	2	5	0	7
9356	2010-05-15	"Sat"	"Midday"	"322"	3	2	2	7
9355	2010-05-14	"Fri"	"Evening"	"161"	1	6	1	8
9354	2010-05-14	"Fri"	"Midday"	"909"	9	0	9	18
9353	2010-05-13	"Thu"	"Evening"	"602"	6	0	2	8
9352	2010-05-13	"Thu"	"Midday"	"495"	4	9	5	18
9351	2010-05-12	"Wed"	"Evening"	"241"	2	4	1	7
9350	2010-05-12	"Wed"	"Midday"	"483"	4	8	3	15
9349	2010-05-11	"Tue"	"Evening"	"370"	3	7	0	10
9348	2010-05-11	"Tue"	"Midday"	"039"	0	3	9	12
9347	2010-05-10	"Mon"	"Evening"	"022"	0	2	2	4
9346	2010-05-10	"Mon"	"Midday"	"286"	2	8	6	16
9345	2010-05-09	"Sun"	"Evening"	"530"	5	3	0	8
9344	2010-05-09	"Sun"	"Midday"	"788"	7	8	8	23
9343	2010-05-08	"Sat"	"Evening"	"985"	9	8	5	22
9342	2010-05-08	"Sat"	"Midday"	"750"	7	5	0	12
9341	2010-05-07	"Fri"	"Evening"	"727"	7	2	7	16
9340	2010-05-07	"Fri"	"Midday"	"403"	4	0	3	7
9339	2010-05-06	"Thu"	"Evening"	"716"	7	1	6	14
9338	2010-05-06	"Thu"	"Midday"	"907"	9	0	7	16
9337	2010-05-05	"Wed"	"Evening"	"621"	6	2	1	9
9336	2010-05-05	"Wed"	"Midday"	"822"	8	2	2	12
9335	2010-05-04	"Tue"	"Evening"	"731"	7	3	1	11
9334	2010-05-04	"Tue"	"Midday"	"800"	8	0	0	8
9333	2010-05-03	"Mon"	"Evening"	"158"	1	5	8	14
9332	2010-05-03	"Mon"	"Midday"	"329"	3	2	9	14
9331	2010-05-02	"Sun"	"Evening"	"138"	1	3	8	12
9330	2010-05-02	"Sun"	"Midday"	"719"	7	1	9	17
9329	2010-05-01	"Sat"	"Evening"	"485"	4	8	5	17
9328	2010-05-01	"Sat"	"Midday"	"122"	1	2	2	5
9327	2010-04-30	"Fri"	"Evening"	"853"	8	5	3	16
9326	2010-04-30	"Fri"	"Midday"	"611"	6	1	1	8
9325	2010-04-29	"Thu"	"Evening"	"393"	3	9	3	15
9324	2010-04-29	"Thu"	"Midday"	"417"	4	1	7	12
9323	2010-04-28	"Wed"	"Evening"	"617"	6	1	7	14
9322	2010-04-28	"Wed"	"Midday"	"254"	2	5	4	11
9321	2010-04-27	"Tue"	"Evening"	"436"	4	3	6	13
9320	2010-04-27	"Tue"	"Midday"	"365"	3	6	5	14
9319	2010-04-26	"Mon"	"Evening"	"341"	3	4	1	8
9318	2010-04-26	"Mon"	"Midday"	"883"	8	8	3	19
9317	2010-04-25	"Sun"	"Evening"	"528"	5	2	8	15
9316	2010-04-25	"Sun"	"Midday"	"692"	6	9	2	17
9315	2010-04-24	"Sat"	"Evening"	"657"	6	5	7	18
9314	2010-04-24	"Sat"	"Midday"	"265"	2	6	5	13
9313	2010-04-23	"Fri"	"Evening"	"569"	5	6	9	20
9312	2010-04-23	"Fri"	"Midday"	"731"	7	3	1	11
9311	2010-04-22	"Thu"	"Evening"	"364"	3	6	4	13
9310	2010-04-22	"Thu"	"Midday"	"850"	8	5	0	13
9309	2010-04-21	"Wed"	"Evening"	"858"	8	5	8	21
9308	2010-04-21	"Wed"	"Midday"	"686"	6	8	6	20
9307	2010-04-20	"Tue"	"Evening"	"596"	5	9	6	20
9306	2010-04-20	"Tue"	"Midday"	"149"	1	4	9	14
9305	2010-04-19	"Mon"	"Evening"	"471"	4	7	1	12
9304	2010-04-19	"Mon"	"Midday"	"572"	5	7	2	14
9303	2010-04-18	"Sun"	"Evening"	"390"	3	9	0	12
9302	2010-04-18	"Sun"	"Midday"	"447"	4	4	7	15
9301	2010-04-17	"Sat"	"Evening"	"341"	3	4	1	8
9300	2010-04-17	"Sat"	"Midday"	"181"	1	8	1	10
9299	2010-04-16	"Fri"	"Evening"	"365"	3	6	5	14
9298	2010-04-16	"Fri"	"Midday"	"191"	1	9	1	11
9297	2010-04-15	"Thu"	"Evening"	"236"	2	3	6	11
9296	2010-04-15	"Thu"	"Midday"	"464"	4	6	4	14
9295	2010-04-14	"Wed"	"Evening"	"398"	3	9	8	20
9294	2010-04-14	"Wed"	"Midday"	"020"	0	2	0	2
9293	2010-04-13	"Tue"	"Evening"	"598"	5	9	8	22
9292	2010-04-13	"Tue"	"Midday"	"159"	1	5	9	15
9291	2010-04-12	"Mon"	"Evening"	"500"	5	0	0	5
9290	2010-04-12	"Mon"	"Midday"	"384"	3	8	4	15
9289	2010-04-11	"Sun"	"Evening"	"227"	2	2	7	11
9288	2010-04-11	"Sun"	"Midday"	"637"	6	3	7	16
9287	2010-04-10	"Sat"	"Evening"	"030"	0	3	0	3
9286	2010-04-10	"Sat"	"Midday"	"840"	8	4	0	12
9285	2010-04-09	"Fri"	"Evening"	"040"	0	4	0	4
9284	2010-04-09	"Fri"	"Midday"	"249"	2	4	9	15
9283	2010-04-08	"Thu"	"Evening"	"090"	0	9	0	9
9282	2010-04-08	"Thu"	"Midday"	"370"	3	7	0	10
9281	2010-04-07	"Wed"	"Evening"	"418"	4	1	8	13
9280	2010-04-07	"Wed"	"Midday"	"226"	2	2	6	10
9279	2010-04-06	"Tue"	"Evening"	"928"	9	2	8	19
9278	2010-04-06	"Tue"	"Midday"	"331"	3	3	1	7
9277	2010-04-05	"Mon"	"Evening"	"202"	2	0	2	4
9276	2010-04-05	"Mon"	"Midday"	"167"	1	6	7	14
9275	2010-04-04	"Sun"	"Evening"	"260"	2	6	0	8
9274	2010-04-04	"Sun"	"Midday"	"486"	4	8	6	18
9273	2010-04-03	"Sat"	"Evening"	"523"	5	2	3	10
9272	2010-04-03	"Sat"	"Midday"	"560"	5	6	0	11
9271	2010-04-02	"Fri"	"Evening"	"594"	5	9	4	18
9270	2010-04-02	"Fri"	"Midday"	"832"	8	3	2	13
9269	2010-04-01	"Thu"	"Evening"	"540"	5	4	0	9
9268	2010-04-01	"Thu"	"Midday"	"931"	9	3	1	13
9267	2010-03-31	"Wed"	"Evening"	"013"	0	1	3	4
9266	2010-03-31	"Wed"	"Midday"	"708"	7	0	8	15
9265	2010-03-30	"Tue"	"Evening"	"366"	3	6	6	15
9264	2010-03-30	"Tue"	"Midday"	"453"	4	5	3	12
9263	2010-03-29	"Mon"	"Evening"	"372"	3	7	2	12
9262	2010-03-29	"Mon"	"Midday"	"038"	0	3	8	11
9261	2010-03-28	"Sun"	"Evening"	"954"	9	5	4	18
9260	2010-03-28	"Sun"	"Midday"	"020"	0	2	0	2
9259	2010-03-27	"Sat"	"Evening"	"362"	3	6	2	11
9258	2010-03-27	"Sat"	"Midday"	"028"	0	2	8	10
9257	2010-03-26	"Fri"	"Evening"	"421"	4	2	1	7
9256	2010-03-26	"Fri"	"Midday"	"750"	7	5	0	12
9255	2010-03-25	"Thu"	"Evening"	"121"	1	2	1	4
9254	2010-03-25	"Thu"	"Midday"	"991"	9	9	1	19
9253	2010-03-24	"Wed"	"Evening"	"966"	9	6	6	21
9252	2010-03-24	"Wed"	"Midday"	"384"	3	8	4	15
9251	2010-03-23	"Tue"	"Evening"	"225"	2	2	5	9
9250	2010-03-23	"Tue"	"Midday"	"120"	1	2	0	3
9249	2010-03-22	"Mon"	"Evening"	"316"	3	1	6	10
9248	2010-03-22	"Mon"	"Midday"	"427"	4	2	7	13
9247	2010-03-21	"Sun"	"Evening"	"468"	4	6	8	18
9246	2010-03-21	"Sun"	"Midday"	"665"	6	6	5	17
9245	2010-03-20	"Sat"	"Evening"	"900"	9	0	0	9
9244	2010-03-20	"Sat"	"Midday"	"647"	6	4	7	17
9243	2010-03-19	"Fri"	"Evening"	"539"	5	3	9	17
9242	2010-03-19	"Fri"	"Midday"	"457"	4	5	7	16
9241	2010-03-18	"Thu"	"Evening"	"437"	4	3	7	14
9240	2010-03-18	"Thu"	"Midday"	"805"	8	0	5	13
9239	2010-03-17	"Wed"	"Evening"	"378"	3	7	8	18
9238	2010-03-17	"Wed"	"Midday"	"783"	7	8	3	18
9237	2010-03-16	"Tue"	"Evening"	"242"	2	4	2	8
9236	2010-03-16	"Tue"	"Midday"	"528"	5	2	8	15
9235	2010-03-15	"Mon"	"Evening"	"260"	2	6	0	8
9234	2010-03-15	"Mon"	"Midday"	"080"	0	8	0	8
9233	2010-03-14	"Sun"	"Evening"	"094"	0	9	4	13
9232	2010-03-14	"Sun"	"Midday"	"764"	7	6	4	17
9231	2010-03-13	"Sat"	"Evening"	"893"	8	9	3	20
9230	2010-03-13	"Sat"	"Midday"	"543"	5	4	3	12
9229	2010-03-12	"Fri"	"Evening"	"153"	1	5	3	9
9228	2010-03-12	"Fri"	"Midday"	"984"	9	8	4	21
9227	2010-03-11	"Thu"	"Evening"	"042"	0	4	2	6
9226	2010-03-11	"Thu"	"Midday"	"064"	0	6	4	10
9225	2010-03-10	"Wed"	"Evening"	"032"	0	3	2	5
9224	2010-03-10	"Wed"	"Midday"	"199"	1	9	9	19
9223	2010-03-09	"Tue"	"Evening"	"426"	4	2	6	12
9222	2010-03-09	"Tue"	"Midday"	"230"	2	3	0	5
9221	2010-03-08	"Mon"	"Evening"	"782"	7	8	2	17
9220	2010-03-08	"Mon"	"Midday"	"769"	7	6	9	22
9219	2010-03-07	"Sun"	"Evening"	"672"	6	7	2	15
9218	2010-03-07	"Sun"	"Midday"	"832"	8	3	2	13
9217	2010-03-06	"Sat"	"Evening"	"517"	5	1	7	13
9216	2010-03-06	"Sat"	"Midday"	"224"	2	2	4	8
9215	2010-03-05	"Fri"	"Evening"	"429"	4	2	9	15
9214	2010-03-05	"Fri"	"Midday"	"033"	0	3	3	6
9213	2010-03-04	"Thu"	"Evening"	"116"	1	1	6	8
9212	2010-03-04	"Thu"	"Midday"	"733"	7	3	3	13
9211	2010-03-03	"Wed"	"Evening"	"849"	8	4	9	21
9210	2010-03-03	"Wed"	"Midday"	"295"	2	9	5	16
9209	2010-03-02	"Tue"	"Evening"	"553"	5	5	3	13
9208	2010-03-02	"Tue"	"Midday"	"627"	6	2	7	15
9207	2010-03-01	"Mon"	"Evening"	"030"	0	3	0	3
9206	2010-03-01	"Mon"	"Midday"	"694"	6	9	4	19
9205	2010-02-28	"Sun"	"Evening"	"650"	6	5	0	11
9204	2010-02-28	"Sun"	"Midday"	"041"	0	4	1	5
9203	2010-02-27	"Sat"	"Evening"	"257"	2	5	7	14
9202	2010-02-27	"Sat"	"Midday"	"353"	3	5	3	11
9201	2010-02-26	"Fri"	"Evening"	"863"	8	6	3	17
9200	2010-02-26	"Fri"	"Midday"	"316"	3	1	6	10
9199	2010-02-25	"Thu"	"Evening"	"533"	5	3	3	11
9198	2010-02-25	"Thu"	"Midday"	"790"	7	9	0	16
9197	2010-02-24	"Wed"	"Evening"	"579"	5	7	9	21
9196	2010-02-24	"Wed"	"Midday"	"752"	7	5	2	14
9195	2010-02-23	"Tue"	"Evening"	"179"	1	7	9	17
9194	2010-02-23	"Tue"	"Midday"	"699"	6	9	9	24
9193	2010-02-22	"Mon"	"Evening"	"082"	0	8	2	10
9192	2010-02-22	"Mon"	"Midday"	"779"	7	7	9	23
9191	2010-02-21	"Sun"	"Evening"	"376"	3	7	6	16
9190	2010-02-21	"Sun"	"Midday"	"553"	5	5	3	13
9189	2010-02-20	"Sat"	"Evening"	"368"	3	6	8	17
9188	2010-02-20	"Sat"	"Midday"	"005"	0	0	5	5
9187	2010-02-19	"Fri"	"Evening"	"162"	1	6	2	9
9186	2010-02-19	"Fri"	"Midday"	"086"	0	8	6	14
9185	2010-02-18	"Thu"	"Evening"	"888"	8	8	8	24
9184	2010-02-18	"Thu"	"Midday"	"139"	1	3	9	13
9183	2010-02-17	"Wed"	"Evening"	"197"	1	9	7	17
9182	2010-02-17	"Wed"	"Midday"	"774"	7	7	4	18
9181	2010-02-16	"Tue"	"Evening"	"614"	6	1	4	11
9180	2010-02-16	"Tue"	"Midday"	"916"	9	1	6	16
9179	2010-02-15	"Mon"	"Evening"	"655"	6	5	5	16
9178	2010-02-15	"Mon"	"Midday"	"693"	6	9	3	18
9177	2010-02-14	"Sun"	"Evening"	"706"	7	0	6	13
9176	2010-02-14	"Sun"	"Midday"	"805"	8	0	5	13
9175	2010-02-13	"Sat"	"Evening"	"381"	3	8	1	12
9174	2010-02-13	"Sat"	"Midday"	"808"	8	0	8	16
9173	2010-02-12	"Fri"	"Evening"	"865"	8	6	5	19
9172	2010-02-12	"Fri"	"Midday"	"918"	9	1	8	18
9171	2010-02-11	"Thu"	"Evening"	"102"	1	0	2	3
9170	2010-02-11	"Thu"	"Midday"	"542"	5	4	2	11
9169	2010-02-10	"Wed"	"Evening"	"285"	2	8	5	15
9168	2010-02-10	"Wed"	"Midday"	"570"	5	7	0	12
9167	2010-02-09	"Tue"	"Evening"	"939"	9	3	9	21
9166	2010-02-09	"Tue"	"Midday"	"295"	2	9	5	16
9165	2010-02-08	"Mon"	"Evening"	"453"	4	5	3	12
9164	2010-02-08	"Mon"	"Midday"	"425"	4	2	5	11
9163	2010-02-07	"Sun"	"Evening"	"010"	0	1	0	1
9162	2010-02-07	"Sun"	"Midday"	"919"	9	1	9	19
9161	2010-02-06	"Sat"	"Evening"	"862"	8	6	2	16
9160	2010-02-06	"Sat"	"Midday"	"444"	4	4	4	12
9159	2010-02-05	"Fri"	"Evening"	"891"	8	9	1	18
9158	2010-02-05	"Fri"	"Midday"	"072"	0	7	2	9
9157	2010-02-04	"Thu"	"Evening"	"569"	5	6	9	20
9156	2010-02-04	"Thu"	"Midday"	"127"	1	2	7	10
9155	2010-02-03	"Wed"	"Evening"	"646"	6	4	6	16
9154	2010-02-03	"Wed"	"Midday"	"696"	6	9	6	21
9153	2010-02-02	"Tue"	"Evening"	"376"	3	7	6	16
9152	2010-02-02	"Tue"	"Midday"	"275"	2	7	5	14
9151	2010-02-01	"Mon"	"Evening"	"215"	2	1	5	8
9150	2010-02-01	"Mon"	"Midday"	"349"	3	4	9	16
9149	2010-01-31	"Sun"	"Evening"	"662"	6	6	2	14
9148	2010-01-31	"Sun"	"Midday"	"960"	9	6	0	15
9147	2010-01-30	"Sat"	"Evening"	"257"	2	5	7	14
9146	2010-01-30	"Sat"	"Midday"	"619"	6	1	9	16
9145	2010-01-29	"Fri"	"Evening"	"305"	3	0	5	8
9144	2010-01-29	"Fri"	"Midday"	"114"	1	1	4	6
9143	2010-01-28	"Thu"	"Evening"	"945"	9	4	5	18
9142	2010-01-28	"Thu"	"Midday"	"268"	2	6	8	16
9141	2010-01-27	"Wed"	"Evening"	"578"	5	7	8	20
9140	2010-01-27	"Wed"	"Midday"	"333"	3	3	3	9
9139	2010-01-26	"Tue"	"Evening"	"707"	7	0	7	14
9138	2010-01-26	"Tue"	"Midday"	"840"	8	4	0	12
9137	2010-01-25	"Mon"	"Evening"	"795"	7	9	5	21
9136	2010-01-25	"Mon"	"Midday"	"068"	0	6	8	14
9135	2010-01-24	"Sun"	"Evening"	"160"	1	6	0	7
9134	2010-01-24	"Sun"	"Midday"	"450"	4	5	0	9
9133	2010-01-23	"Sat"	"Evening"	"012"	0	1	2	3
9132	2010-01-23	"Sat"	"Midday"	"524"	5	2	4	11
9131	2010-01-22	"Fri"	"Evening"	"007"	0	0	7	7
9130	2010-01-22	"Fri"	"Midday"	"450"	4	5	0	9
9129	2010-01-21	"Thu"	"Evening"	"906"	9	0	6	15
9128	2010-01-21	"Thu"	"Midday"	"245"	2	4	5	11
9127	2010-01-20	"Wed"	"Evening"	"968"	9	6	8	23
9126	2010-01-20	"Wed"	"Midday"	"283"	2	8	3	13
9125	2010-01-19	"Tue"	"Evening"	"827"	8	2	7	17
9124	2010-01-19	"Tue"	"Midday"	"335"	3	3	5	11
9123	2010-01-18	"Mon"	"Evening"	"370"	3	7	0	10
9122	2010-01-18	"Mon"	"Midday"	"229"	2	2	9	13
9121	2010-01-17	"Sun"	"Evening"	"849"	8	4	9	21
9120	2010-01-17	"Sun"	"Midday"	"993"	9	9	3	21
9119	2010-01-16	"Sat"	"Evening"	"449"	4	4	9	17
9118	2010-01-16	"Sat"	"Midday"	"297"	2	9	7	18
9117	2010-01-15	"Fri"	"Evening"	"315"	3	1	5	9
9116	2010-01-15	"Fri"	"Midday"	"136"	1	3	6	10
9115	2010-01-14	"Thu"	"Evening"	"354"	3	5	4	12
9114	2010-01-14	"Thu"	"Midday"	"204"	2	0	4	6
9113	2010-01-13	"Wed"	"Evening"	"367"	3	6	7	16
9112	2010-01-13	"Wed"	"Midday"	"025"	0	2	5	7
9111	2010-01-12	"Tue"	"Evening"	"147"	1	4	7	12
9110	2010-01-12	"Tue"	"Midday"	"447"	4	4	7	15
9109	2010-01-11	"Mon"	"Evening"	"353"	3	5	3	11
9108	2010-01-11	"Mon"	"Midday"	"681"	6	8	1	15
9107	2010-01-10	"Sun"	"Evening"	"679"	6	7	9	22
9106	2010-01-10	"Sun"	"Midday"	"558"	5	5	8	18
9105	2010-01-09	"Sat"	"Evening"	"175"	1	7	5	13
9104	2010-01-09	"Sat"	"Midday"	"537"	5	3	7	15
9103	2010-01-08	"Fri"	"Evening"	"554"	5	5	4	14
9102	2010-01-08	"Fri"	"Midday"	"342"	3	4	2	9
9101	2010-01-07	"Thu"	"Evening"	"865"	8	6	5	19
9100	2010-01-07	"Thu"	"Midday"	"695"	6	9	5	20
9099	2010-01-06	"Wed"	"Evening"	"642"	6	4	2	12
9098	2010-01-06	"Wed"	"Midday"	"712"	7	1	2	10
9097	2010-01-05	"Tue"	"Evening"	"094"	0	9	4	13
9096	2010-01-05	"Tue"	"Midday"	"741"	7	4	1	12
9095	2010-01-04	"Mon"	"Evening"	"301"	3	0	1	4
9094	2010-01-04	"Mon"	"Midday"	"888"	8	8	8	24
9093	2010-01-03	"Sun"	"Evening"	"151"	1	5	1	7
9092	2010-01-03	"Sun"	"Midday"	"433"	4	3	3	10
9091	2010-01-02	"Sat"	"Evening"	"302"	3	0	2	5
9090	2010-01-02	"Sat"	"Midday"	"426"	4	2	6	12
9089	2010-01-01	"Fri"	"Evening"	"663"	6	6	3	15
9088	2010-01-01	"Fri"	"Midday"	"138"	1	3	8	12
9087	2009-12-31	"Thu"	"Evening"	"595"	5	9	5	19
9086	2009-12-31	"Thu"	"Midday"	"955"	9	5	5	19
9085	2009-12-30	"Wed"	"Evening"	"726"	7	2	6	15
9084	2009-12-30	"Wed"	"Midday"	"093"	0	9	3	12
9083	2009-12-29	"Tue"	"Evening"	"078"	0	7	8	15
9082	2009-12-29	"Tue"	"Midday"	"741"	7	4	1	12
9081	2009-12-28	"Mon"	"Evening"	"533"	5	3	3	11
9080	2009-12-28	"Mon"	"Midday"	"796"	7	9	6	22
9079	2009-12-27	"Sun"	"Evening"	"222"	2	2	2	6
9078	2009-12-27	"Sun"	"Midday"	"609"	6	0	9	15
9077	2009-12-26	"Sat"	"Evening"	"737"	7	3	7	17
9076	2009-12-26	"Sat"	"Midday"	"279"	2	7	9	18
9075	2009-12-25	"Fri"	"Evening"	"516"	5	1	6	12
9074	2009-12-25	"Fri"	"Midday"	"424"	4	2	4	10
9073	2009-12-24	"Thu"	"Evening"	"551"	5	5	1	11
9072	2009-12-24	"Thu"	"Midday"	"529"	5	2	9	16
9071	2009-12-23	"Wed"	"Evening"	"388"	3	8	8	19
9070	2009-12-23	"Wed"	"Midday"	"792"	7	9	2	18
9069	2009-12-22	"Tue"	"Evening"	"975"	9	7	5	21
9068	2009-12-22	"Tue"	"Midday"	"303"	3	0	3	6
9067	2009-12-21	"Mon"	"Evening"	"318"	3	1	8	12
9066	2009-12-21	"Mon"	"Midday"	"053"	0	5	3	8
9065	2009-12-20	"Sun"	"Evening"	"352"	3	5	2	10
9064	2009-12-20	"Sun"	"Midday"	"030"	0	3	0	3
9063	2009-12-19	"Sat"	"Evening"	"080"	0	8	0	8
9062	2009-12-19	"Sat"	"Midday"	"544"	5	4	4	13
9061	2009-12-18	"Fri"	"Evening"	"934"	9	3	4	16
9060	2009-12-18	"Fri"	"Midday"	"482"	4	8	2	14
9059	2009-12-17	"Thu"	"Evening"	"030"	0	3	0	3
9058	2009-12-17	"Thu"	"Midday"	"407"	4	0	7	11
9057	2009-12-16	"Wed"	"Evening"	"925"	9	2	5	16
9056	2009-12-16	"Wed"	"Midday"	"249"	2	4	9	15
9055	2009-12-15	"Tue"	"Evening"	"262"	2	6	2	10
9054	2009-12-15	"Tue"	"Midday"	"581"	5	8	1	14
9053	2009-12-14	"Mon"	"Evening"	"201"	2	0	1	3
9052	2009-12-14	"Mon"	"Midday"	"622"	6	2	2	10
9051	2009-12-13	"Sun"	"Evening"	"980"	9	8	0	17
9050	2009-12-13	"Sun"	"Midday"	"478"	4	7	8	19
9049	2009-12-12	"Sat"	"Evening"	"768"	7	6	8	21
9048	2009-12-12	"Sat"	"Midday"	"278"	2	7	8	17
9047	2009-12-11	"Fri"	"Evening"	"262"	2	6	2	10
9046	2009-12-11	"Fri"	"Midday"	"023"	0	2	3	5
9045	2009-12-10	"Thu"	"Evening"	"287"	2	8	7	17
9044	2009-12-10	"Thu"	"Midday"	"650"	6	5	0	11
9043	2009-12-09	"Wed"	"Evening"	"707"	7	0	7	14
9042	2009-12-09	"Wed"	"Midday"	"748"	7	4	8	19
9041	2009-12-08	"Tue"	"Evening"	"503"	5	0	3	8
9040	2009-12-08	"Tue"	"Midday"	"524"	5	2	4	11
9039	2009-12-07	"Mon"	"Evening"	"560"	5	6	0	11
9038	2009-12-07	"Mon"	"Midday"	"898"	8	9	8	25
9037	2009-12-06	"Sun"	"Evening"	"050"	0	5	0	5
9036	2009-12-06	"Sun"	"Midday"	"021"	0	2	1	3
9035	2009-12-05	"Sat"	"Evening"	"375"	3	7	5	15
9034	2009-12-05	"Sat"	"Midday"	"033"	0	3	3	6
9033	2009-12-04	"Fri"	"Evening"	"580"	5	8	0	13
9032	2009-12-04	"Fri"	"Midday"	"971"	9	7	1	17
9031	2009-12-03	"Thu"	"Evening"	"507"	5	0	7	12
9030	2009-12-03	"Thu"	"Midday"	"654"	6	5	4	15
9029	2009-12-02	"Wed"	"Evening"	"049"	0	4	9	13
9028	2009-12-02	"Wed"	"Midday"	"450"	4	5	0	9
9027	2009-12-01	"Tue"	"Evening"	"125"	1	2	5	8
9026	2009-12-01	"Tue"	"Midday"	"974"	9	7	4	20
9025	2009-11-30	"Mon"	"Evening"	"230"	2	3	0	5
9024	2009-11-30	"Mon"	"Midday"	"965"	9	6	5	20
9023	2009-11-29	"Sun"	"Evening"	"724"	7	2	4	13
9022	2009-11-29	"Sun"	"Midday"	"501"	5	0	1	6
9021	2009-11-28	"Sat"	"Evening"	"502"	5	0	2	7
9020	2009-11-28	"Sat"	"Midday"	"802"	8	0	2	10
9019	2009-11-27	"Fri"	"Evening"	"380"	3	8	0	11
9018	2009-11-27	"Fri"	"Midday"	"899"	8	9	9	26
9017	2009-11-26	"Thu"	"Evening"	"839"	8	3	9	20
9016	2009-11-26	"Thu"	"Midday"	"351"	3	5	1	9
9015	2009-11-25	"Wed"	"Evening"	"253"	2	5	3	10
9014	2009-11-25	"Wed"	"Midday"	"027"	0	2	7	9
9013	2009-11-24	"Tue"	"Evening"	"979"	9	7	9	25
9012	2009-11-24	"Tue"	"Midday"	"602"	6	0	2	8
9011	2009-11-23	"Mon"	"Evening"	"504"	5	0	4	9
9010	2009-11-23	"Mon"	"Midday"	"669"	6	6	9	21
9009	2009-11-22	"Sun"	"Evening"	"206"	2	0	6	8
9008	2009-11-22	"Sun"	"Midday"	"268"	2	6	8	16
9007	2009-11-21	"Sat"	"Evening"	"686"	6	8	6	20
9006	2009-11-21	"Sat"	"Midday"	"602"	6	0	2	8
9005	2009-11-20	"Fri"	"Evening"	"976"	9	7	6	22
9004	2009-11-20	"Fri"	"Midday"	"559"	5	5	9	19
9003	2009-11-19	"Thu"	"Evening"	"523"	5	2	3	10
9002	2009-11-19	"Thu"	"Midday"	"121"	1	2	1	4
9001	2009-11-18	"Wed"	"Evening"	"536"	5	3	6	14
9000	2009-11-18	"Wed"	"Midday"	"990"	9	9	0	18
8999	2009-11-17	"Tue"	"Evening"	"020"	0	2	0	2
8998	2009-11-17	"Tue"	"Midday"	"293"	2	9	3	14
8997	2009-11-16	"Mon"	"Evening"	"975"	9	7	5	21
8996	2009-11-16	"Mon"	"Midday"	"825"	8	2	5	15
8995	2009-11-15	"Sun"	"Evening"	"329"	3	2	9	14
8994	2009-11-15	"Sun"	"Midday"	"508"	5	0	8	13
8993	2009-11-14	"Sat"	"Evening"	"636"	6	3	6	15
8992	2009-11-14	"Sat"	"Midday"	"306"	3	0	6	9
8991	2009-11-13	"Fri"	"Evening"	"511"	5	1	1	7
8990	2009-11-13	"Fri"	"Midday"	"167"	1	6	7	14
8989	2009-11-12	"Thu"	"Evening"	"571"	5	7	1	13
8988	2009-11-12	"Thu"	"Midday"	"811"	8	1	1	10
8987	2009-11-11	"Wed"	"Evening"	"674"	6	7	4	17
8986	2009-11-11	"Wed"	"Midday"	"961"	9	6	1	16
8985	2009-11-10	"Tue"	"Evening"	"318"	3	1	8	12
8984	2009-11-10	"Tue"	"Midday"	"975"	9	7	5	21
8983	2009-11-09	"Mon"	"Evening"	"264"	2	6	4	12
8982	2009-11-09	"Mon"	"Midday"	"815"	8	1	5	14
8981	2009-11-08	"Sun"	"Evening"	"167"	1	6	7	14
8980	2009-11-08	"Sun"	"Midday"	"256"	2	5	6	13
8979	2009-11-07	"Sat"	"Evening"	"350"	3	5	0	8
8978	2009-11-07	"Sat"	"Midday"	"935"	9	3	5	17
8977	2009-11-06	"Fri"	"Evening"	"604"	6	0	4	10
8976	2009-11-06	"Fri"	"Midday"	"728"	7	2	8	17
8975	2009-11-05	"Thu"	"Evening"	"499"	4	9	9	22
8974	2009-11-05	"Thu"	"Midday"	"000"	0	0	0	0
8973	2009-11-04	"Wed"	"Evening"	"763"	7	6	3	16
8972	2009-11-04	"Wed"	"Midday"	"617"	6	1	7	14
8971	2009-11-03	"Tue"	"Evening"	"184"	1	8	4	13
8970	2009-11-03	"Tue"	"Midday"	"163"	1	6	3	10
8969	2009-11-02	"Mon"	"Evening"	"878"	8	7	8	23
8968	2009-11-02	"Mon"	"Midday"	"408"	4	0	8	12
8967	2009-11-01	"Sun"	"Evening"	"309"	3	0	9	12
8966	2009-11-01	"Sun"	"Midday"	"970"	9	7	0	16
8965	2009-10-31	"Sat"	"Evening"	"975"	9	7	5	21
8964	2009-10-31	"Sat"	"Midday"	"883"	8	8	3	19
8963	2009-10-30	"Fri"	"Evening"	"727"	7	2	7	16
8962	2009-10-30	"Fri"	"Midday"	"392"	3	9	2	14
8961	2009-10-29	"Thu"	"Evening"	"123"	1	2	3	6
8960	2009-10-29	"Thu"	"Midday"	"225"	2	2	5	9
8959	2009-10-28	"Wed"	"Evening"	"476"	4	7	6	17
8958	2009-10-28	"Wed"	"Midday"	"600"	6	0	0	6
8957	2009-10-27	"Tue"	"Evening"	"425"	4	2	5	11
8956	2009-10-27	"Tue"	"Midday"	"149"	1	4	9	14
8955	2009-10-26	"Mon"	"Evening"	"988"	9	8	8	25
8954	2009-10-26	"Mon"	"Midday"	"056"	0	5	6	11
8953	2009-10-25	"Sun"	"Evening"	"024"	0	2	4	6
8952	2009-10-25	"Sun"	"Midday"	"254"	2	5	4	11
8951	2009-10-24	"Sat"	"Evening"	"631"	6	3	1	10
8950	2009-10-24	"Sat"	"Midday"	"790"	7	9	0	16
8949	2009-10-23	"Fri"	"Evening"	"647"	6	4	7	17
8948	2009-10-23	"Fri"	"Midday"	"030"	0	3	0	3
8947	2009-10-22	"Thu"	"Evening"	"866"	8	6	6	20
8946	2009-10-22	"Thu"	"Midday"	"724"	7	2	4	13
8945	2009-10-21	"Wed"	"Evening"	"821"	8	2	1	11
8944	2009-10-21	"Wed"	"Midday"	"414"	4	1	4	9
8943	2009-10-20	"Tue"	"Evening"	"154"	1	5	4	10
8942	2009-10-20	"Tue"	"Midday"	"088"	0	8	8	16
8941	2009-10-19	"Mon"	"Evening"	"026"	0	2	6	8
8940	2009-10-19	"Mon"	"Midday"	"495"	4	9	5	18
8939	2009-10-18	"Sun"	"Evening"	"405"	4	0	5	9
8938	2009-10-18	"Sun"	"Midday"	"918"	9	1	8	18
8937	2009-10-17	"Sat"	"Evening"	"706"	7	0	6	13
8936	2009-10-17	"Sat"	"Midday"	"423"	4	2	3	9
8935	2009-10-16	"Fri"	"Evening"	"486"	4	8	6	18
8934	2009-10-16	"Fri"	"Midday"	"532"	5	3	2	10
8933	2009-10-15	"Thu"	"Evening"	"990"	9	9	0	18
8932	2009-10-15	"Thu"	"Midday"	"910"	9	1	0	10
8931	2009-10-14	"Wed"	"Evening"	"557"	5	5	7	17
8930	2009-10-14	"Wed"	"Midday"	"177"	1	7	7	15
8929	2009-10-13	"Tue"	"Evening"	"620"	6	2	0	8
8928	2009-10-13	"Tue"	"Midday"	"963"	9	6	3	18
8927	2009-10-12	"Mon"	"Evening"	"903"	9	0	3	12
8926	2009-10-12	"Mon"	"Midday"	"486"	4	8	6	18
8925	2009-10-11	"Sun"	"Evening"	"967"	9	6	7	22
8924	2009-10-11	"Sun"	"Midday"	"630"	6	3	0	9
8923	2009-10-10	"Sat"	"Evening"	"579"	5	7	9	21
8922	2009-10-10	"Sat"	"Midday"	"226"	2	2	6	10
8921	2009-10-09	"Fri"	"Evening"	"574"	5	7	4	16
8920	2009-10-09	"Fri"	"Midday"	"195"	1	9	5	15
8919	2009-10-08	"Thu"	"Evening"	"179"	1	7	9	17
8918	2009-10-08	"Thu"	"Midday"	"128"	1	2	8	11
8917	2009-10-07	"Wed"	"Evening"	"847"	8	4	7	19
8916	2009-10-07	"Wed"	"Midday"	"885"	8	8	5	21
8915	2009-10-06	"Tue"	"Evening"	"019"	0	1	9	10
8914	2009-10-06	"Tue"	"Midday"	"160"	1	6	0	7
8913	2009-10-05	"Mon"	"Evening"	"744"	7	4	4	15
8912	2009-10-05	"Mon"	"Midday"	"730"	7	3	0	10
8911	2009-10-04	"Sun"	"Evening"	"388"	3	8	8	19
8910	2009-10-04	"Sun"	"Midday"	"868"	8	6	8	22
8909	2009-10-03	"Sat"	"Evening"	"345"	3	4	5	12
8908	2009-10-03	"Sat"	"Midday"	"250"	2	5	0	7
8907	2009-10-02	"Fri"	"Evening"	"729"	7	2	9	18
8906	2009-10-02	"Fri"	"Midday"	"081"	0	8	1	9
8905	2009-10-01	"Thu"	"Evening"	"921"	9	2	1	12
8904	2009-10-01	"Thu"	"Midday"	"540"	5	4	0	9
8903	2009-09-30	"Wed"	"Evening"	"983"	9	8	3	20
8902	2009-09-30	"Wed"	"Midday"	"300"	3	0	0	3
8901	2009-09-29	"Tue"	"Evening"	"147"	1	4	7	12
8900	2009-09-29	"Tue"	"Midday"	"325"	3	2	5	10
8899	2009-09-28	"Mon"	"Evening"	"342"	3	4	2	9
8898	2009-09-28	"Mon"	"Midday"	"150"	1	5	0	6
8897	2009-09-27	"Sun"	"Evening"	"457"	4	5	7	16
8896	2009-09-27	"Sun"	"Midday"	"445"	4	4	5	13
8895	2009-09-26	"Sat"	"Evening"	"854"	8	5	4	17
8894	2009-09-26	"Sat"	"Midday"	"996"	9	9	6	24
8893	2009-09-25	"Fri"	"Evening"	"730"	7	3	0	10
8892	2009-09-25	"Fri"	"Midday"	"673"	6	7	3	16
8891	2009-09-24	"Thu"	"Evening"	"594"	5	9	4	18
8890	2009-09-24	"Thu"	"Midday"	"596"	5	9	6	20
8889	2009-09-23	"Wed"	"Evening"	"049"	0	4	9	13
8888	2009-09-23	"Wed"	"Midday"	"909"	9	0	9	18
8887	2009-09-22	"Tue"	"Evening"	"259"	2	5	9	16
8886	2009-09-22	"Tue"	"Midday"	"677"	6	7	7	20
8885	2009-09-21	"Mon"	"Evening"	"664"	6	6	4	16
8884	2009-09-21	"Mon"	"Midday"	"575"	5	7	5	17
8883	2009-09-20	"Sun"	"Evening"	"432"	4	3	2	9
8882	2009-09-20	"Sun"	"Midday"	"556"	5	5	6	16
8881	2009-09-19	"Sat"	"Evening"	"908"	9	0	8	17
8880	2009-09-19	"Sat"	"Midday"	"325"	3	2	5	10
8879	2009-09-18	"Fri"	"Evening"	"732"	7	3	2	12
8878	2009-09-18	"Fri"	"Midday"	"249"	2	4	9	15
8877	2009-09-17	"Thu"	"Evening"	"637"	6	3	7	16
8876	2009-09-17	"Thu"	"Midday"	"893"	8	9	3	20
8875	2009-09-16	"Wed"	"Evening"	"794"	7	9	4	20
8874	2009-09-16	"Wed"	"Midday"	"763"	7	6	3	16
8873	2009-09-15	"Tue"	"Evening"	"400"	4	0	0	4
8872	2009-09-15	"Tue"	"Midday"	"309"	3	0	9	12
8871	2009-09-14	"Mon"	"Evening"	"824"	8	2	4	14
8870	2009-09-14	"Mon"	"Midday"	"732"	7	3	2	12
8869	2009-09-13	"Sun"	"Evening"	"647"	6	4	7	17
8868	2009-09-13	"Sun"	"Midday"	"376"	3	7	6	16
8867	2009-09-12	"Sat"	"Evening"	"422"	4	2	2	8
8866	2009-09-12	"Sat"	"Midday"	"249"	2	4	9	15
8865	2009-09-11	"Fri"	"Evening"	"047"	0	4	7	11
8864	2009-09-11	"Fri"	"Midday"	"286"	2	8	6	16
8863	2009-09-10	"Thu"	"Evening"	"823"	8	2	3	13
8862	2009-09-10	"Thu"	"Midday"	"149"	1	4	9	14
8861	2009-09-09	"Wed"	"Evening"	"732"	7	3	2	12
8860	2009-09-09	"Wed"	"Midday"	"896"	8	9	6	23
8859	2009-09-08	"Tue"	"Evening"	"318"	3	1	8	12
8858	2009-09-08	"Tue"	"Midday"	"040"	0	4	0	4
8857	2009-09-07	"Mon"	"Evening"	"715"	7	1	5	13
8856	2009-09-07	"Mon"	"Midday"	"056"	0	5	6	11
8855	2009-09-06	"Sun"	"Evening"	"824"	8	2	4	14
8854	2009-09-06	"Sun"	"Midday"	"724"	7	2	4	13
8853	2009-09-05	"Sat"	"Evening"	"285"	2	8	5	15
8852	2009-09-05	"Sat"	"Midday"	"015"	0	1	5	6
8851	2009-09-04	"Fri"	"Evening"	"730"	7	3	0	10
8850	2009-09-04	"Fri"	"Midday"	"784"	7	8	4	19
8849	2009-09-03	"Thu"	"Evening"	"720"	7	2	0	9
8848	2009-09-03	"Thu"	"Midday"	"135"	1	3	5	9
8847	2009-09-02	"Wed"	"Evening"	"059"	0	5	9	14
8846	2009-09-02	"Wed"	"Midday"	"254"	2	5	4	11
8845	2009-09-01	"Tue"	"Evening"	"763"	7	6	3	16
8844	2009-09-01	"Tue"	"Midday"	"767"	7	6	7	20
8843	2009-08-31	"Mon"	"Evening"	"472"	4	7	2	13
8842	2009-08-31	"Mon"	"Midday"	"949"	9	4	9	22
8841	2009-08-30	"Sun"	"Evening"	"283"	2	8	3	13
8840	2009-08-30	"Sun"	"Midday"	"679"	6	7	9	22
8839	2009-08-29	"Sat"	"Evening"	"126"	1	2	6	9
8838	2009-08-29	"Sat"	"Midday"	"200"	2	0	0	2
8837	2009-08-28	"Fri"	"Evening"	"580"	5	8	0	13
8836	2009-08-28	"Fri"	"Midday"	"546"	5	4	6	15
8835	2009-08-27	"Thu"	"Evening"	"659"	6	5	9	20
8834	2009-08-27	"Thu"	"Midday"	"369"	3	6	9	18
8833	2009-08-26	"Wed"	"Evening"	"037"	0	3	7	10
8832	2009-08-26	"Wed"	"Midday"	"364"	3	6	4	13
8831	2009-08-25	"Tue"	"Evening"	"129"	1	2	9	12
8830	2009-08-25	"Tue"	"Midday"	"262"	2	6	2	10
8829	2009-08-24	"Mon"	"Evening"	"583"	5	8	3	16
8828	2009-08-24	"Mon"	"Midday"	"594"	5	9	4	18
8827	2009-08-23	"Sun"	"Evening"	"192"	1	9	2	12
8826	2009-08-23	"Sun"	"Midday"	"869"	8	6	9	23
8825	2009-08-22	"Sat"	"Evening"	"206"	2	0	6	8
8824	2009-08-22	"Sat"	"Midday"	"168"	1	6	8	15
8823	2009-08-21	"Fri"	"Evening"	"601"	6	0	1	7
8822	2009-08-21	"Fri"	"Midday"	"732"	7	3	2	12
8821	2009-08-20	"Thu"	"Evening"	"957"	9	5	7	21
8820	2009-08-20	"Thu"	"Midday"	"598"	5	9	8	22
8819	2009-08-19	"Wed"	"Evening"	"399"	3	9	9	21
8818	2009-08-19	"Wed"	"Midday"	"343"	3	4	3	10
8817	2009-08-18	"Tue"	"Evening"	"342"	3	4	2	9
8816	2009-08-18	"Tue"	"Midday"	"393"	3	9	3	15
8815	2009-08-17	"Mon"	"Evening"	"280"	2	8	0	10
8814	2009-08-17	"Mon"	"Midday"	"543"	5	4	3	12
8813	2009-08-16	"Sun"	"Evening"	"848"	8	4	8	20
8812	2009-08-16	"Sun"	"Midday"	"618"	6	1	8	15
8811	2009-08-15	"Sat"	"Evening"	"260"	2	6	0	8
8810	2009-08-15	"Sat"	"Midday"	"606"	6	0	6	12
8809	2009-08-14	"Fri"	"Evening"	"876"	8	7	6	21
8808	2009-08-14	"Fri"	"Midday"	"298"	2	9	8	19
8807	2009-08-13	"Thu"	"Evening"	"497"	4	9	7	20
8806	2009-08-13	"Thu"	"Midday"	"066"	0	6	6	12
8805	2009-08-12	"Wed"	"Evening"	"456"	4	5	6	15
8804	2009-08-12	"Wed"	"Midday"	"460"	4	6	0	10
8803	2009-08-11	"Tue"	"Evening"	"748"	7	4	8	19
8802	2009-08-11	"Tue"	"Midday"	"083"	0	8	3	11
8801	2009-08-10	"Mon"	"Evening"	"733"	7	3	3	13
8800	2009-08-10	"Mon"	"Midday"	"532"	5	3	2	10
8799	2009-08-09	"Sun"	"Evening"	"553"	5	5	3	13
8798	2009-08-09	"Sun"	"Midday"	"729"	7	2	9	18
8797	2009-08-08	"Sat"	"Evening"	"024"	0	2	4	6
8796	2009-08-08	"Sat"	"Midday"	"883"	8	8	3	19
8795	2009-08-07	"Fri"	"Evening"	"505"	5	0	5	10
8794	2009-08-07	"Fri"	"Midday"	"394"	3	9	4	16
8793	2009-08-06	"Thu"	"Evening"	"130"	1	3	0	4
8792	2009-08-06	"Thu"	"Midday"	"112"	1	1	2	4
8791	2009-08-05	"Wed"	"Evening"	"126"	1	2	6	9
8790	2009-08-05	"Wed"	"Midday"	"884"	8	8	4	20
8789	2009-08-04	"Tue"	"Evening"	"306"	3	0	6	9
8788	2009-08-04	"Tue"	"Midday"	"471"	4	7	1	12
8787	2009-08-03	"Mon"	"Evening"	"744"	7	4	4	15
8786	2009-08-03	"Mon"	"Midday"	"407"	4	0	7	11
8785	2009-08-02	"Sun"	"Evening"	"765"	7	6	5	18
8784	2009-08-02	"Sun"	"Midday"	"501"	5	0	1	6
8783	2009-08-01	"Sat"	"Evening"	"073"	0	7	3	10
8782	2009-08-01	"Sat"	"Midday"	"189"	1	8	9	18
8781	2009-07-31	"Fri"	"Evening"	"908"	9	0	8	17
8780	2009-07-31	"Fri"	"Midday"	"381"	3	8	1	12
8779	2009-07-30	"Thu"	"Evening"	"860"	8	6	0	14
8778	2009-07-30	"Thu"	"Midday"	"818"	8	1	8	17
8777	2009-07-29	"Wed"	"Evening"	"387"	3	8	7	18
8776	2009-07-29	"Wed"	"Midday"	"543"	5	4	3	12
8775	2009-07-28	"Tue"	"Evening"	"802"	8	0	2	10
8774	2009-07-28	"Tue"	"Midday"	"439"	4	3	9	16
8773	2009-07-27	"Mon"	"Evening"	"094"	0	9	4	13
8772	2009-07-27	"Mon"	"Midday"	"943"	9	4	3	16
8771	2009-07-26	"Sun"	"Evening"	"412"	4	1	2	7
8770	2009-07-26	"Sun"	"Midday"	"024"	0	2	4	6
8769	2009-07-25	"Sat"	"Evening"	"562"	5	6	2	13
8768	2009-07-25	"Sat"	"Midday"	"107"	1	0	7	8
8767	2009-07-24	"Fri"	"Evening"	"986"	9	8	6	23
8766	2009-07-24	"Fri"	"Midday"	"316"	3	1	6	10
8765	2009-07-23	"Thu"	"Evening"	"043"	0	4	3	7
8764	2009-07-23	"Thu"	"Midday"	"163"	1	6	3	10
8763	2009-07-22	"Wed"	"Evening"	"702"	7	0	2	9
8762	2009-07-22	"Wed"	"Midday"	"892"	8	9	2	19
8761	2009-07-21	"Tue"	"Evening"	"245"	2	4	5	11
8760	2009-07-21	"Tue"	"Midday"	"752"	7	5	2	14
8759	2009-07-20	"Mon"	"Evening"	"459"	4	5	9	18
8758	2009-07-20	"Mon"	"Midday"	"903"	9	0	3	12
8757	2009-07-19	"Sun"	"Evening"	"682"	6	8	2	16
8756	2009-07-19	"Sun"	"Midday"	"252"	2	5	2	9
8755	2009-07-18	"Sat"	"Evening"	"638"	6	3	8	17
8754	2009-07-18	"Sat"	"Midday"	"600"	6	0	0	6
8753	2009-07-17	"Fri"	"Evening"	"690"	6	9	0	15
8752	2009-07-17	"Fri"	"Midday"	"859"	8	5	9	22
8751	2009-07-16	"Thu"	"Evening"	"388"	3	8	8	19
8750	2009-07-16	"Thu"	"Midday"	"110"	1	1	0	2
8749	2009-07-15	"Wed"	"Evening"	"986"	9	8	6	23
8748	2009-07-15	"Wed"	"Midday"	"768"	7	6	8	21
8747	2009-07-14	"Tue"	"Evening"	"728"	7	2	8	17
8746	2009-07-14	"Tue"	"Midday"	"874"	8	7	4	19
8745	2009-07-13	"Mon"	"Evening"	"782"	7	8	2	17
8744	2009-07-13	"Mon"	"Midday"	"121"	1	2	1	4
8743	2009-07-12	"Sun"	"Evening"	"297"	2	9	7	18
8742	2009-07-12	"Sun"	"Midday"	"632"	6	3	2	11
8741	2009-07-11	"Sat"	"Evening"	"650"	6	5	0	11
8740	2009-07-11	"Sat"	"Midday"	"372"	3	7	2	12
8739	2009-07-10	"Fri"	"Evening"	"835"	8	3	5	16
8738	2009-07-10	"Fri"	"Midday"	"789"	7	8	9	24
8737	2009-07-09	"Thu"	"Evening"	"733"	7	3	3	13
8736	2009-07-09	"Thu"	"Midday"	"551"	5	5	1	11
8735	2009-07-08	"Wed"	"Evening"	"415"	4	1	5	10
8734	2009-07-08	"Wed"	"Midday"	"405"	4	0	5	9
8733	2009-07-07	"Tue"	"Evening"	"974"	9	7	4	20
8732	2009-07-07	"Tue"	"Midday"	"693"	6	9	3	18
8731	2009-07-06	"Mon"	"Evening"	"043"	0	4	3	7
8730	2009-07-06	"Mon"	"Midday"	"732"	7	3	2	12
8729	2009-07-05	"Sun"	"Evening"	"033"	0	3	3	6
8728	2009-07-05	"Sun"	"Midday"	"760"	7	6	0	13
8727	2009-07-04	"Sat"	"Evening"	"880"	8	8	0	16
8726	2009-07-04	"Sat"	"Midday"	"175"	1	7	5	13
8725	2009-07-03	"Fri"	"Evening"	"505"	5	0	5	10
8724	2009-07-03	"Fri"	"Midday"	"845"	8	4	5	17
8723	2009-07-02	"Thu"	"Evening"	"667"	6	6	7	19
8722	2009-07-02	"Thu"	"Midday"	"529"	5	2	9	16
8721	2009-07-01	"Wed"	"Evening"	"283"	2	8	3	13
8720	2009-07-01	"Wed"	"Midday"	"642"	6	4	2	12
8719	2009-06-30	"Tue"	"Evening"	"441"	4	4	1	9
8718	2009-06-30	"Tue"	"Midday"	"880"	8	8	0	16
8717	2009-06-29	"Mon"	"Evening"	"765"	7	6	5	18
8716	2009-06-29	"Mon"	"Midday"	"487"	4	8	7	19
8715	2009-06-28	"Sun"	"Evening"	"829"	8	2	9	19
8714	2009-06-28	"Sun"	"Midday"	"633"	6	3	3	12
8713	2009-06-27	"Sat"	"Evening"	"863"	8	6	3	17
8712	2009-06-27	"Sat"	"Midday"	"236"	2	3	6	11
8711	2009-06-26	"Fri"	"Evening"	"166"	1	6	6	13
8710	2009-06-26	"Fri"	"Midday"	"742"	7	4	2	13
8709	2009-06-25	"Thu"	"Evening"	"067"	0	6	7	13
8708	2009-06-25	"Thu"	"Midday"	"667"	6	6	7	19
8707	2009-06-24	"Wed"	"Evening"	"483"	4	8	3	15
8706	2009-06-24	"Wed"	"Midday"	"434"	4	3	4	11
8705	2009-06-23	"Tue"	"Evening"	"121"	1	2	1	4
8704	2009-06-23	"Tue"	"Midday"	"514"	5	1	4	10
8703	2009-06-22	"Mon"	"Evening"	"003"	0	0	3	3
8702	2009-06-22	"Mon"	"Midday"	"742"	7	4	2	13
8701	2009-06-21	"Sun"	"Evening"	"168"	1	6	8	15
8700	2009-06-21	"Sun"	"Midday"	"011"	0	1	1	2
8699	2009-06-20	"Sat"	"Evening"	"800"	8	0	0	8
8698	2009-06-20	"Sat"	"Midday"	"673"	6	7	3	16
8697	2009-06-19	"Fri"	"Evening"	"575"	5	7	5	17
8696	2009-06-19	"Fri"	"Midday"	"275"	2	7	5	14
8695	2009-06-18	"Thu"	"Evening"	"860"	8	6	0	14
8694	2009-06-18	"Thu"	"Midday"	"086"	0	8	6	14
8693	2009-06-17	"Wed"	"Evening"	"503"	5	0	3	8
8692	2009-06-17	"Wed"	"Midday"	"659"	6	5	9	20
8691	2009-06-16	"Tue"	"Evening"	"873"	8	7	3	18
8690	2009-06-16	"Tue"	"Midday"	"995"	9	9	5	23
8689	2009-06-15	"Mon"	"Evening"	"499"	4	9	9	22
8688	2009-06-15	"Mon"	"Midday"	"603"	6	0	3	9
8687	2009-06-14	"Sun"	"Evening"	"817"	8	1	7	16
8686	2009-06-14	"Sun"	"Midday"	"868"	8	6	8	22
8685	2009-06-13	"Sat"	"Evening"	"508"	5	0	8	13
8684	2009-06-13	"Sat"	"Midday"	"409"	4	0	9	13
8683	2009-06-12	"Fri"	"Evening"	"514"	5	1	4	10
8682	2009-06-12	"Fri"	"Midday"	"998"	9	9	8	26
8681	2009-06-11	"Thu"	"Evening"	"260"	2	6	0	8
8680	2009-06-11	"Thu"	"Midday"	"137"	1	3	7	11
8679	2009-06-10	"Wed"	"Evening"	"087"	0	8	7	15
8678	2009-06-10	"Wed"	"Midday"	"446"	4	4	6	14
8677	2009-06-09	"Tue"	"Evening"	"240"	2	4	0	6
8676	2009-06-09	"Tue"	"Midday"	"527"	5	2	7	14
8675	2009-06-08	"Mon"	"Evening"	"327"	3	2	7	12
8674	2009-06-08	"Mon"	"Midday"	"923"	9	2	3	14
8673	2009-06-07	"Sun"	"Evening"	"768"	7	6	8	21
8672	2009-06-07	"Sun"	"Midday"	"664"	6	6	4	16
8671	2009-06-06	"Sat"	"Evening"	"262"	2	6	2	10
8670	2009-06-06	"Sat"	"Midday"	"510"	5	1	0	6
8669	2009-06-05	"Fri"	"Evening"	"476"	4	7	6	17
8668	2009-06-05	"Fri"	"Midday"	"638"	6	3	8	17
8667	2009-06-04	"Thu"	"Evening"	"493"	4	9	3	16
8666	2009-06-04	"Thu"	"Midday"	"158"	1	5	8	14
8665	2009-06-03	"Wed"	"Evening"	"411"	4	1	1	6
8664	2009-06-03	"Wed"	"Midday"	"155"	1	5	5	11
8663	2009-06-02	"Tue"	"Evening"	"725"	7	2	5	14
8662	2009-06-02	"Tue"	"Midday"	"413"	4	1	3	8
8661	2009-06-01	"Mon"	"Evening"	"979"	9	7	9	25
8660	2009-06-01	"Mon"	"Midday"	"422"	4	2	2	8
8659	2009-05-31	"Sun"	"Evening"	"282"	2	8	2	12
8658	2009-05-31	"Sun"	"Midday"	"148"	1	4	8	13
8657	2009-05-30	"Sat"	"Evening"	"901"	9	0	1	10
8656	2009-05-30	"Sat"	"Midday"	"692"	6	9	2	17
8655	2009-05-29	"Fri"	"Evening"	"719"	7	1	9	17
8654	2009-05-29	"Fri"	"Midday"	"122"	1	2	2	5
8653	2009-05-28	"Thu"	"Evening"	"180"	1	8	0	9
8652	2009-05-28	"Thu"	"Midday"	"276"	2	7	6	15
8651	2009-05-27	"Wed"	"Evening"	"058"	0	5	8	13
8650	2009-05-27	"Wed"	"Midday"	"339"	3	3	9	15
8649	2009-05-26	"Tue"	"Evening"	"075"	0	7	5	12
8648	2009-05-26	"Tue"	"Midday"	"441"	4	4	1	9
8647	2009-05-25	"Mon"	"Evening"	"894"	8	9	4	21
8646	2009-05-25	"Mon"	"Midday"	"318"	3	1	8	12
8645	2009-05-24	"Sun"	"Evening"	"455"	4	5	5	14
8644	2009-05-24	"Sun"	"Midday"	"696"	6	9	6	21
8643	2009-05-23	"Sat"	"Evening"	"550"	5	5	0	10
8642	2009-05-23	"Sat"	"Midday"	"462"	4	6	2	12
8641	2009-05-22	"Fri"	"Evening"	"601"	6	0	1	7
8640	2009-05-22	"Fri"	"Midday"	"804"	8	0	4	12
8639	2009-05-21	"Thu"	"Evening"	"939"	9	3	9	21
8638	2009-05-21	"Thu"	"Midday"	"312"	3	1	2	6
8637	2009-05-20	"Wed"	"Evening"	"762"	7	6	2	15
8636	2009-05-20	"Wed"	"Midday"	"880"	8	8	0	16
8635	2009-05-19	"Tue"	"Evening"	"030"	0	3	0	3
8634	2009-05-19	"Tue"	"Midday"	"367"	3	6	7	16
8633	2009-05-18	"Mon"	"Evening"	"653"	6	5	3	14
8632	2009-05-18	"Mon"	"Midday"	"581"	5	8	1	14
8631	2009-05-17	"Sun"	"Evening"	"047"	0	4	7	11
8630	2009-05-17	"Sun"	"Midday"	"055"	0	5	5	10
8629	2009-05-16	"Sat"	"Evening"	"259"	2	5	9	16
8628	2009-05-16	"Sat"	"Midday"	"001"	0	0	1	1
8627	2009-05-15	"Fri"	"Evening"	"668"	6	6	8	20
8626	2009-05-15	"Fri"	"Midday"	"775"	7	7	5	19
8625	2009-05-14	"Thu"	"Evening"	"379"	3	7	9	19
8624	2009-05-14	"Thu"	"Midday"	"577"	5	7	7	19
8623	2009-05-13	"Wed"	"Evening"	"574"	5	7	4	16
8622	2009-05-13	"Wed"	"Midday"	"508"	5	0	8	13
8621	2009-05-12	"Tue"	"Evening"	"069"	0	6	9	15
8620	2009-05-12	"Tue"	"Midday"	"100"	1	0	0	1
8619	2009-05-11	"Mon"	"Evening"	"869"	8	6	9	23
8618	2009-05-11	"Mon"	"Midday"	"065"	0	6	5	11
8617	2009-05-10	"Sun"	"Evening"	"854"	8	5	4	17
8616	2009-05-10	"Sun"	"Midday"	"909"	9	0	9	18
8615	2009-05-09	"Sat"	"Evening"	"806"	8	0	6	14
8614	2009-05-09	"Sat"	"Midday"	"500"	5	0	0	5
8613	2009-05-08	"Fri"	"Evening"	"241"	2	4	1	7
8612	2009-05-08	"Fri"	"Midday"	"321"	3	2	1	6
8611	2009-05-07	"Thu"	"Evening"	"859"	8	5	9	22
8610	2009-05-07	"Thu"	"Midday"	"990"	9	9	0	18
8609	2009-05-06	"Wed"	"Evening"	"204"	2	0	4	6
8608	2009-05-06	"Wed"	"Midday"	"945"	9	4	5	18
8607	2009-05-05	"Tue"	"Evening"	"209"	2	0	9	11
8606	2009-05-05	"Tue"	"Midday"	"182"	1	8	2	11
8605	2009-05-04	"Mon"	"Evening"	"749"	7	4	9	20
8604	2009-05-04	"Mon"	"Midday"	"197"	1	9	7	17
8603	2009-05-03	"Sun"	"Evening"	"887"	8	8	7	23
8602	2009-05-03	"Sun"	"Midday"	"611"	6	1	1	8
8601	2009-05-02	"Sat"	"Evening"	"619"	6	1	9	16
8600	2009-05-02	"Sat"	"Midday"	"438"	4	3	8	15
8599	2009-05-01	"Fri"	"Evening"	"253"	2	5	3	10
8598	2009-05-01	"Fri"	"Midday"	"079"	0	7	9	16
8597	2009-04-30	"Thu"	"Evening"	"946"	9	4	6	19
8596	2009-04-30	"Thu"	"Midday"	"723"	7	2	3	12
8595	2009-04-29	"Wed"	"Evening"	"862"	8	6	2	16
8594	2009-04-29	"Wed"	"Midday"	"260"	2	6	0	8
8593	2009-04-28	"Tue"	"Evening"	"025"	0	2	5	7
8592	2009-04-28	"Tue"	"Midday"	"374"	3	7	4	14
8591	2009-04-27	"Mon"	"Evening"	"847"	8	4	7	19
8590	2009-04-27	"Mon"	"Midday"	"407"	4	0	7	11
8589	2009-04-26	"Sun"	"Evening"	"152"	1	5	2	8
8588	2009-04-26	"Sun"	"Midday"	"702"	7	0	2	9
8587	2009-04-25	"Sat"	"Evening"	"300"	3	0	0	3
8586	2009-04-25	"Sat"	"Midday"	"114"	1	1	4	6
8585	2009-04-24	"Fri"	"Evening"	"004"	0	0	4	4
8584	2009-04-24	"Fri"	"Midday"	"883"	8	8	3	19
8583	2009-04-23	"Thu"	"Evening"	"959"	9	5	9	23
8582	2009-04-23	"Thu"	"Midday"	"936"	9	3	6	18
8581	2009-04-22	"Wed"	"Evening"	"620"	6	2	0	8
8580	2009-04-22	"Wed"	"Midday"	"088"	0	8	8	16
8579	2009-04-21	"Tue"	"Evening"	"766"	7	6	6	19
8578	2009-04-21	"Tue"	"Midday"	"099"	0	9	9	18
8577	2009-04-20	"Mon"	"Evening"	"920"	9	2	0	11
8576	2009-04-20	"Mon"	"Midday"	"263"	2	6	3	11
8575	2009-04-19	"Sun"	"Evening"	"948"	9	4	8	21
8574	2009-04-19	"Sun"	"Midday"	"490"	4	9	0	13
8573	2009-04-18	"Sat"	"Evening"	"190"	1	9	0	10
8572	2009-04-18	"Sat"	"Midday"	"861"	8	6	1	15
8571	2009-04-17	"Fri"	"Evening"	"406"	4	0	6	10
8570	2009-04-17	"Fri"	"Midday"	"879"	8	7	9	24
8569	2009-04-16	"Thu"	"Evening"	"323"	3	2	3	8
8568	2009-04-16	"Thu"	"Midday"	"181"	1	8	1	10
8567	2009-04-15	"Wed"	"Evening"	"111"	1	1	1	3
8566	2009-04-15	"Wed"	"Midday"	"666"	6	6	6	18
8565	2009-04-14	"Tue"	"Evening"	"692"	6	9	2	17
8564	2009-04-14	"Tue"	"Midday"	"251"	2	5	1	8
8563	2009-04-13	"Mon"	"Evening"	"869"	8	6	9	23
8562	2009-04-13	"Mon"	"Midday"	"189"	1	8	9	18
8561	2009-04-12	"Sun"	"Evening"	"166"	1	6	6	13
8560	2009-04-12	"Sun"	"Midday"	"510"	5	1	0	6
8559	2009-04-11	"Sat"	"Evening"	"844"	8	4	4	16
8558	2009-04-11	"Sat"	"Midday"	"800"	8	0	0	8
8557	2009-04-10	"Fri"	"Evening"	"263"	2	6	3	11
8556	2009-04-10	"Fri"	"Midday"	"273"	2	7	3	12
8555	2009-04-09	"Thu"	"Evening"	"234"	2	3	4	9
8554	2009-04-09	"Thu"	"Midday"	"360"	3	6	0	9
8553	2009-04-08	"Wed"	"Evening"	"030"	0	3	0	3
8552	2009-04-08	"Wed"	"Midday"	"171"	1	7	1	9
8551	2009-04-07	"Tue"	"Evening"	"299"	2	9	9	20
8550	2009-04-07	"Tue"	"Midday"	"738"	7	3	8	18
8549	2009-04-06	"Mon"	"Evening"	"124"	1	2	4	7
8548	2009-04-06	"Mon"	"Midday"	"252"	2	5	2	9
8547	2009-04-05	"Sun"	"Evening"	"870"	8	7	0	15
8546	2009-04-05	"Sun"	"Midday"	"838"	8	3	8	19
8545	2009-04-04	"Sat"	"Evening"	"298"	2	9	8	19
8544	2009-04-04	"Sat"	"Midday"	"438"	4	3	8	15
8543	2009-04-03	"Fri"	"Evening"	"308"	3	0	8	11
8542	2009-04-03	"Fri"	"Midday"	"191"	1	9	1	11
8541	2009-04-02	"Thu"	"Evening"	"784"	7	8	4	19
8540	2009-04-02	"Thu"	"Midday"	"833"	8	3	3	14
8539	2009-04-01	"Wed"	"Evening"	"240"	2	4	0	6
8538	2009-04-01	"Wed"	"Midday"	"103"	1	0	3	4
8537	2009-03-31	"Tue"	"Evening"	"934"	9	3	4	16
8536	2009-03-31	"Tue"	"Midday"	"396"	3	9	6	18
8535	2009-03-30	"Mon"	"Evening"	"967"	9	6	7	22
8534	2009-03-30	"Mon"	"Midday"	"021"	0	2	1	3
8533	2009-03-29	"Sun"	"Evening"	"920"	9	2	0	11
8532	2009-03-29	"Sun"	"Midday"	"308"	3	0	8	11
8531	2009-03-28	"Sat"	"Evening"	"833"	8	3	3	14
8530	2009-03-28	"Sat"	"Midday"	"047"	0	4	7	11
8529	2009-03-27	"Fri"	"Evening"	"454"	4	5	4	13
8528	2009-03-27	"Fri"	"Midday"	"563"	5	6	3	14
8527	2009-03-26	"Thu"	"Evening"	"802"	8	0	2	10
8526	2009-03-26	"Thu"	"Midday"	"119"	1	1	9	11
8525	2009-03-25	"Wed"	"Evening"	"246"	2	4	6	12
8524	2009-03-25	"Wed"	"Midday"	"082"	0	8	2	10
8523	2009-03-24	"Tue"	"Evening"	"111"	1	1	1	3
8522	2009-03-24	"Tue"	"Midday"	"025"	0	2	5	7
8521	2009-03-23	"Mon"	"Evening"	"693"	6	9	3	18
8520	2009-03-23	"Mon"	"Midday"	"120"	1	2	0	3
8519	2009-03-22	"Sun"	"Evening"	"022"	0	2	2	4
8518	2009-03-22	"Sun"	"Midday"	"716"	7	1	6	14
8517	2009-03-21	"Sat"	"Evening"	"286"	2	8	6	16
8516	2009-03-21	"Sat"	"Midday"	"511"	5	1	1	7
8515	2009-03-20	"Fri"	"Evening"	"445"	4	4	5	13
8514	2009-03-20	"Fri"	"Midday"	"737"	7	3	7	17
8513	2009-03-19	"Thu"	"Evening"	"143"	1	4	3	8
8512	2009-03-19	"Thu"	"Midday"	"303"	3	0	3	6
8511	2009-03-18	"Wed"	"Evening"	"241"	2	4	1	7
8510	2009-03-18	"Wed"	"Midday"	"029"	0	2	9	11
8509	2009-03-17	"Tue"	"Evening"	"322"	3	2	2	7
8508	2009-03-17	"Tue"	"Midday"	"567"	5	6	7	18
8507	2009-03-16	"Mon"	"Evening"	"345"	3	4	5	12
8506	2009-03-16	"Mon"	"Midday"	"470"	4	7	0	11
8505	2009-03-15	"Sun"	"Evening"	"386"	3	8	6	17
8504	2009-03-15	"Sun"	"Midday"	"575"	5	7	5	17
8503	2009-03-14	"Sat"	"Evening"	"411"	4	1	1	6
8502	2009-03-14	"Sat"	"Midday"	"115"	1	1	5	7
8501	2009-03-13	"Fri"	"Evening"	"003"	0	0	3	3
8500	2009-03-13	"Fri"	"Midday"	"189"	1	8	9	18
8499	2009-03-12	"Thu"	"Evening"	"381"	3	8	1	12
8498	2009-03-12	"Thu"	"Midday"	"166"	1	6	6	13
8497	2009-03-11	"Wed"	"Evening"	"212"	2	1	2	5
8496	2009-03-11	"Wed"	"Midday"	"238"	2	3	8	13
8495	2009-03-10	"Tue"	"Evening"	"306"	3	0	6	9
8494	2009-03-10	"Tue"	"Midday"	"092"	0	9	2	11
8493	2009-03-09	"Mon"	"Evening"	"311"	3	1	1	5
8492	2009-03-09	"Mon"	"Midday"	"387"	3	8	7	18
8491	2009-03-08	"Sun"	"Evening"	"816"	8	1	6	15
8490	2009-03-08	"Sun"	"Midday"	"030"	0	3	0	3
8489	2009-03-07	"Sat"	"Evening"	"106"	1	0	6	7
8488	2009-03-07	"Sat"	"Midday"	"921"	9	2	1	12
8487	2009-03-06	"Fri"	"Evening"	"368"	3	6	8	17
8486	2009-03-06	"Fri"	"Midday"	"495"	4	9	5	18
8485	2009-03-05	"Thu"	"Evening"	"406"	4	0	6	10
8484	2009-03-05	"Thu"	"Midday"	"447"	4	4	7	15
8483	2009-03-04	"Wed"	"Evening"	"676"	6	7	6	19
8482	2009-03-04	"Wed"	"Midday"	"240"	2	4	0	6
8481	2009-03-03	"Tue"	"Evening"	"266"	2	6	6	14
8480	2009-03-03	"Tue"	"Midday"	"914"	9	1	4	14
8479	2009-03-02	"Mon"	"Evening"	"239"	2	3	9	14
8478	2009-03-02	"Mon"	"Midday"	"636"	6	3	6	15
8477	2009-03-01	"Sun"	"Evening"	"553"	5	5	3	13
8476	2009-03-01	"Sun"	"Midday"	"947"	9	4	7	20
8475	2009-02-28	"Sat"	"Evening"	"009"	0	0	9	9
8474	2009-02-28	"Sat"	"Midday"	"667"	6	6	7	19
8473	2009-02-27	"Fri"	"Evening"	"455"	4	5	5	14
8472	2009-02-27	"Fri"	"Midday"	"986"	9	8	6	23
8471	2009-02-26	"Thu"	"Evening"	"160"	1	6	0	7
8470	2009-02-26	"Thu"	"Midday"	"510"	5	1	0	6
8469	2009-02-25	"Wed"	"Evening"	"408"	4	0	8	12
8468	2009-02-25	"Wed"	"Midday"	"727"	7	2	7	16
8467	2009-02-24	"Tue"	"Evening"	"228"	2	2	8	12
8466	2009-02-24	"Tue"	"Midday"	"478"	4	7	8	19
8465	2009-02-23	"Mon"	"Evening"	"110"	1	1	0	2
8464	2009-02-23	"Mon"	"Midday"	"670"	6	7	0	13
8463	2009-02-22	"Sun"	"Evening"	"462"	4	6	2	12
8462	2009-02-22	"Sun"	"Midday"	"429"	4	2	9	15
8461	2009-02-21	"Sat"	"Evening"	"265"	2	6	5	13
8460	2009-02-21	"Sat"	"Midday"	"068"	0	6	8	14
8459	2009-02-20	"Fri"	"Evening"	"808"	8	0	8	16
8458	2009-02-20	"Fri"	"Midday"	"318"	3	1	8	12
8457	2009-02-19	"Thu"	"Evening"	"392"	3	9	2	14
8456	2009-02-19	"Thu"	"Midday"	"217"	2	1	7	10
8455	2009-02-18	"Wed"	"Evening"	"202"	2	0	2	4
8454	2009-02-18	"Wed"	"Midday"	"094"	0	9	4	13
8453	2009-02-17	"Tue"	"Evening"	"658"	6	5	8	19
8452	2009-02-17	"Tue"	"Midday"	"843"	8	4	3	15
8451	2009-02-16	"Mon"	"Evening"	"972"	9	7	2	18
8450	2009-02-16	"Mon"	"Midday"	"166"	1	6	6	13
8449	2009-02-15	"Sun"	"Evening"	"659"	6	5	9	20
8448	2009-02-15	"Sun"	"Midday"	"239"	2	3	9	14
8447	2009-02-14	"Sat"	"Evening"	"195"	1	9	5	15
8446	2009-02-14	"Sat"	"Midday"	"612"	6	1	2	9
8445	2009-02-13	"Fri"	"Evening"	"769"	7	6	9	22
8444	2009-02-13	"Fri"	"Midday"	"669"	6	6	9	21
8443	2009-02-12	"Thu"	"Evening"	"405"	4	0	5	9
8442	2009-02-12	"Thu"	"Midday"	"610"	6	1	0	7
8441	2009-02-11	"Wed"	"Evening"	"421"	4	2	1	7
8440	2009-02-11	"Wed"	"Midday"	"389"	3	8	9	20
8439	2009-02-10	"Tue"	"Evening"	"482"	4	8	2	14
8438	2009-02-10	"Tue"	"Midday"	"802"	8	0	2	10
8437	2009-02-09	"Mon"	"Evening"	"568"	5	6	8	19
8436	2009-02-09	"Mon"	"Midday"	"204"	2	0	4	6
8435	2009-02-08	"Sun"	"Evening"	"108"	1	0	8	9
8434	2009-02-08	"Sun"	"Midday"	"653"	6	5	3	14
8433	2009-02-07	"Sat"	"Evening"	"875"	8	7	5	20
8432	2009-02-07	"Sat"	"Midday"	"366"	3	6	6	15
8431	2009-02-06	"Fri"	"Evening"	"119"	1	1	9	11
8430	2009-02-06	"Fri"	"Midday"	"198"	1	9	8	18
8429	2009-02-05	"Thu"	"Evening"	"975"	9	7	5	21
8428	2009-02-05	"Thu"	"Midday"	"719"	7	1	9	17
8427	2009-02-04	"Wed"	"Evening"	"822"	8	2	2	12
8426	2009-02-04	"Wed"	"Midday"	"285"	2	8	5	15
8425	2009-02-03	"Tue"	"Evening"	"839"	8	3	9	20
8424	2009-02-03	"Tue"	"Midday"	"551"	5	5	1	11
8423	2009-02-02	"Mon"	"Evening"	"947"	9	4	7	20
8422	2009-02-02	"Mon"	"Midday"	"160"	1	6	0	7
8421	2009-02-01	"Sun"	"Evening"	"642"	6	4	2	12
8420	2009-02-01	"Sun"	"Midday"	"912"	9	1	2	12
8419	2009-01-31	"Sat"	"Evening"	"686"	6	8	6	20
8418	2009-01-31	"Sat"	"Midday"	"390"	3	9	0	12
8417	2009-01-30	"Fri"	"Evening"	"784"	7	8	4	19
8416	2009-01-30	"Fri"	"Midday"	"900"	9	0	0	9
8415	2009-01-29	"Thu"	"Evening"	"764"	7	6	4	17
8414	2009-01-29	"Thu"	"Midday"	"920"	9	2	0	11
8413	2009-01-28	"Wed"	"Evening"	"158"	1	5	8	14
8412	2009-01-28	"Wed"	"Midday"	"648"	6	4	8	18
8411	2009-01-27	"Tue"	"Evening"	"452"	4	5	2	11
8410	2009-01-27	"Tue"	"Midday"	"094"	0	9	4	13
8409	2009-01-26	"Mon"	"Evening"	"239"	2	3	9	14
8408	2009-01-26	"Mon"	"Midday"	"423"	4	2	3	9
8407	2009-01-25	"Sun"	"Evening"	"503"	5	0	3	8
8406	2009-01-25	"Sun"	"Midday"	"494"	4	9	4	17
8405	2009-01-24	"Sat"	"Evening"	"267"	2	6	7	15
8404	2009-01-24	"Sat"	"Midday"	"029"	0	2	9	11
8403	2009-01-23	"Fri"	"Evening"	"843"	8	4	3	15
8402	2009-01-23	"Fri"	"Midday"	"466"	4	6	6	16
8401	2009-01-22	"Thu"	"Evening"	"627"	6	2	7	15
8400	2009-01-22	"Thu"	"Midday"	"505"	5	0	5	10
8399	2009-01-21	"Wed"	"Evening"	"315"	3	1	5	9
8398	2009-01-21	"Wed"	"Midday"	"451"	4	5	1	10
8397	2009-01-20	"Tue"	"Evening"	"131"	1	3	1	5
8396	2009-01-20	"Tue"	"Midday"	"590"	5	9	0	14
8395	2009-01-19	"Mon"	"Evening"	"159"	1	5	9	15
8394	2009-01-19	"Mon"	"Midday"	"766"	7	6	6	19
8393	2009-01-18	"Sun"	"Evening"	"352"	3	5	2	10
8392	2009-01-18	"Sun"	"Midday"	"364"	3	6	4	13
8391	2009-01-17	"Sat"	"Evening"	"786"	7	8	6	21
8390	2009-01-17	"Sat"	"Midday"	"270"	2	7	0	9
8389	2009-01-16	"Fri"	"Evening"	"595"	5	9	5	19
8388	2009-01-16	"Fri"	"Midday"	"048"	0	4	8	12
8387	2009-01-15	"Thu"	"Evening"	"056"	0	5	6	11
8386	2009-01-15	"Thu"	"Midday"	"306"	3	0	6	9
8385	2009-01-14	"Wed"	"Evening"	"531"	5	3	1	9
8384	2009-01-14	"Wed"	"Midday"	"881"	8	8	1	17
8383	2009-01-13	"Tue"	"Evening"	"067"	0	6	7	13
8382	2009-01-13	"Tue"	"Midday"	"707"	7	0	7	14
8381	2009-01-12	"Mon"	"Evening"	"518"	5	1	8	14
8380	2009-01-12	"Mon"	"Midday"	"216"	2	1	6	9
8379	2009-01-11	"Sun"	"Evening"	"914"	9	1	4	14
8378	2009-01-11	"Sun"	"Midday"	"058"	0	5	8	13
8377	2009-01-10	"Sat"	"Evening"	"362"	3	6	2	11
8376	2009-01-10	"Sat"	"Midday"	"931"	9	3	1	13
8375	2009-01-09	"Fri"	"Evening"	"533"	5	3	3	11
8374	2009-01-09	"Fri"	"Midday"	"213"	2	1	3	6
8373	2009-01-08	"Thu"	"Evening"	"713"	7	1	3	11
8372	2009-01-08	"Thu"	"Midday"	"186"	1	8	6	15
8371	2009-01-07	"Wed"	"Evening"	"689"	6	8	9	23
8370	2009-01-07	"Wed"	"Midday"	"305"	3	0	5	8
8369	2009-01-06	"Tue"	"Evening"	"798"	7	9	8	24
8368	2009-01-06	"Tue"	"Midday"	"896"	8	9	6	23
8367	2009-01-05	"Mon"	"Evening"	"686"	6	8	6	20
8366	2009-01-05	"Mon"	"Midday"	"645"	6	4	5	15
8365	2009-01-04	"Sun"	"Evening"	"436"	4	3	6	13
8364	2009-01-04	"Sun"	"Midday"	"760"	7	6	0	13
8363	2009-01-03	"Sat"	"Evening"	"659"	6	5	9	20
8362	2009-01-03	"Sat"	"Midday"	"768"	7	6	8	21
8361	2009-01-02	"Fri"	"Evening"	"969"	9	6	9	24
8360	2009-01-02	"Fri"	"Midday"	"544"	5	4	4	13
8359	2009-01-01	"Thu"	"Evening"	"621"	6	2	1	9
8358	2009-01-01	"Thu"	"Midday"	"073"	0	7	3	10
8357	2008-12-31	"Wed"	"Evening"	"663"	6	6	3	15
8356	2008-12-31	"Wed"	"Midday"	"679"	6	7	9	22
8355	2008-12-30	"Tue"	"Evening"	"954"	9	5	4	18
8354	2008-12-30	"Tue"	"Midday"	"372"	3	7	2	12
8353	2008-12-29	"Mon"	"Evening"	"212"	2	1	2	5
8352	2008-12-29	"Mon"	"Midday"	"958"	9	5	8	22
8351	2008-12-28	"Sun"	"Evening"	"396"	3	9	6	18
8350	2008-12-28	"Sun"	"Midday"	"475"	4	7	5	16
8349	2008-12-27	"Sat"	"Evening"	"345"	3	4	5	12
8348	2008-12-27	"Sat"	"Midday"	"081"	0	8	1	9
8347	2008-12-26	"Fri"	"Evening"	"853"	8	5	3	16
8346	2008-12-26	"Fri"	"Midday"	"614"	6	1	4	11
8345	2008-12-25	"Thu"	"Evening"	"034"	0	3	4	7
8344	2008-12-25	"Thu"	"Midday"	"110"	1	1	0	2
8343	2008-12-24	"Wed"	"Evening"	"132"	1	3	2	6
8342	2008-12-24	"Wed"	"Midday"	"913"	9	1	3	13
8341	2008-12-23	"Tue"	"Evening"	"683"	6	8	3	17
8340	2008-12-23	"Tue"	"Midday"	"082"	0	8	2	10
8339	2008-12-22	"Mon"	"Evening"	"433"	4	3	3	10
8338	2008-12-22	"Mon"	"Midday"	"956"	9	5	6	20
8337	2008-12-21	"Sun"	"Evening"	"797"	7	9	7	23
8336	2008-12-21	"Sun"	"Midday"	"728"	7	2	8	17
8335	2008-12-20	"Sat"	"Evening"	"980"	9	8	0	17
8334	2008-12-20	"Sat"	"Midday"	"917"	9	1	7	17
8333	2008-12-19	"Fri"	"Evening"	"605"	6	0	5	11
8332	2008-12-19	"Fri"	"Midday"	"519"	5	1	9	15
8331	2008-12-18	"Thu"	"Evening"	"674"	6	7	4	17
8330	2008-12-18	"Thu"	"Midday"	"403"	4	0	3	7
8329	2008-12-17	"Wed"	"Evening"	"517"	5	1	7	13
8328	2008-12-17	"Wed"	"Midday"	"590"	5	9	0	14
8327	2008-12-16	"Tue"	"Evening"	"654"	6	5	4	15
8326	2008-12-16	"Tue"	"Midday"	"545"	5	4	5	14
8325	2008-12-15	"Mon"	"Evening"	"750"	7	5	0	12
8324	2008-12-15	"Mon"	"Midday"	"829"	8	2	9	19
8323	2008-12-14	"Sun"	"Evening"	"393"	3	9	3	15
8322	2008-12-14	"Sun"	"Midday"	"531"	5	3	1	9
8321	2008-12-13	"Sat"	"Evening"	"622"	6	2	2	10
8320	2008-12-13	"Sat"	"Midday"	"547"	5	4	7	16
8319	2008-12-12	"Fri"	"Evening"	"368"	3	6	8	17
8318	2008-12-12	"Fri"	"Midday"	"374"	3	7	4	14
8317	2008-12-11	"Thu"	"Evening"	"966"	9	6	6	21
8316	2008-12-11	"Thu"	"Midday"	"158"	1	5	8	14
8315	2008-12-10	"Wed"	"Evening"	"493"	4	9	3	16
8314	2008-12-10	"Wed"	"Midday"	"208"	2	0	8	10
8313	2008-12-09	"Tue"	"Evening"	"236"	2	3	6	11
8312	2008-12-09	"Tue"	"Midday"	"777"	7	7	7	21
8311	2008-12-08	"Mon"	"Evening"	"126"	1	2	6	9
8310	2008-12-08	"Mon"	"Midday"	"660"	6	6	0	12
8309	2008-12-07	"Sun"	"Evening"	"135"	1	3	5	9
8308	2008-12-07	"Sun"	"Midday"	"245"	2	4	5	11
8307	2008-12-06	"Sat"	"Evening"	"401"	4	0	1	5
8306	2008-12-06	"Sat"	"Midday"	"649"	6	4	9	19
8305	2008-12-05	"Fri"	"Evening"	"947"	9	4	7	20
8304	2008-12-05	"Fri"	"Midday"	"598"	5	9	8	22
8303	2008-12-04	"Thu"	"Evening"	"540"	5	4	0	9
8302	2008-12-04	"Thu"	"Midday"	"080"	0	8	0	8
8301	2008-12-03	"Wed"	"Evening"	"826"	8	2	6	16
8300	2008-12-03	"Wed"	"Midday"	"369"	3	6	9	18
8299	2008-12-02	"Tue"	"Evening"	"739"	7	3	9	19
8298	2008-12-02	"Tue"	"Midday"	"452"	4	5	2	11
8297	2008-12-01	"Mon"	"Evening"	"164"	1	6	4	11
8296	2008-12-01	"Mon"	"Midday"	"812"	8	1	2	11
8295	2008-11-30	"Sun"	"Evening"	"945"	9	4	5	18
8294	2008-11-30	"Sun"	"Midday"	"232"	2	3	2	7
8293	2008-11-29	"Sat"	"Evening"	"720"	7	2	0	9
8292	2008-11-29	"Sat"	"Midday"	"263"	2	6	3	11
8291	2008-11-28	"Fri"	"Evening"	"887"	8	8	7	23
8290	2008-11-28	"Fri"	"Midday"	"796"	7	9	6	22
8289	2008-11-27	"Thu"	"Evening"	"180"	1	8	0	9
8288	2008-11-27	"Thu"	"Midday"	"211"	2	1	1	4
8287	2008-11-26	"Wed"	"Evening"	"594"	5	9	4	18
8286	2008-11-26	"Wed"	"Midday"	"700"	7	0	0	7
8285	2008-11-25	"Tue"	"Evening"	"061"	0	6	1	7
8284	2008-11-25	"Tue"	"Midday"	"249"	2	4	9	15
8283	2008-11-24	"Mon"	"Evening"	"461"	4	6	1	11
8282	2008-11-24	"Mon"	"Midday"	"355"	3	5	5	13
8281	2008-11-23	"Sun"	"Evening"	"435"	4	3	5	12
8280	2008-11-23	"Sun"	"Midday"	"557"	5	5	7	17
8279	2008-11-22	"Sat"	"Evening"	"832"	8	3	2	13
8278	2008-11-22	"Sat"	"Midday"	"348"	3	4	8	15
8277	2008-11-21	"Fri"	"Evening"	"109"	1	0	9	10
8276	2008-11-21	"Fri"	"Midday"	"154"	1	5	4	10
8275	2008-11-20	"Thu"	"Evening"	"995"	9	9	5	23
8274	2008-11-20	"Thu"	"Midday"	"464"	4	6	4	14
8273	2008-11-19	"Wed"	"Evening"	"011"	0	1	1	2
8272	2008-11-19	"Wed"	"Midday"	"711"	7	1	1	9
8271	2008-11-18	"Tue"	"Evening"	"542"	5	4	2	11
8270	2008-11-18	"Tue"	"Midday"	"324"	3	2	4	9
8269	2008-11-17	"Mon"	"Evening"	"991"	9	9	1	19
8268	2008-11-17	"Mon"	"Midday"	"943"	9	4	3	16
8267	2008-11-16	"Sun"	"Evening"	"421"	4	2	1	7
8266	2008-11-16	"Sun"	"Midday"	"470"	4	7	0	11
8265	2008-11-15	"Sat"	"Evening"	"668"	6	6	8	20
8264	2008-11-15	"Sat"	"Midday"	"052"	0	5	2	7
8263	2008-11-14	"Fri"	"Evening"	"777"	7	7	7	21
8262	2008-11-14	"Fri"	"Midday"	"266"	2	6	6	14
8261	2008-11-13	"Thu"	"Evening"	"532"	5	3	2	10
8260	2008-11-13	"Thu"	"Midday"	"491"	4	9	1	14
8259	2008-11-12	"Wed"	"Evening"	"570"	5	7	0	12
8258	2008-11-12	"Wed"	"Midday"	"934"	9	3	4	16
8257	2008-11-11	"Tue"	"Evening"	"141"	1	4	1	6
8256	2008-11-11	"Tue"	"Midday"	"222"	2	2	2	6
8255	2008-11-10	"Mon"	"Evening"	"309"	3	0	9	12
8254	2008-11-10	"Mon"	"Midday"	"608"	6	0	8	14
8253	2008-11-09	"Sun"	"Evening"	"164"	1	6	4	11
8252	2008-11-09	"Sun"	"Midday"	"542"	5	4	2	11
8251	2008-11-08	"Sat"	"Evening"	"419"	4	1	9	14
8250	2008-11-08	"Sat"	"Midday"	"998"	9	9	8	26
8249	2008-11-07	"Fri"	"Evening"	"753"	7	5	3	15
8248	2008-11-07	"Fri"	"Midday"	"017"	0	1	7	8
8247	2008-11-06	"Thu"	"Evening"	"986"	9	8	6	23
8246	2008-11-06	"Thu"	"Midday"	"796"	7	9	6	22
8245	2008-11-05	"Wed"	"Evening"	"528"	5	2	8	15
8244	2008-11-05	"Wed"	"Midday"	"355"	3	5	5	13
8243	2008-11-04	"Tue"	"Evening"	"838"	8	3	8	19
8242	2008-11-04	"Tue"	"Midday"	"051"	0	5	1	6
8241	2008-11-03	"Mon"	"Evening"	"623"	6	2	3	11
8240	2008-11-03	"Mon"	"Midday"	"940"	9	4	0	13
8239	2008-11-02	"Sun"	"Evening"	"241"	2	4	1	7
8238	2008-11-02	"Sun"	"Midday"	"146"	1	4	6	11
8237	2008-11-01	"Sat"	"Evening"	"866"	8	6	6	20
8236	2008-11-01	"Sat"	"Midday"	"382"	3	8	2	13
8235	2008-10-31	"Fri"	"Evening"	"575"	5	7	5	17
8234	2008-10-31	"Fri"	"Midday"	"768"	7	6	8	21
8233	2008-10-30	"Thu"	"Evening"	"303"	3	0	3	6
8232	2008-10-30	"Thu"	"Midday"	"884"	8	8	4	20
8231	2008-10-29	"Wed"	"Evening"	"773"	7	7	3	17
8230	2008-10-29	"Wed"	"Midday"	"994"	9	9	4	22
8229	2008-10-28	"Tue"	"Evening"	"932"	9	3	2	14
8228	2008-10-28	"Tue"	"Midday"	"475"	4	7	5	16
8227	2008-10-27	"Mon"	"Evening"	"827"	8	2	7	17
8226	2008-10-27	"Mon"	"Midday"	"762"	7	6	2	15
8225	2008-10-26	"Sun"	"Evening"	"200"	2	0	0	2
8224	2008-10-26	"Sun"	"Midday"	"874"	8	7	4	19
8223	2008-10-25	"Sat"	"Evening"	"703"	7	0	3	10
8222	2008-10-25	"Sat"	"Midday"	"633"	6	3	3	12
8221	2008-10-24	"Fri"	"Evening"	"200"	2	0	0	2
8220	2008-10-24	"Fri"	"Midday"	"344"	3	4	4	11
8219	2008-10-23	"Thu"	"Evening"	"821"	8	2	1	11
8218	2008-10-23	"Thu"	"Midday"	"394"	3	9	4	16
8217	2008-10-22	"Wed"	"Evening"	"191"	1	9	1	11
8216	2008-10-22	"Wed"	"Midday"	"190"	1	9	0	10
8215	2008-10-21	"Tue"	"Evening"	"645"	6	4	5	15
8214	2008-10-21	"Tue"	"Midday"	"676"	6	7	6	19
8213	2008-10-20	"Mon"	"Evening"	"968"	9	6	8	23
8212	2008-10-20	"Mon"	"Midday"	"621"	6	2	1	9
8211	2008-10-19	"Sun"	"Evening"	"444"	4	4	4	12
8210	2008-10-19	"Sun"	"Midday"	"174"	1	7	4	12
8209	2008-10-18	"Sat"	"Evening"	"050"	0	5	0	5
8208	2008-10-18	"Sat"	"Midday"	"916"	9	1	6	16
8207	2008-10-17	"Fri"	"Evening"	"775"	7	7	5	19
8206	2008-10-17	"Fri"	"Midday"	"913"	9	1	3	13
8205	2008-10-16	"Thu"	"Evening"	"415"	4	1	5	10
8204	2008-10-16	"Thu"	"Midday"	"525"	5	2	5	12
8203	2008-10-15	"Wed"	"Evening"	"376"	3	7	6	16
8202	2008-10-15	"Wed"	"Midday"	"539"	5	3	9	17
8201	2008-10-14	"Tue"	"Evening"	"838"	8	3	8	19
8200	2008-10-14	"Tue"	"Midday"	"547"	5	4	7	16
8199	2008-10-13	"Mon"	"Evening"	"060"	0	6	0	6
8198	2008-10-13	"Mon"	"Midday"	"220"	2	2	0	4
8197	2008-10-12	"Sun"	"Evening"	"659"	6	5	9	20
8196	2008-10-12	"Sun"	"Midday"	"079"	0	7	9	16
8195	2008-10-11	"Sat"	"Evening"	"785"	7	8	5	20
8194	2008-10-11	"Sat"	"Midday"	"641"	6	4	1	11
8193	2008-10-10	"Fri"	"Evening"	"261"	2	6	1	9
8192	2008-10-10	"Fri"	"Midday"	"456"	4	5	6	15
8191	2008-10-09	"Thu"	"Evening"	"049"	0	4	9	13
8190	2008-10-09	"Thu"	"Midday"	"764"	7	6	4	17
8189	2008-10-08	"Wed"	"Evening"	"359"	3	5	9	17
8188	2008-10-08	"Wed"	"Midday"	"602"	6	0	2	8
8187	2008-10-07	"Tue"	"Evening"	"318"	3	1	8	12
8186	2008-10-07	"Tue"	"Midday"	"220"	2	2	0	4
8185	2008-10-06	"Mon"	"Evening"	"517"	5	1	7	13
8184	2008-10-06	"Mon"	"Midday"	"503"	5	0	3	8
8183	2008-10-05	"Sun"	"Evening"	"617"	6	1	7	14
8182	2008-10-05	"Sun"	"Midday"	"355"	3	5	5	13
8181	2008-10-04	"Sat"	"Evening"	"066"	0	6	6	12
8180	2008-10-04	"Sat"	"Midday"	"676"	6	7	6	19
8179	2008-10-03	"Fri"	"Evening"	"518"	5	1	8	14
8178	2008-10-03	"Fri"	"Midday"	"565"	5	6	5	16
8177	2008-10-02	"Thu"	"Evening"	"728"	7	2	8	17
8176	2008-10-02	"Thu"	"Midday"	"711"	7	1	1	9
8175	2008-10-01	"Wed"	"Evening"	"251"	2	5	1	8
8174	2008-10-01	"Wed"	"Midday"	"822"	8	2	2	12
8173	2008-09-30	"Tue"	"Evening"	"111"	1	1	1	3
8172	2008-09-30	"Tue"	"Midday"	"981"	9	8	1	18
8171	2008-09-29	"Mon"	"Evening"	"011"	0	1	1	2
8170	2008-09-29	"Mon"	"Midday"	"590"	5	9	0	14
8169	2008-09-28	"Sun"	"Evening"	"983"	9	8	3	20
8168	2008-09-28	"Sun"	"Midday"	"978"	9	7	8	24
8167	2008-09-27	"Sat"	"Evening"	"573"	5	7	3	15
8166	2008-09-27	"Sat"	"Midday"	"567"	5	6	7	18
8165	2008-09-26	"Fri"	"Evening"	"764"	7	6	4	17
8164	2008-09-26	"Fri"	"Midday"	"633"	6	3	3	12
8163	2008-09-25	"Thu"	"Evening"	"219"	2	1	9	12
8162	2008-09-25	"Thu"	"Midday"	"336"	3	3	6	12
8161	2008-09-24	"Wed"	"Evening"	"060"	0	6	0	6
8160	2008-09-24	"Wed"	"Midday"	"803"	8	0	3	11
8159	2008-09-23	"Tue"	"Evening"	"504"	5	0	4	9
8158	2008-09-23	"Tue"	"Midday"	"584"	5	8	4	17
8157	2008-09-22	"Mon"	"Evening"	"436"	4	3	6	13
8156	2008-09-22	"Mon"	"Midday"	"233"	2	3	3	8
8155	2008-09-21	"Sun"	"Evening"	"394"	3	9	4	16
8154	2008-09-21	"Sun"	"Midday"	"473"	4	7	3	14
8153	2008-09-20	"Sat"	"Evening"	"642"	6	4	2	12
8152	2008-09-20	"Sat"	"Midday"	"147"	1	4	7	12
8151	2008-09-19	"Fri"	"Evening"	"007"	0	0	7	7
8150	2008-09-19	"Fri"	"Midday"	"180"	1	8	0	9
8149	2008-09-18	"Thu"	"Evening"	"650"	6	5	0	11
8148	2008-09-18	"Thu"	"Midday"	"571"	5	7	1	13
8147	2008-09-17	"Wed"	"Evening"	"614"	6	1	4	11
8146	2008-09-17	"Wed"	"Midday"	"333"	3	3	3	9
8145	2008-09-16	"Tue"	"Evening"	"058"	0	5	8	13
8144	2008-09-16	"Tue"	"Midday"	"929"	9	2	9	20
8143	2008-09-15	"Mon"	"Evening"	"139"	1	3	9	13
8142	2008-09-15	"Mon"	"Midday"	"090"	0	9	0	9
8141	2008-09-14	"Sun"	"Evening"	"485"	4	8	5	17
8140	2008-09-14	"Sun"	"Midday"	"627"	6	2	7	15
8139	2008-09-13	"Sat"	"Evening"	"197"	1	9	7	17
8138	2008-09-13	"Sat"	"Midday"	"127"	1	2	7	10
8137	2008-09-12	"Fri"	"Evening"	"140"	1	4	0	5
8136	2008-09-12	"Fri"	"Midday"	"291"	2	9	1	12
8135	2008-09-11	"Thu"	"Evening"	"030"	0	3	0	3
8134	2008-09-11	"Thu"	"Midday"	"586"	5	8	6	19
8133	2008-09-10	"Wed"	"Evening"	"279"	2	7	9	18
8132	2008-09-10	"Wed"	"Midday"	"347"	3	4	7	14
8131	2008-09-09	"Tue"	"Evening"	"498"	4	9	8	21
8130	2008-09-09	"Tue"	"Midday"	"686"	6	8	6	20
8129	2008-09-08	"Mon"	"Evening"	"904"	9	0	4	13
8128	2008-09-08	"Mon"	"Midday"	"508"	5	0	8	13
8127	2008-09-07	"Sun"	"Evening"	"897"	8	9	7	24
8126	2008-09-07	"Sun"	"Midday"	"381"	3	8	1	12
8125	2008-09-06	"Sat"	"Evening"	"730"	7	3	0	10
8124	2008-09-06	"Sat"	"Midday"	"282"	2	8	2	12
8123	2008-09-05	"Fri"	"Evening"	"771"	7	7	1	15
8122	2008-09-05	"Fri"	"Midday"	"485"	4	8	5	17
8121	2008-09-04	"Thu"	"Evening"	"817"	8	1	7	16
8120	2008-09-04	"Thu"	"Midday"	"003"	0	0	3	3
8119	2008-09-03	"Wed"	"Evening"	"769"	7	6	9	22
8118	2008-09-03	"Wed"	"Midday"	"669"	6	6	9	21
8117	2008-09-02	"Tue"	"Evening"	"357"	3	5	7	15
8116	2008-09-02	"Tue"	"Midday"	"970"	9	7	0	16
8115	2008-09-01	"Mon"	"Evening"	"865"	8	6	5	19
8114	2008-09-01	"Mon"	"Midday"	"988"	9	8	8	25
8113	2008-08-31	"Sun"	"Evening"	"073"	0	7	3	10
8112	2008-08-31	"Sun"	"Midday"	"198"	1	9	8	18
8111	2008-08-30	"Sat"	"Evening"	"783"	7	8	3	18
8110	2008-08-30	"Sat"	"Midday"	"988"	9	8	8	25
8109	2008-08-29	"Fri"	"Evening"	"130"	1	3	0	4
8108	2008-08-29	"Fri"	"Midday"	"083"	0	8	3	11
8107	2008-08-28	"Thu"	"Evening"	"895"	8	9	5	22
8106	2008-08-28	"Thu"	"Midday"	"699"	6	9	9	24
8105	2008-08-27	"Wed"	"Evening"	"502"	5	0	2	7
8104	2008-08-27	"Wed"	"Midday"	"964"	9	6	4	19
8103	2008-08-26	"Tue"	"Evening"	"202"	2	0	2	4
8102	2008-08-26	"Tue"	"Midday"	"255"	2	5	5	12
8101	2008-08-25	"Mon"	"Evening"	"000"	0	0	0	0
8100	2008-08-25	"Mon"	"Midday"	"462"	4	6	2	12
8099	2008-08-24	"Sun"	"Evening"	"078"	0	7	8	15
8098	2008-08-24	"Sun"	"Midday"	"569"	5	6	9	20
8097	2008-08-23	"Sat"	"Evening"	"764"	7	6	4	17
8096	2008-08-23	"Sat"	"Midday"	"361"	3	6	1	10
8095	2008-08-22	"Fri"	"Evening"	"681"	6	8	1	15
8094	2008-08-22	"Fri"	"Midday"	"998"	9	9	8	26
8093	2008-08-21	"Thu"	"Evening"	"213"	2	1	3	6
8092	2008-08-21	"Thu"	"Midday"	"766"	7	6	6	19
8091	2008-08-20	"Wed"	"Evening"	"322"	3	2	2	7
8090	2008-08-20	"Wed"	"Midday"	"948"	9	4	8	21
8089	2008-08-19	"Tue"	"Evening"	"189"	1	8	9	18
8088	2008-08-19	"Tue"	"Midday"	"881"	8	8	1	17
8087	2008-08-18	"Mon"	"Evening"	"053"	0	5	3	8
8086	2008-08-18	"Mon"	"Midday"	"920"	9	2	0	11
8085	2008-08-17	"Sun"	"Evening"	"856"	8	5	6	19
8084	2008-08-17	"Sun"	"Midday"	"332"	3	3	2	8
8083	2008-08-16	"Sat"	"Evening"	"675"	6	7	5	18
8082	2008-08-16	"Sat"	"Midday"	"285"	2	8	5	15
8081	2008-08-15	"Fri"	"Evening"	"306"	3	0	6	9
8080	2008-08-15	"Fri"	"Midday"	"140"	1	4	0	5
8079	2008-08-14	"Thu"	"Evening"	"286"	2	8	6	16
8078	2008-08-14	"Thu"	"Midday"	"410"	4	1	0	5
8077	2008-08-13	"Wed"	"Evening"	"003"	0	0	3	3
8076	2008-08-13	"Wed"	"Midday"	"050"	0	5	0	5
8075	2008-08-12	"Tue"	"Evening"	"941"	9	4	1	14
8074	2008-08-12	"Tue"	"Midday"	"986"	9	8	6	23
8073	2008-08-11	"Mon"	"Evening"	"918"	9	1	8	18
8072	2008-08-11	"Mon"	"Midday"	"968"	9	6	8	23
8071	2008-08-10	"Sun"	"Evening"	"716"	7	1	6	14
8070	2008-08-10	"Sun"	"Midday"	"668"	6	6	8	20
8069	2008-08-09	"Sat"	"Evening"	"449"	4	4	9	17
8068	2008-08-09	"Sat"	"Midday"	"890"	8	9	0	17
8067	2008-08-08	"Fri"	"Evening"	"798"	7	9	8	24
8066	2008-08-08	"Fri"	"Midday"	"198"	1	9	8	18
8065	2008-08-07	"Thu"	"Evening"	"525"	5	2	5	12
8064	2008-08-07	"Thu"	"Midday"	"069"	0	6	9	15
8063	2008-08-06	"Wed"	"Evening"	"590"	5	9	0	14
8062	2008-08-06	"Wed"	"Midday"	"015"	0	1	5	6
8061	2008-08-05	"Tue"	"Evening"	"370"	3	7	0	10
8060	2008-08-05	"Tue"	"Midday"	"769"	7	6	9	22
8059	2008-08-04	"Mon"	"Evening"	"127"	1	2	7	10
8058	2008-08-04	"Mon"	"Midday"	"899"	8	9	9	26
8057	2008-08-03	"Sun"	"Evening"	"240"	2	4	0	6
8056	2008-08-03	"Sun"	"Midday"	"764"	7	6	4	17
8055	2008-08-02	"Sat"	"Evening"	"414"	4	1	4	9
8054	2008-08-02	"Sat"	"Midday"	"346"	3	4	6	13
8053	2008-08-01	"Fri"	"Evening"	"854"	8	5	4	17
8052	2008-08-01	"Fri"	"Midday"	"385"	3	8	5	16
8051	2008-07-31	"Thu"	"Evening"	"250"	2	5	0	7
8050	2008-07-31	"Thu"	"Midday"	"320"	3	2	0	5
8049	2008-07-30	"Wed"	"Evening"	"141"	1	4	1	6
8048	2008-07-30	"Wed"	"Midday"	"171"	1	7	1	9
8047	2008-07-29	"Tue"	"Evening"	"826"	8	2	6	16
8046	2008-07-29	"Tue"	"Midday"	"651"	6	5	1	12
8045	2008-07-28	"Mon"	"Evening"	"262"	2	6	2	10
8044	2008-07-28	"Mon"	"Midday"	"156"	1	5	6	12
8043	2008-07-27	"Sun"	"Evening"	"265"	2	6	5	13
8042	2008-07-27	"Sun"	"Midday"	"285"	2	8	5	15
8041	2008-07-26	"Sat"	"Evening"	"557"	5	5	7	17
8040	2008-07-26	"Sat"	"Midday"	"944"	9	4	4	17
8039	2008-07-25	"Fri"	"Evening"	"145"	1	4	5	10
8038	2008-07-25	"Fri"	"Midday"	"345"	3	4	5	12
8037	2008-07-24	"Thu"	"Evening"	"253"	2	5	3	10
8036	2008-07-24	"Thu"	"Midday"	"863"	8	6	3	17
8035	2008-07-23	"Wed"	"Evening"	"512"	5	1	2	8
8034	2008-07-23	"Wed"	"Midday"	"505"	5	0	5	10
8033	2008-07-22	"Tue"	"Evening"	"069"	0	6	9	15
8032	2008-07-22	"Tue"	"Midday"	"716"	7	1	6	14
8031	2008-07-21	"Mon"	"Evening"	"798"	7	9	8	24
8030	2008-07-21	"Mon"	"Midday"	"129"	1	2	9	12
8029	2008-07-20	"Sun"	"Evening"	"076"	0	7	6	13
8028	2008-07-20	"Sun"	"Midday"	"214"	2	1	4	7
8027	2008-07-19	"Sat"	"Evening"	"141"	1	4	1	6
8026	2008-07-19	"Sat"	"Midday"	"373"	3	7	3	13
8025	2008-07-18	"Fri"	"Evening"	"328"	3	2	8	13
8024	2008-07-18	"Fri"	"Midday"	"521"	5	2	1	8
8023	2008-07-17	"Thu"	"Evening"	"555"	5	5	5	15
8022	2008-07-17	"Thu"	"Midday"	"015"	0	1	5	6
8021	2008-07-16	"Wed"	"Evening"	"206"	2	0	6	8
8020	2008-07-16	"Wed"	"Midday"	"240"	2	4	0	6
8019	2008-07-15	"Tue"	"Evening"	"356"	3	5	6	14
8018	2008-07-15	"Tue"	"Midday"	"620"	6	2	0	8
8017	2008-07-14	"Mon"	"Evening"	"127"	1	2	7	10
8016	2008-07-14	"Mon"	"Midday"	"064"	0	6	4	10
8015	2008-07-13	"Sun"	"Evening"	"344"	3	4	4	11
8014	2008-07-13	"Sun"	"Midday"	"373"	3	7	3	13
8013	2008-07-12	"Sat"	"Evening"	"707"	7	0	7	14
8012	2008-07-12	"Sat"	"Midday"	"670"	6	7	0	13
8011	2008-07-11	"Fri"	"Evening"	"793"	7	9	3	19
8010	2008-07-11	"Fri"	"Midday"	"823"	8	2	3	13
8009	2008-07-10	"Thu"	"Evening"	"535"	5	3	5	13
8008	2008-07-10	"Thu"	"Midday"	"331"	3	3	1	7
8007	2008-07-09	"Wed"	"Evening"	"826"	8	2	6	16
8006	2008-07-09	"Wed"	"Midday"	"148"	1	4	8	13
8005	2008-07-08	"Tue"	"Evening"	"085"	0	8	5	13
8004	2008-07-08	"Tue"	"Midday"	"324"	3	2	4	9
8003	2008-07-07	"Mon"	"Evening"	"106"	1	0	6	7
8002	2008-07-07	"Mon"	"Midday"	"781"	7	8	1	16
8001	2008-07-06	"Sun"	"Evening"	"877"	8	7	7	22
8000	2008-07-06	"Sun"	"Midday"	"731"	7	3	1	11
7999	2008-07-05	"Sat"	"Evening"	"453"	4	5	3	12
7998	2008-07-05	"Sat"	"Midday"	"416"	4	1	6	11
7997	2008-07-04	"Fri"	"Evening"	"916"	9	1	6	16
7996	2008-07-04	"Fri"	"Midday"	"915"	9	1	5	15
7995	2008-07-03	"Thu"	"Evening"	"837"	8	3	7	18
7994	2008-07-03	"Thu"	"Midday"	"011"	0	1	1	2
7993	2008-07-02	"Wed"	"Evening"	"548"	5	4	8	17
7992	2008-07-02	"Wed"	"Midday"	"509"	5	0	9	14
7991	2008-07-01	"Tue"	"Evening"	"536"	5	3	6	14
7990	2008-07-01	"Tue"	"Midday"	"240"	2	4	0	6
7989	2008-06-30	"Mon"	"Evening"	"426"	4	2	6	12
7988	2008-06-30	"Mon"	"Midday"	"416"	4	1	6	11
7987	2008-06-29	"Sun"	"Evening"	"253"	2	5	3	10
7986	2008-06-29	"Sun"	"Midday"	"913"	9	1	3	13
7985	2008-06-28	"Sat"	"Evening"	"149"	1	4	9	14
7984	2008-06-28	"Sat"	"Midday"	"674"	6	7	4	17
7983	2008-06-27	"Fri"	"Evening"	"777"	7	7	7	21
7982	2008-06-27	"Fri"	"Midday"	"189"	1	8	9	18
7981	2008-06-26	"Thu"	"Evening"	"907"	9	0	7	16
7980	2008-06-26	"Thu"	"Midday"	"705"	7	0	5	12
7979	2008-06-25	"Wed"	"Evening"	"441"	4	4	1	9
7978	2008-06-25	"Wed"	"Midday"	"809"	8	0	9	17
7977	2008-06-24	"Tue"	"Evening"	"176"	1	7	6	14
7976	2008-06-24	"Tue"	"Midday"	"376"	3	7	6	16
7975	2008-06-23	"Mon"	"Evening"	"759"	7	5	9	21
7974	2008-06-23	"Mon"	"Midday"	"248"	2	4	8	14
7973	2008-06-22	"Sun"	"Evening"	"097"	0	9	7	16
7972	2008-06-22	"Sun"	"Midday"	"870"	8	7	0	15
7971	2008-06-21	"Sat"	"Evening"	"063"	0	6	3	9
7970	2008-06-21	"Sat"	"Midday"	"304"	3	0	4	7
7969	2008-06-20	"Fri"	"Evening"	"021"	0	2	1	3
7968	2008-06-20	"Fri"	"Midday"	"498"	4	9	8	21
7967	2008-06-19	"Thu"	"Evening"	"259"	2	5	9	16
7966	2008-06-19	"Thu"	"Midday"	"984"	9	8	4	21
7965	2008-06-18	"Wed"	"Evening"	"050"	0	5	0	5
7964	2008-06-18	"Wed"	"Midday"	"345"	3	4	5	12
7963	2008-06-17	"Tue"	"Evening"	"609"	6	0	9	15
7962	2008-06-17	"Tue"	"Midday"	"163"	1	6	3	10
7961	2008-06-16	"Mon"	"Evening"	"495"	4	9	5	18
7960	2008-06-16	"Mon"	"Midday"	"888"	8	8	8	24
7959	2008-06-15	"Sun"	"Evening"	"815"	8	1	5	14
7958	2008-06-15	"Sun"	"Midday"	"693"	6	9	3	18
7957	2008-06-14	"Sat"	"Evening"	"924"	9	2	4	15
7956	2008-06-14	"Sat"	"Midday"	"075"	0	7	5	12
7955	2008-06-13	"Fri"	"Evening"	"711"	7	1	1	9
7954	2008-06-13	"Fri"	"Midday"	"681"	6	8	1	15
7953	2008-06-12	"Thu"	"Evening"	"216"	2	1	6	9
7952	2008-06-12	"Thu"	"Midday"	"014"	0	1	4	5
7951	2008-06-11	"Wed"	"Evening"	"641"	6	4	1	11
7950	2008-06-11	"Wed"	"Midday"	"399"	3	9	9	21
7949	2008-06-10	"Tue"	"Evening"	"197"	1	9	7	17
7948	2008-06-10	"Tue"	"Midday"	"026"	0	2	6	8
7947	2008-06-09	"Mon"	"Evening"	"953"	9	5	3	17
7946	2008-06-09	"Mon"	"Midday"	"077"	0	7	7	14
7945	2008-06-08	"Sun"	"Evening"	"630"	6	3	0	9
7944	2008-06-08	"Sun"	"Midday"	"968"	9	6	8	23
7943	2008-06-07	"Sat"	"Evening"	"140"	1	4	0	5
7942	2008-06-07	"Sat"	"Midday"	"888"	8	8	8	24
7941	2008-06-06	"Fri"	"Evening"	"391"	3	9	1	13
7940	2008-06-06	"Fri"	"Midday"	"335"	3	3	5	11
7939	2008-06-05	"Thu"	"Evening"	"194"	1	9	4	14
7938	2008-06-05	"Thu"	"Midday"	"080"	0	8	0	8
7937	2008-06-04	"Wed"	"Evening"	"400"	4	0	0	4
7936	2008-06-04	"Wed"	"Midday"	"823"	8	2	3	13
7935	2008-06-03	"Tue"	"Evening"	"360"	3	6	0	9
7934	2008-06-03	"Tue"	"Midday"	"097"	0	9	7	16
7933	2008-06-02	"Mon"	"Evening"	"310"	3	1	0	4
7932	2008-06-02	"Mon"	"Midday"	"108"	1	0	8	9
7931	2008-06-01	"Sun"	"Evening"	"087"	0	8	7	15
7930	2008-06-01	"Sun"	"Midday"	"559"	5	5	9	19
7929	2008-05-31	"Sat"	"Evening"	"443"	4	4	3	11
7928	2008-05-31	"Sat"	"Midday"	"752"	7	5	2	14
7927	2008-05-30	"Fri"	"Evening"	"475"	4	7	5	16
7926	2008-05-30	"Fri"	"Midday"	"800"	8	0	0	8
7925	2008-05-29	"Thu"	"Evening"	"551"	5	5	1	11
7924	2008-05-29	"Thu"	"Midday"	"375"	3	7	5	15
7923	2008-05-28	"Wed"	"Evening"	"564"	5	6	4	15
7922	2008-05-28	"Wed"	"Midday"	"111"	1	1	1	3
7921	2008-05-27	"Tue"	"Evening"	"734"	7	3	4	14
7920	2008-05-27	"Tue"	"Midday"	"589"	5	8	9	22
7919	2008-05-26	"Mon"	"Evening"	"961"	9	6	1	16
7918	2008-05-26	"Mon"	"Midday"	"860"	8	6	0	14
7917	2008-05-25	"Sun"	"Evening"	"159"	1	5	9	15
7916	2008-05-25	"Sun"	"Midday"	"289"	2	8	9	19
7915	2008-05-24	"Sat"	"Evening"	"960"	9	6	0	15
7914	2008-05-24	"Sat"	"Midday"	"738"	7	3	8	18
7913	2008-05-23	"Fri"	"Evening"	"636"	6	3	6	15
7912	2008-05-23	"Fri"	"Midday"	"426"	4	2	6	12
7911	2008-05-22	"Thu"	"Evening"	"455"	4	5	5	14
7910	2008-05-22	"Thu"	"Midday"	"843"	8	4	3	15
7909	2008-05-21	"Wed"	"Evening"	"117"	1	1	7	9
7908	2008-05-21	"Wed"	"Midday"	"366"	3	6	6	15
7907	2008-05-20	"Tue"	"Evening"	"780"	7	8	0	15
7906	2008-05-20	"Tue"	"Midday"	"139"	1	3	9	13
7905	2008-05-19	"Mon"	"Evening"	"116"	1	1	6	8
7904	2008-05-19	"Mon"	"Midday"	"200"	2	0	0	2
7903	2008-05-18	"Sun"	"Evening"	"973"	9	7	3	19
7902	2008-05-18	"Sun"	"Midday"	"381"	3	8	1	12
7901	2008-05-17	"Sat"	"Evening"	"497"	4	9	7	20
7900	2008-05-17	"Sat"	"Midday"	"467"	4	6	7	17
7899	2008-05-16	"Fri"	"Evening"	"225"	2	2	5	9
7898	2008-05-16	"Fri"	"Midday"	"237"	2	3	7	12
7897	2008-05-15	"Thu"	"Evening"	"547"	5	4	7	16
7896	2008-05-15	"Thu"	"Midday"	"606"	6	0	6	12
7895	2008-05-14	"Wed"	"Evening"	"315"	3	1	5	9
7894	2008-05-14	"Wed"	"Midday"	"950"	9	5	0	14
7893	2008-05-13	"Tue"	"Evening"	"811"	8	1	1	10
7892	2008-05-13	"Tue"	"Midday"	"149"	1	4	9	14
7891	2008-05-12	"Mon"	"Evening"	"354"	3	5	4	12
7890	2008-05-12	"Mon"	"Midday"	"219"	2	1	9	12
7889	2008-05-11	"Sun"	"Evening"	"493"	4	9	3	16
7888	2008-05-11	"Sun"	"Midday"	"847"	8	4	7	19
7887	2008-05-10	"Sat"	"Evening"	"800"	8	0	0	8
7886	2008-05-10	"Sat"	"Midday"	"149"	1	4	9	14
7885	2008-05-09	"Fri"	"Evening"	"676"	6	7	6	19
7884	2008-05-09	"Fri"	"Midday"	"118"	1	1	8	10
7883	2008-05-08	"Thu"	"Evening"	"403"	4	0	3	7
7882	2008-05-08	"Thu"	"Midday"	"691"	6	9	1	16
7881	2008-05-07	"Wed"	"Evening"	"413"	4	1	3	8
7880	2008-05-07	"Wed"	"Midday"	"073"	0	7	3	10
7879	2008-05-06	"Tue"	"Evening"	"998"	9	9	8	26
7878	2008-05-06	"Tue"	"Midday"	"056"	0	5	6	11
7877	2008-05-05	"Mon"	"Evening"	"717"	7	1	7	15
7876	2008-05-05	"Mon"	"Midday"	"037"	0	3	7	10
7875	2008-05-04	"Sun"	"Evening"	"079"	0	7	9	16
7874	2008-05-04	"Sun"	"Midday"	"566"	5	6	6	17
7873	2008-05-03	"Sat"	"Evening"	"277"	2	7	7	16
7872	2008-05-03	"Sat"	"Midday"	"235"	2	3	5	10
7871	2008-05-02	"Fri"	"Evening"	"357"	3	5	7	15
7870	2008-05-02	"Fri"	"Midday"	"388"	3	8	8	19
7869	2008-05-01	"Thu"	"Evening"	"784"	7	8	4	19
7868	2008-05-01	"Thu"	"Midday"	"591"	5	9	1	15
7867	2008-04-30	"Wed"	"Evening"	"213"	2	1	3	6
7866	2008-04-30	"Wed"	"Midday"	"461"	4	6	1	11
7865	2008-04-29	"Tue"	"Evening"	"668"	6	6	8	20
7864	2008-04-29	"Tue"	"Midday"	"560"	5	6	0	11
7863	2008-04-28	"Mon"	"Evening"	"906"	9	0	6	15
7862	2008-04-28	"Mon"	"Midday"	"344"	3	4	4	11
7861	2008-04-27	"Sun"	"Evening"	"710"	7	1	0	8
7860	2008-04-27	"Sun"	"Midday"	"376"	3	7	6	16
7859	2008-04-26	"Sat"	"Evening"	"897"	8	9	7	24
7858	2008-04-26	"Sat"	"Midday"	"401"	4	0	1	5
7857	2008-04-25	"Fri"	"Evening"	"360"	3	6	0	9
7856	2008-04-25	"Fri"	"Midday"	"766"	7	6	6	19
7855	2008-04-24	"Thu"	"Evening"	"090"	0	9	0	9
7854	2008-04-24	"Thu"	"Midday"	"777"	7	7	7	21
7853	2008-04-23	"Wed"	"Evening"	"390"	3	9	0	12
7852	2008-04-23	"Wed"	"Midday"	"489"	4	8	9	21
7851	2008-04-22	"Tue"	"Evening"	"422"	4	2	2	8
7850	2008-04-22	"Tue"	"Midday"	"392"	3	9	2	14
7849	2008-04-21	"Mon"	"Evening"	"176"	1	7	6	14
7848	2008-04-21	"Mon"	"Midday"	"401"	4	0	1	5
7847	2008-04-20	"Sun"	"Evening"	"976"	9	7	6	22
7846	2008-04-20	"Sun"	"Midday"	"750"	7	5	0	12
7845	2008-04-19	"Sat"	"Evening"	"862"	8	6	2	16
7844	2008-04-19	"Sat"	"Midday"	"044"	0	4	4	8
7843	2008-04-18	"Fri"	"Evening"	"113"	1	1	3	5
7842	2008-04-18	"Fri"	"Midday"	"198"	1	9	8	18
7841	2008-04-17	"Thu"	"Evening"	"079"	0	7	9	16
7840	2008-04-17	"Thu"	"Midday"	"679"	6	7	9	22
7839	2008-04-16	"Wed"	"Evening"	"613"	6	1	3	10
7838	2008-04-16	"Wed"	"Midday"	"383"	3	8	3	14
7837	2008-04-15	"Tue"	"Evening"	"385"	3	8	5	16
7836	2008-04-15	"Tue"	"Midday"	"981"	9	8	1	18
7835	2008-04-14	"Mon"	"Evening"	"422"	4	2	2	8
7834	2008-04-14	"Mon"	"Midday"	"600"	6	0	0	6
7833	2008-04-13	"Sun"	"Evening"	"722"	7	2	2	11
7832	2008-04-13	"Sun"	"Midday"	"471"	4	7	1	12
7831	2008-04-12	"Sat"	"Evening"	"754"	7	5	4	16
7830	2008-04-12	"Sat"	"Midday"	"868"	8	6	8	22
7829	2008-04-11	"Fri"	"Evening"	"770"	7	7	0	14
7828	2008-04-11	"Fri"	"Midday"	"506"	5	0	6	11
7827	2008-04-10	"Thu"	"Evening"	"670"	6	7	0	13
7826	2008-04-10	"Thu"	"Midday"	"652"	6	5	2	13
7825	2008-04-09	"Wed"	"Evening"	"821"	8	2	1	11
7824	2008-04-09	"Wed"	"Midday"	"074"	0	7	4	11
7823	2008-04-08	"Tue"	"Evening"	"595"	5	9	5	19
7822	2008-04-08	"Tue"	"Midday"	"628"	6	2	8	16
7821	2008-04-07	"Mon"	"Evening"	"198"	1	9	8	18
7820	2008-04-07	"Mon"	"Midday"	"226"	2	2	6	10
7819	2008-04-06	"Sun"	"Evening"	"834"	8	3	4	15
7818	2008-04-06	"Sun"	"Midday"	"215"	2	1	5	8
7817	2008-04-05	"Sat"	"Evening"	"812"	8	1	2	11
7816	2008-04-05	"Sat"	"Midday"	"162"	1	6	2	9
7815	2008-04-04	"Fri"	"Evening"	"945"	9	4	5	18
7814	2008-04-04	"Fri"	"Midday"	"757"	7	5	7	19
7813	2008-04-03	"Thu"	"Evening"	"593"	5	9	3	17
7812	2008-04-03	"Thu"	"Midday"	"533"	5	3	3	11
7811	2008-04-02	"Wed"	"Evening"	"313"	3	1	3	7
7810	2008-04-02	"Wed"	"Midday"	"421"	4	2	1	7
7809	2008-04-01	"Tue"	"Evening"	"428"	4	2	8	14
7808	2008-04-01	"Tue"	"Midday"	"644"	6	4	4	14
7807	2008-03-31	"Mon"	"Evening"	"147"	1	4	7	12
7806	2008-03-31	"Mon"	"Midday"	"550"	5	5	0	10
7805	2008-03-30	"Sun"	"Evening"	"816"	8	1	6	15
7804	2008-03-30	"Sun"	"Midday"	"129"	1	2	9	12
7803	2008-03-29	"Sat"	"Evening"	"855"	8	5	5	18
7802	2008-03-29	"Sat"	"Midday"	"717"	7	1	7	15
7801	2008-03-28	"Fri"	"Evening"	"872"	8	7	2	17
7800	2008-03-28	"Fri"	"Midday"	"371"	3	7	1	11
7799	2008-03-27	"Thu"	"Evening"	"648"	6	4	8	18
7798	2008-03-27	"Thu"	"Midday"	"423"	4	2	3	9
7797	2008-03-26	"Wed"	"Evening"	"321"	3	2	1	6
7796	2008-03-26	"Wed"	"Midday"	"724"	7	2	4	13
7795	2008-03-25	"Tue"	"Evening"	"651"	6	5	1	12
7794	2008-03-25	"Tue"	"Midday"	"840"	8	4	0	12
7793	2008-03-24	"Mon"	"Evening"	"472"	4	7	2	13
7792	2008-03-24	"Mon"	"Midday"	"917"	9	1	7	17
7791	2008-03-23	"Sun"	"Evening"	"548"	5	4	8	17
7790	2008-03-23	"Sun"	"Midday"	"133"	1	3	3	7
7789	2008-03-22	"Sat"	"Evening"	"956"	9	5	6	20
7788	2008-03-22	"Sat"	"Midday"	"734"	7	3	4	14
7787	2008-03-21	"Fri"	"Evening"	"651"	6	5	1	12
7786	2008-03-21	"Fri"	"Midday"	"138"	1	3	8	12
7785	2008-03-20	"Thu"	"Evening"	"438"	4	3	8	15
7784	2008-03-20	"Thu"	"Midday"	"707"	7	0	7	14
7783	2008-03-19	"Wed"	"Evening"	"357"	3	5	7	15
7782	2008-03-19	"Wed"	"Midday"	"233"	2	3	3	8
7781	2008-03-18	"Tue"	"Evening"	"305"	3	0	5	8
7780	2008-03-18	"Tue"	"Midday"	"731"	7	3	1	11
7779	2008-03-17	"Mon"	"Evening"	"189"	1	8	9	18
7778	2008-03-17	"Mon"	"Midday"	"814"	8	1	4	13
7777	2008-03-16	"Sun"	"Evening"	"438"	4	3	8	15
7776	2008-03-16	"Sun"	"Midday"	"832"	8	3	2	13
7775	2008-03-15	"Sat"	"Evening"	"158"	1	5	8	14
7774	2008-03-15	"Sat"	"Midday"	"644"	6	4	4	14
7773	2008-03-14	"Fri"	"Evening"	"982"	9	8	2	19
7772	2008-03-14	"Fri"	"Midday"	"128"	1	2	8	11
7771	2008-03-13	"Thu"	"Evening"	"944"	9	4	4	17
7770	2008-03-13	"Thu"	"Midday"	"692"	6	9	2	17
7769	2008-03-12	"Wed"	"Evening"	"564"	5	6	4	15
7768	2008-03-12	"Wed"	"Midday"	"321"	3	2	1	6
7767	2008-03-11	"Tue"	"Evening"	"119"	1	1	9	11
7766	2008-03-11	"Tue"	"Midday"	"840"	8	4	0	12
7765	2008-03-10	"Mon"	"Evening"	"983"	9	8	3	20
7764	2008-03-10	"Mon"	"Midday"	"101"	1	0	1	2
7763	2008-03-09	"Sun"	"Evening"	"095"	0	9	5	14
7762	2008-03-09	"Sun"	"Midday"	"784"	7	8	4	19
7761	2008-03-08	"Sat"	"Evening"	"636"	6	3	6	15
7760	2008-03-08	"Sat"	"Midday"	"192"	1	9	2	12
7759	2008-03-07	"Fri"	"Evening"	"759"	7	5	9	21
7758	2008-03-07	"Fri"	"Midday"	"757"	7	5	7	19
7757	2008-03-06	"Thu"	"Evening"	"727"	7	2	7	16
7756	2008-03-06	"Thu"	"Midday"	"235"	2	3	5	10
7755	2008-03-05	"Wed"	"Evening"	"765"	7	6	5	18
7754	2008-03-05	"Wed"	"Midday"	"552"	5	5	2	12
7753	2008-03-04	"Tue"	"Evening"	"056"	0	5	6	11
7752	2008-03-04	"Tue"	"Midday"	"105"	1	0	5	6
7751	2008-03-03	"Mon"	"Evening"	"024"	0	2	4	6
7750	2008-03-03	"Mon"	"Midday"	"043"	0	4	3	7
7749	2008-03-02	"Sun"	"Evening"	"239"	2	3	9	14
7748	2008-03-02	"Sun"	"Midday"	"576"	5	7	6	18
7747	2008-03-01	"Sat"	"Evening"	"044"	0	4	4	8
7746	2008-03-01	"Sat"	"Midday"	"331"	3	3	1	7
7745	2008-02-29	"Fri"	"Evening"	"488"	4	8	8	20
7744	2008-02-29	"Fri"	"Midday"	"206"	2	0	6	8
7743	2008-02-28	"Thu"	"Evening"	"263"	2	6	3	11
7742	2008-02-28	"Thu"	"Midday"	"918"	9	1	8	18
7741	2008-02-27	"Wed"	"Evening"	"951"	9	5	1	15
7740	2008-02-27	"Wed"	"Midday"	"705"	7	0	5	12
7739	2008-02-26	"Tue"	"Evening"	"705"	7	0	5	12
7738	2008-02-26	"Tue"	"Midday"	"945"	9	4	5	18
7737	2008-02-25	"Mon"	"Evening"	"074"	0	7	4	11
7736	2008-02-25	"Mon"	"Midday"	"827"	8	2	7	17
7735	2008-02-24	"Sun"	"Evening"	"012"	0	1	2	3
7734	2008-02-24	"Sun"	"Midday"	"998"	9	9	8	26
7733	2008-02-23	"Sat"	"Evening"	"025"	0	2	5	7
7732	2008-02-23	"Sat"	"Midday"	"483"	4	8	3	15
7731	2008-02-22	"Fri"	"Evening"	"887"	8	8	7	23
7730	2008-02-22	"Fri"	"Midday"	"526"	5	2	6	13
7729	2008-02-21	"Thu"	"Evening"	"831"	8	3	1	12
7728	2008-02-21	"Thu"	"Midday"	"552"	5	5	2	12
7727	2008-02-20	"Wed"	"Evening"	"917"	9	1	7	17
7726	2008-02-20	"Wed"	"Midday"	"620"	6	2	0	8
7725	2008-02-19	"Tue"	"Evening"	"190"	1	9	0	10
7724	2008-02-19	"Tue"	"Midday"	"714"	7	1	4	12
7723	2008-02-18	"Mon"	"Evening"	"311"	3	1	1	5
7722	2008-02-18	"Mon"	"Midday"	"793"	7	9	3	19
7721	2008-02-17	"Sun"	"Evening"	"920"	9	2	0	11
7720	2008-02-17	"Sun"	"Midday"	"332"	3	3	2	8
7719	2008-02-16	"Sat"	"Evening"	"618"	6	1	8	15
7718	2008-02-16	"Sat"	"Midday"	"152"	1	5	2	8
7717	2008-02-15	"Fri"	"Evening"	"661"	6	6	1	13
7716	2008-02-15	"Fri"	"Midday"	"963"	9	6	3	18
7715	2008-02-14	"Thu"	"Evening"	"109"	1	0	9	10
7714	2008-02-14	"Thu"	"Midday"	"535"	5	3	5	13
7713	2008-02-13	"Wed"	"Evening"	"598"	5	9	8	22
7712	2008-02-13	"Wed"	"Midday"	"826"	8	2	6	16
7711	2008-02-12	"Tue"	"Evening"	"036"	0	3	6	9
7710	2008-02-12	"Tue"	"Midday"	"498"	4	9	8	21
7709	2008-02-11	"Mon"	"Evening"	"434"	4	3	4	11
7708	2008-02-11	"Mon"	"Midday"	"911"	9	1	1	11
7707	2008-02-10	"Sun"	"Evening"	"295"	2	9	5	16
7706	2008-02-10	"Sun"	"Midday"	"260"	2	6	0	8
7705	2008-02-09	"Sat"	"Evening"	"128"	1	2	8	11
7704	2008-02-09	"Sat"	"Midday"	"847"	8	4	7	19
7703	2008-02-08	"Fri"	"Evening"	"510"	5	1	0	6
7702	2008-02-08	"Fri"	"Midday"	"987"	9	8	7	24
7701	2008-02-07	"Thu"	"Evening"	"224"	2	2	4	8
7700	2008-02-07	"Thu"	"Midday"	"600"	6	0	0	6
7699	2008-02-06	"Wed"	"Evening"	"600"	6	0	0	6
7698	2008-02-06	"Wed"	"Midday"	"578"	5	7	8	20
7697	2008-02-05	"Tue"	"Evening"	"539"	5	3	9	17
7696	2008-02-05	"Tue"	"Midday"	"752"	7	5	2	14
7695	2008-02-04	"Mon"	"Evening"	"334"	3	3	4	10
7694	2008-02-04	"Mon"	"Midday"	"024"	0	2	4	6
7693	2008-02-03	"Sun"	"Evening"	"109"	1	0	9	10
7692	2008-02-03	"Sun"	"Midday"	"082"	0	8	2	10
7691	2008-02-02	"Sat"	"Evening"	"939"	9	3	9	21
7690	2008-02-02	"Sat"	"Midday"	"488"	4	8	8	20
7689	2008-02-01	"Fri"	"Evening"	"642"	6	4	2	12
7688	2008-02-01	"Fri"	"Midday"	"550"	5	5	0	10
7687	2008-01-31	"Thu"	"Evening"	"664"	6	6	4	16
7686	2008-01-31	"Thu"	"Midday"	"961"	9	6	1	16
7685	2008-01-30	"Wed"	"Evening"	"356"	3	5	6	14
7684	2008-01-30	"Wed"	"Midday"	"196"	1	9	6	16
7683	2008-01-29	"Tue"	"Evening"	"393"	3	9	3	15
7682	2008-01-29	"Tue"	"Midday"	"166"	1	6	6	13
7681	2008-01-28	"Mon"	"Evening"	"570"	5	7	0	12
7680	2008-01-28	"Mon"	"Midday"	"285"	2	8	5	15
7679	2008-01-27	"Sun"	"Evening"	"409"	4	0	9	13
7678	2008-01-27	"Sun"	"Midday"	"512"	5	1	2	8
7677	2008-01-26	"Sat"	"Evening"	"881"	8	8	1	17
7676	2008-01-26	"Sat"	"Midday"	"320"	3	2	0	5
7675	2008-01-25	"Fri"	"Evening"	"286"	2	8	6	16
7674	2008-01-25	"Fri"	"Midday"	"608"	6	0	8	14
7673	2008-01-24	"Thu"	"Evening"	"009"	0	0	9	9
7672	2008-01-24	"Thu"	"Midday"	"015"	0	1	5	6
7671	2008-01-23	"Wed"	"Evening"	"044"	0	4	4	8
7670	2008-01-23	"Wed"	"Midday"	"526"	5	2	6	13
7669	2008-01-22	"Tue"	"Evening"	"859"	8	5	9	22
7668	2008-01-22	"Tue"	"Midday"	"393"	3	9	3	15
7667	2008-01-21	"Mon"	"Evening"	"326"	3	2	6	11
7666	2008-01-21	"Mon"	"Midday"	"196"	1	9	6	16
7665	2008-01-20	"Sun"	"Evening"	"563"	5	6	3	14
7664	2008-01-20	"Sun"	"Midday"	"546"	5	4	6	15
7663	2008-01-19	"Sat"	"Evening"	"510"	5	1	0	6
7662	2008-01-19	"Sat"	"Midday"	"936"	9	3	6	18
7661	2008-01-18	"Fri"	"Evening"	"684"	6	8	4	18
7660	2008-01-18	"Fri"	"Midday"	"290"	2	9	0	11
7659	2008-01-17	"Thu"	"Evening"	"617"	6	1	7	14
7658	2008-01-17	"Thu"	"Midday"	"587"	5	8	7	20
7657	2008-01-16	"Wed"	"Evening"	"803"	8	0	3	11
7656	2008-01-16	"Wed"	"Midday"	"303"	3	0	3	6
7655	2008-01-15	"Tue"	"Evening"	"294"	2	9	4	15
7654	2008-01-15	"Tue"	"Midday"	"517"	5	1	7	13
7653	2008-01-14	"Mon"	"Evening"	"684"	6	8	4	18
7652	2008-01-14	"Mon"	"Midday"	"159"	1	5	9	15
7651	2008-01-13	"Sun"	"Evening"	"566"	5	6	6	17
7650	2008-01-13	"Sun"	"Midday"	"831"	8	3	1	12
7649	2008-01-12	"Sat"	"Evening"	"598"	5	9	8	22
7648	2008-01-12	"Sat"	"Midday"	"637"	6	3	7	16
7647	2008-01-11	"Fri"	"Evening"	"307"	3	0	7	10
7646	2008-01-11	"Fri"	"Midday"	"025"	0	2	5	7
7645	2008-01-10	"Thu"	"Evening"	"707"	7	0	7	14
7644	2008-01-10	"Thu"	"Midday"	"030"	0	3	0	3
7643	2008-01-09	"Wed"	"Evening"	"712"	7	1	2	10
7642	2008-01-09	"Wed"	"Midday"	"457"	4	5	7	16
7641	2008-01-08	"Tue"	"Evening"	"781"	7	8	1	16
7640	2008-01-08	"Tue"	"Midday"	"338"	3	3	8	14
7639	2008-01-07	"Mon"	"Evening"	"037"	0	3	7	10
7638	2008-01-07	"Mon"	"Midday"	"057"	0	5	7	12
7637	2008-01-06	"Sun"	"Evening"	"662"	6	6	2	14
7636	2008-01-06	"Sun"	"Midday"	"235"	2	3	5	10
7635	2008-01-05	"Sat"	"Evening"	"908"	9	0	8	17
7634	2008-01-05	"Sat"	"Midday"	"944"	9	4	4	17
7633	2008-01-04	"Fri"	"Evening"	"064"	0	6	4	10
7632	2008-01-04	"Fri"	"Midday"	"471"	4	7	1	12
7631	2008-01-03	"Thu"	"Evening"	"475"	4	7	5	16
7630	2008-01-03	"Thu"	"Midday"	"525"	5	2	5	12
7629	2008-01-02	"Wed"	"Evening"	"761"	7	6	1	14
7628	2008-01-02	"Wed"	"Midday"	"129"	1	2	9	12
7627	2008-01-01	"Tue"	"Evening"	"554"	5	5	4	14
7626	2008-01-01	"Tue"	"Midday"	"499"	4	9	9	22
7625	2007-12-31	"Mon"	"Evening"	"703"	7	0	3	10
7624	2007-12-31	"Mon"	"Midday"	"890"	8	9	0	17
7623	2007-12-30	"Sun"	"Evening"	"068"	0	6	8	14
7622	2007-12-30	"Sun"	"Midday"	"207"	2	0	7	9
7621	2007-12-29	"Sat"	"Evening"	"885"	8	8	5	21
7620	2007-12-29	"Sat"	"Midday"	"814"	8	1	4	13
7619	2007-12-28	"Fri"	"Evening"	"420"	4	2	0	6
7618	2007-12-28	"Fri"	"Midday"	"108"	1	0	8	9
7617	2007-12-27	"Thu"	"Evening"	"491"	4	9	1	14
7616	2007-12-27	"Thu"	"Midday"	"020"	0	2	0	2
7615	2007-12-26	"Wed"	"Evening"	"360"	3	6	0	9
7614	2007-12-26	"Wed"	"Midday"	"991"	9	9	1	19
7613	2007-12-25	"Tue"	"Evening"	"349"	3	4	9	16
7612	2007-12-25	"Tue"	"Midday"	"000"	0	0	0	0
7611	2007-12-24	"Mon"	"Evening"	"612"	6	1	2	9
7610	2007-12-24	"Mon"	"Midday"	"339"	3	3	9	15
7609	2007-12-23	"Sun"	"Evening"	"470"	4	7	0	11
7608	2007-12-23	"Sun"	"Midday"	"005"	0	0	5	5
7607	2007-12-22	"Sat"	"Evening"	"015"	0	1	5	6
7606	2007-12-22	"Sat"	"Midday"	"234"	2	3	4	9
7605	2007-12-21	"Fri"	"Evening"	"141"	1	4	1	6
7604	2007-12-21	"Fri"	"Midday"	"355"	3	5	5	13
7603	2007-12-20	"Thu"	"Evening"	"753"	7	5	3	15
7602	2007-12-20	"Thu"	"Midday"	"980"	9	8	0	17
7601	2007-12-19	"Wed"	"Evening"	"305"	3	0	5	8
7600	2007-12-19	"Wed"	"Midday"	"067"	0	6	7	13
7599	2007-12-18	"Tue"	"Evening"	"382"	3	8	2	13
7598	2007-12-18	"Tue"	"Midday"	"279"	2	7	9	18
7597	2007-12-17	"Mon"	"Evening"	"422"	4	2	2	8
7596	2007-12-17	"Mon"	"Midday"	"997"	9	9	7	25
7595	2007-12-16	"Sun"	"Evening"	"095"	0	9	5	14
7594	2007-12-16	"Sun"	"Midday"	"700"	7	0	0	7
7593	2007-12-15	"Sat"	"Evening"	"627"	6	2	7	15
7592	2007-12-15	"Sat"	"Midday"	"009"	0	0	9	9
7591	2007-12-14	"Fri"	"Evening"	"407"	4	0	7	11
7590	2007-12-14	"Fri"	"Midday"	"639"	6	3	9	18
7589	2007-12-13	"Thu"	"Evening"	"100"	1	0	0	1
7588	2007-12-13	"Thu"	"Midday"	"034"	0	3	4	7
7587	2007-12-12	"Wed"	"Evening"	"518"	5	1	8	14
7586	2007-12-12	"Wed"	"Midday"	"352"	3	5	2	10
7585	2007-12-11	"Tue"	"Evening"	"873"	8	7	3	18
7584	2007-12-11	"Tue"	"Midday"	"881"	8	8	1	17
7583	2007-12-10	"Mon"	"Evening"	"244"	2	4	4	10
7582	2007-12-10	"Mon"	"Midday"	"908"	9	0	8	17
7581	2007-12-09	"Sun"	"Evening"	"417"	4	1	7	12
7580	2007-12-09	"Sun"	"Midday"	"983"	9	8	3	20
7579	2007-12-08	"Sat"	"Evening"	"489"	4	8	9	21
7578	2007-12-08	"Sat"	"Midday"	"166"	1	6	6	13
7577	2007-12-07	"Fri"	"Evening"	"684"	6	8	4	18
7576	2007-12-07	"Fri"	"Midday"	"941"	9	4	1	14
7575	2007-12-06	"Thu"	"Evening"	"827"	8	2	7	17
7574	2007-12-06	"Thu"	"Midday"	"326"	3	2	6	11
7573	2007-12-05	"Wed"	"Evening"	"572"	5	7	2	14
7572	2007-12-05	"Wed"	"Midday"	"030"	0	3	0	3
7571	2007-12-04	"Tue"	"Evening"	"711"	7	1	1	9
7570	2007-12-04	"Tue"	"Midday"	"326"	3	2	6	11
7569	2007-12-03	"Mon"	"Evening"	"053"	0	5	3	8
7568	2007-12-03	"Mon"	"Midday"	"673"	6	7	3	16
7567	2007-12-02	"Sun"	"Evening"	"291"	2	9	1	12
7566	2007-12-02	"Sun"	"Midday"	"820"	8	2	0	10
7565	2007-12-01	"Sat"	"Evening"	"837"	8	3	7	18
7564	2007-12-01	"Sat"	"Midday"	"776"	7	7	6	20
7563	2007-11-30	"Fri"	"Evening"	"796"	7	9	6	22
7562	2007-11-30	"Fri"	"Midday"	"856"	8	5	6	19
7561	2007-11-29	"Thu"	"Evening"	"481"	4	8	1	13
7560	2007-11-29	"Thu"	"Midday"	"141"	1	4	1	6
7559	2007-11-28	"Wed"	"Evening"	"743"	7	4	3	14
7558	2007-11-28	"Wed"	"Midday"	"224"	2	2	4	8
7557	2007-11-27	"Tue"	"Evening"	"287"	2	8	7	17
7556	2007-11-27	"Tue"	"Midday"	"578"	5	7	8	20
7555	2007-11-26	"Mon"	"Evening"	"884"	8	8	4	20
7554	2007-11-26	"Mon"	"Midday"	"967"	9	6	7	22
7553	2007-11-25	"Sun"	"Evening"	"684"	6	8	4	18
7552	2007-11-25	"Sun"	"Midday"	"007"	0	0	7	7
7551	2007-11-24	"Sat"	"Evening"	"677"	6	7	7	20
7550	2007-11-24	"Sat"	"Midday"	"700"	7	0	0	7
7549	2007-11-23	"Fri"	"Evening"	"201"	2	0	1	3
7548	2007-11-23	"Fri"	"Midday"	"434"	4	3	4	11
7547	2007-11-22	"Thu"	"Evening"	"972"	9	7	2	18
7546	2007-11-22	"Thu"	"Midday"	"727"	7	2	7	16
7545	2007-11-21	"Wed"	"Evening"	"123"	1	2	3	6
7544	2007-11-21	"Wed"	"Midday"	"328"	3	2	8	13
7543	2007-11-20	"Tue"	"Evening"	"018"	0	1	8	9
7542	2007-11-20	"Tue"	"Midday"	"614"	6	1	4	11
7541	2007-11-19	"Mon"	"Evening"	"415"	4	1	5	10
7540	2007-11-19	"Mon"	"Midday"	"559"	5	5	9	19
7539	2007-11-18	"Sun"	"Evening"	"927"	9	2	7	18
7538	2007-11-18	"Sun"	"Midday"	"708"	7	0	8	15
7537	2007-11-17	"Sat"	"Evening"	"825"	8	2	5	15
7536	2007-11-17	"Sat"	"Midday"	"806"	8	0	6	14
7535	2007-11-16	"Fri"	"Evening"	"643"	6	4	3	13
7534	2007-11-16	"Fri"	"Midday"	"323"	3	2	3	8
7533	2007-11-15	"Thu"	"Evening"	"050"	0	5	0	5
7532	2007-11-15	"Thu"	"Midday"	"627"	6	2	7	15
7531	2007-11-14	"Wed"	"Evening"	"687"	6	8	7	21
7530	2007-11-14	"Wed"	"Midday"	"393"	3	9	3	15
7529	2007-11-13	"Tue"	"Evening"	"314"	3	1	4	8
7528	2007-11-13	"Tue"	"Midday"	"850"	8	5	0	13
7527	2007-11-12	"Mon"	"Evening"	"908"	9	0	8	17
7526	2007-11-12	"Mon"	"Midday"	"197"	1	9	7	17
7525	2007-11-11	"Sun"	"Evening"	"300"	3	0	0	3
7524	2007-11-11	"Sun"	"Midday"	"771"	7	7	1	15
7523	2007-11-10	"Sat"	"Evening"	"196"	1	9	6	16
7522	2007-11-10	"Sat"	"Midday"	"917"	9	1	7	17
7521	2007-11-09	"Fri"	"Evening"	"694"	6	9	4	19
7520	2007-11-09	"Fri"	"Midday"	"397"	3	9	7	19
7519	2007-11-08	"Thu"	"Evening"	"030"	0	3	0	3
7518	2007-11-08	"Thu"	"Midday"	"763"	7	6	3	16
7517	2007-11-07	"Wed"	"Evening"	"217"	2	1	7	10
7516	2007-11-07	"Wed"	"Midday"	"884"	8	8	4	20
7515	2007-11-06	"Tue"	"Evening"	"273"	2	7	3	12
7514	2007-11-06	"Tue"	"Midday"	"235"	2	3	5	10
7513	2007-11-05	"Mon"	"Evening"	"255"	2	5	5	12
7512	2007-11-05	"Mon"	"Midday"	"177"	1	7	7	15
7511	2007-11-04	"Sun"	"Evening"	"398"	3	9	8	20
7510	2007-11-04	"Sun"	"Midday"	"195"	1	9	5	15
7509	2007-11-03	"Sat"	"Evening"	"111"	1	1	1	3
7508	2007-11-03	"Sat"	"Midday"	"473"	4	7	3	14
7507	2007-11-02	"Fri"	"Evening"	"294"	2	9	4	15
7506	2007-11-02	"Fri"	"Midday"	"926"	9	2	6	17
7505	2007-11-01	"Thu"	"Evening"	"103"	1	0	3	4
7504	2007-11-01	"Thu"	"Midday"	"099"	0	9	9	18
7503	2007-10-31	"Wed"	"Evening"	"408"	4	0	8	12
7502	2007-10-31	"Wed"	"Midday"	"918"	9	1	8	18
7501	2007-10-30	"Tue"	"Evening"	"997"	9	9	7	25
7500	2007-10-30	"Tue"	"Midday"	"261"	2	6	1	9
7499	2007-10-29	"Mon"	"Evening"	"518"	5	1	8	14
7498	2007-10-29	"Mon"	"Midday"	"960"	9	6	0	15
7497	2007-10-28	"Sun"	"Evening"	"518"	5	1	8	14
7496	2007-10-28	"Sun"	"Midday"	"820"	8	2	0	10
7495	2007-10-27	"Sat"	"Evening"	"488"	4	8	8	20
7494	2007-10-27	"Sat"	"Midday"	"997"	9	9	7	25
7493	2007-10-26	"Fri"	"Evening"	"387"	3	8	7	18
7492	2007-10-26	"Fri"	"Midday"	"288"	2	8	8	18
7491	2007-10-25	"Thu"	"Evening"	"181"	1	8	1	10
7490	2007-10-25	"Thu"	"Midday"	"091"	0	9	1	10
7489	2007-10-24	"Wed"	"Evening"	"843"	8	4	3	15
7488	2007-10-24	"Wed"	"Midday"	"671"	6	7	1	14
7487	2007-10-23	"Tue"	"Evening"	"097"	0	9	7	16
7486	2007-10-23	"Tue"	"Midday"	"118"	1	1	8	10
7485	2007-10-22	"Mon"	"Evening"	"918"	9	1	8	18
7484	2007-10-22	"Mon"	"Midday"	"952"	9	5	2	16
7483	2007-10-21	"Sun"	"Evening"	"506"	5	0	6	11
7482	2007-10-21	"Sun"	"Midday"	"230"	2	3	0	5
7481	2007-10-20	"Sat"	"Evening"	"728"	7	2	8	17
7480	2007-10-20	"Sat"	"Midday"	"222"	2	2	2	6
7479	2007-10-19	"Fri"	"Evening"	"322"	3	2	2	7
7478	2007-10-19	"Fri"	"Midday"	"632"	6	3	2	11
7477	2007-10-18	"Thu"	"Evening"	"485"	4	8	5	17
7476	2007-10-18	"Thu"	"Midday"	"086"	0	8	6	14
7475	2007-10-17	"Wed"	"Evening"	"639"	6	3	9	18
7474	2007-10-17	"Wed"	"Midday"	"136"	1	3	6	10
7473	2007-10-16	"Tue"	"Evening"	"125"	1	2	5	8
7472	2007-10-16	"Tue"	"Midday"	"236"	2	3	6	11
7471	2007-10-15	"Mon"	"Evening"	"683"	6	8	3	17
7470	2007-10-15	"Mon"	"Midday"	"720"	7	2	0	9
7469	2007-10-14	"Sun"	"Evening"	"393"	3	9	3	15
7468	2007-10-14	"Sun"	"Midday"	"120"	1	2	0	3
7467	2007-10-13	"Sat"	"Evening"	"646"	6	4	6	16
7466	2007-10-13	"Sat"	"Midday"	"396"	3	9	6	18
7465	2007-10-12	"Fri"	"Evening"	"198"	1	9	8	18
7464	2007-10-12	"Fri"	"Midday"	"852"	8	5	2	15
7463	2007-10-11	"Thu"	"Evening"	"275"	2	7	5	14
7462	2007-10-11	"Thu"	"Midday"	"170"	1	7	0	8
7461	2007-10-10	"Wed"	"Evening"	"102"	1	0	2	3
7460	2007-10-10	"Wed"	"Midday"	"893"	8	9	3	20
7459	2007-10-09	"Tue"	"Evening"	"854"	8	5	4	17
7458	2007-10-09	"Tue"	"Midday"	"574"	5	7	4	16
7457	2007-10-08	"Mon"	"Evening"	"031"	0	3	1	4
7456	2007-10-08	"Mon"	"Midday"	"889"	8	8	9	25
7455	2007-10-07	"Sun"	"Evening"	"198"	1	9	8	18
7454	2007-10-07	"Sun"	"Midday"	"734"	7	3	4	14
7453	2007-10-06	"Sat"	"Evening"	"817"	8	1	7	16
7452	2007-10-06	"Sat"	"Midday"	"154"	1	5	4	10
7451	2007-10-05	"Fri"	"Evening"	"150"	1	5	0	6
7450	2007-10-05	"Fri"	"Midday"	"872"	8	7	2	17
7449	2007-10-04	"Thu"	"Evening"	"302"	3	0	2	5
7448	2007-10-04	"Thu"	"Midday"	"952"	9	5	2	16
7447	2007-10-03	"Wed"	"Evening"	"759"	7	5	9	21
7446	2007-10-03	"Wed"	"Midday"	"324"	3	2	4	9
7445	2007-10-02	"Tue"	"Evening"	"517"	5	1	7	13
7444	2007-10-02	"Tue"	"Midday"	"987"	9	8	7	24
7443	2007-10-01	"Mon"	"Evening"	"149"	1	4	9	14
7442	2007-10-01	"Mon"	"Midday"	"465"	4	6	5	15
7441	2007-09-30	"Sun"	"Evening"	"305"	3	0	5	8
7440	2007-09-30	"Sun"	"Midday"	"711"	7	1	1	9
7439	2007-09-29	"Sat"	"Evening"	"559"	5	5	9	19
7438	2007-09-29	"Sat"	"Midday"	"835"	8	3	5	16
7437	2007-09-28	"Fri"	"Evening"	"666"	6	6	6	18
7436	2007-09-28	"Fri"	"Midday"	"386"	3	8	6	17
7435	2007-09-27	"Thu"	"Evening"	"237"	2	3	7	12
7434	2007-09-27	"Thu"	"Midday"	"681"	6	8	1	15
7433	2007-09-26	"Wed"	"Evening"	"290"	2	9	0	11
7432	2007-09-26	"Wed"	"Midday"	"328"	3	2	8	13
7431	2007-09-25	"Tue"	"Evening"	"870"	8	7	0	15
7430	2007-09-25	"Tue"	"Midday"	"540"	5	4	0	9
7429	2007-09-24	"Mon"	"Evening"	"680"	6	8	0	14
7428	2007-09-24	"Mon"	"Midday"	"406"	4	0	6	10
7427	2007-09-23	"Sun"	"Evening"	"906"	9	0	6	15
7426	2007-09-23	"Sun"	"Midday"	"728"	7	2	8	17
7425	2007-09-22	"Sat"	"Evening"	"677"	6	7	7	20
7424	2007-09-22	"Sat"	"Midday"	"909"	9	0	9	18
7423	2007-09-21	"Fri"	"Evening"	"172"	1	7	2	10
7422	2007-09-21	"Fri"	"Midday"	"609"	6	0	9	15
7421	2007-09-20	"Thu"	"Evening"	"441"	4	4	1	9
7420	2007-09-20	"Thu"	"Midday"	"234"	2	3	4	9
7419	2007-09-19	"Wed"	"Evening"	"993"	9	9	3	21
7418	2007-09-19	"Wed"	"Midday"	"661"	6	6	1	13
7417	2007-09-18	"Tue"	"Evening"	"762"	7	6	2	15
7416	2007-09-18	"Tue"	"Midday"	"306"	3	0	6	9
7415	2007-09-17	"Mon"	"Evening"	"455"	4	5	5	14
7414	2007-09-17	"Mon"	"Midday"	"908"	9	0	8	17
7413	2007-09-16	"Sun"	"Evening"	"880"	8	8	0	16
7412	2007-09-16	"Sun"	"Midday"	"113"	1	1	3	5
7411	2007-09-15	"Sat"	"Evening"	"043"	0	4	3	7
7410	2007-09-15	"Sat"	"Midday"	"833"	8	3	3	14
7409	2007-09-14	"Fri"	"Evening"	"120"	1	2	0	3
7408	2007-09-14	"Fri"	"Midday"	"291"	2	9	1	12
7407	2007-09-13	"Thu"	"Evening"	"058"	0	5	8	13
7406	2007-09-13	"Thu"	"Midday"	"730"	7	3	0	10
7405	2007-09-12	"Wed"	"Evening"	"751"	7	5	1	13
7404	2007-09-12	"Wed"	"Midday"	"869"	8	6	9	23
7403	2007-09-11	"Tue"	"Evening"	"436"	4	3	6	13
7402	2007-09-11	"Tue"	"Midday"	"024"	0	2	4	6
7401	2007-09-10	"Mon"	"Evening"	"213"	2	1	3	6
7400	2007-09-10	"Mon"	"Midday"	"893"	8	9	3	20
7399	2007-09-09	"Sun"	"Evening"	"491"	4	9	1	14
7398	2007-09-09	"Sun"	"Midday"	"114"	1	1	4	6
7397	2007-09-08	"Sat"	"Evening"	"665"	6	6	5	17
7396	2007-09-08	"Sat"	"Midday"	"231"	2	3	1	6
7395	2007-09-07	"Fri"	"Evening"	"446"	4	4	6	14
7394	2007-09-07	"Fri"	"Midday"	"433"	4	3	3	10
7393	2007-09-06	"Thu"	"Evening"	"864"	8	6	4	18
7392	2007-09-06	"Thu"	"Midday"	"166"	1	6	6	13
7391	2007-09-05	"Wed"	"Evening"	"170"	1	7	0	8
7390	2007-09-05	"Wed"	"Midday"	"934"	9	3	4	16
7389	2007-09-04	"Tue"	"Evening"	"855"	8	5	5	18
7388	2007-09-04	"Tue"	"Midday"	"472"	4	7	2	13
7387	2007-09-03	"Mon"	"Evening"	"023"	0	2	3	5
7386	2007-09-03	"Mon"	"Midday"	"062"	0	6	2	8
7385	2007-09-02	"Sun"	"Evening"	"582"	5	8	2	15
7384	2007-09-02	"Sun"	"Midday"	"828"	8	2	8	18
7383	2007-09-01	"Sat"	"Evening"	"881"	8	8	1	17
7382	2007-09-01	"Sat"	"Midday"	"680"	6	8	0	14
7381	2007-08-31	"Fri"	"Evening"	"160"	1	6	0	7
7380	2007-08-31	"Fri"	"Midday"	"188"	1	8	8	17
7379	2007-08-30	"Thu"	"Evening"	"590"	5	9	0	14
7378	2007-08-30	"Thu"	"Midday"	"254"	2	5	4	11
7377	2007-08-29	"Wed"	"Evening"	"755"	7	5	5	17
7376	2007-08-29	"Wed"	"Midday"	"198"	1	9	8	18
7375	2007-08-28	"Tue"	"Evening"	"617"	6	1	7	14
7374	2007-08-28	"Tue"	"Midday"	"961"	9	6	1	16
7373	2007-08-27	"Mon"	"Evening"	"008"	0	0	8	8
7372	2007-08-27	"Mon"	"Midday"	"785"	7	8	5	20
7371	2007-08-26	"Sun"	"Evening"	"758"	7	5	8	20
7370	2007-08-26	"Sun"	"Midday"	"166"	1	6	6	13
7369	2007-08-25	"Sat"	"Evening"	"657"	6	5	7	18
7368	2007-08-25	"Sat"	"Midday"	"394"	3	9	4	16
7367	2007-08-24	"Fri"	"Evening"	"859"	8	5	9	22
7366	2007-08-24	"Fri"	"Midday"	"020"	0	2	0	2
7365	2007-08-23	"Thu"	"Evening"	"337"	3	3	7	13
7364	2007-08-23	"Thu"	"Midday"	"430"	4	3	0	7
7363	2007-08-22	"Wed"	"Evening"	"731"	7	3	1	11
7362	2007-08-22	"Wed"	"Midday"	"135"	1	3	5	9
7361	2007-08-21	"Tue"	"Evening"	"901"	9	0	1	10
7360	2007-08-21	"Tue"	"Midday"	"009"	0	0	9	9
7359	2007-08-20	"Mon"	"Evening"	"763"	7	6	3	16
7358	2007-08-20	"Mon"	"Midday"	"465"	4	6	5	15
7357	2007-08-19	"Sun"	"Evening"	"632"	6	3	2	11
7356	2007-08-19	"Sun"	"Midday"	"838"	8	3	8	19
7355	2007-08-18	"Sat"	"Evening"	"171"	1	7	1	9
7354	2007-08-18	"Sat"	"Midday"	"362"	3	6	2	11
7353	2007-08-17	"Fri"	"Evening"	"747"	7	4	7	18
7352	2007-08-17	"Fri"	"Midday"	"772"	7	7	2	16
7351	2007-08-16	"Thu"	"Evening"	"491"	4	9	1	14
7350	2007-08-16	"Thu"	"Midday"	"294"	2	9	4	15
7349	2007-08-15	"Wed"	"Evening"	"952"	9	5	2	16
7348	2007-08-15	"Wed"	"Midday"	"402"	4	0	2	6
7347	2007-08-14	"Tue"	"Evening"	"643"	6	4	3	13
7346	2007-08-14	"Tue"	"Midday"	"072"	0	7	2	9
7345	2007-08-13	"Mon"	"Evening"	"864"	8	6	4	18
7344	2007-08-13	"Mon"	"Midday"	"963"	9	6	3	18
7343	2007-08-12	"Sun"	"Evening"	"035"	0	3	5	8
7342	2007-08-12	"Sun"	"Midday"	"448"	4	4	8	16
7341	2007-08-11	"Sat"	"Evening"	"971"	9	7	1	17
7340	2007-08-11	"Sat"	"Midday"	"478"	4	7	8	19
7339	2007-08-10	"Fri"	"Evening"	"165"	1	6	5	12
7338	2007-08-10	"Fri"	"Midday"	"888"	8	8	8	24
7337	2007-08-09	"Thu"	"Evening"	"350"	3	5	0	8
7336	2007-08-09	"Thu"	"Midday"	"738"	7	3	8	18
7335	2007-08-08	"Wed"	"Evening"	"566"	5	6	6	17
7334	2007-08-08	"Wed"	"Midday"	"590"	5	9	0	14
7333	2007-08-07	"Tue"	"Evening"	"791"	7	9	1	17
7332	2007-08-07	"Tue"	"Midday"	"259"	2	5	9	16
7331	2007-08-06	"Mon"	"Evening"	"734"	7	3	4	14
7330	2007-08-06	"Mon"	"Midday"	"766"	7	6	6	19
7329	2007-08-05	"Sun"	"Evening"	"142"	1	4	2	7
7328	2007-08-05	"Sun"	"Midday"	"548"	5	4	8	17
7327	2007-08-04	"Sat"	"Evening"	"685"	6	8	5	19
7326	2007-08-04	"Sat"	"Midday"	"274"	2	7	4	13
7325	2007-08-03	"Fri"	"Evening"	"922"	9	2	2	13
7324	2007-08-03	"Fri"	"Midday"	"629"	6	2	9	17
7323	2007-08-02	"Thu"	"Evening"	"622"	6	2	2	10
7322	2007-08-02	"Thu"	"Midday"	"093"	0	9	3	12
7321	2007-08-01	"Wed"	"Evening"	"937"	9	3	7	19
7320	2007-08-01	"Wed"	"Midday"	"543"	5	4	3	12
7319	2007-07-31	"Tue"	"Evening"	"394"	3	9	4	16
7318	2007-07-31	"Tue"	"Midday"	"279"	2	7	9	18
7317	2007-07-30	"Mon"	"Evening"	"926"	9	2	6	17
7316	2007-07-30	"Mon"	"Midday"	"495"	4	9	5	18
7315	2007-07-29	"Sun"	"Evening"	"226"	2	2	6	10
7314	2007-07-29	"Sun"	"Midday"	"229"	2	2	9	13
7313	2007-07-28	"Sat"	"Evening"	"380"	3	8	0	11
7312	2007-07-28	"Sat"	"Midday"	"953"	9	5	3	17
7311	2007-07-27	"Fri"	"Evening"	"251"	2	5	1	8
7310	2007-07-27	"Fri"	"Midday"	"708"	7	0	8	15
7309	2007-07-26	"Thu"	"Evening"	"436"	4	3	6	13
7308	2007-07-26	"Thu"	"Midday"	"210"	2	1	0	3
7307	2007-07-25	"Wed"	"Evening"	"692"	6	9	2	17
7306	2007-07-25	"Wed"	"Midday"	"172"	1	7	2	10
7305	2007-07-24	"Tue"	"Evening"	"467"	4	6	7	17
7304	2007-07-24	"Tue"	"Midday"	"233"	2	3	3	8
7303	2007-07-23	"Mon"	"Evening"	"509"	5	0	9	14
7302	2007-07-23	"Mon"	"Midday"	"022"	0	2	2	4
7301	2007-07-22	"Sun"	"Evening"	"415"	4	1	5	10
7300	2007-07-22	"Sun"	"Midday"	"402"	4	0	2	6
7299	2007-07-21	"Sat"	"Evening"	"269"	2	6	9	17
7298	2007-07-21	"Sat"	"Midday"	"375"	3	7	5	15
7297	2007-07-20	"Fri"	"Evening"	"546"	5	4	6	15
7296	2007-07-20	"Fri"	"Midday"	"544"	5	4	4	13
7295	2007-07-19	"Thu"	"Evening"	"839"	8	3	9	20
7294	2007-07-19	"Thu"	"Midday"	"026"	0	2	6	8
7293	2007-07-18	"Wed"	"Evening"	"123"	1	2	3	6
7292	2007-07-18	"Wed"	"Midday"	"414"	4	1	4	9
7291	2007-07-17	"Tue"	"Evening"	"921"	9	2	1	12
7290	2007-07-17	"Tue"	"Midday"	"405"	4	0	5	9
7289	2007-07-16	"Mon"	"Evening"	"907"	9	0	7	16
7288	2007-07-16	"Mon"	"Midday"	"123"	1	2	3	6
7287	2007-07-15	"Sun"	"Evening"	"649"	6	4	9	19
7286	2007-07-15	"Sun"	"Midday"	"394"	3	9	4	16
7285	2007-07-14	"Sat"	"Evening"	"313"	3	1	3	7
7284	2007-07-14	"Sat"	"Midday"	"165"	1	6	5	12
7283	2007-07-13	"Fri"	"Evening"	"169"	1	6	9	16
7282	2007-07-13	"Fri"	"Midday"	"516"	5	1	6	12
7281	2007-07-12	"Thu"	"Evening"	"076"	0	7	6	13
7280	2007-07-12	"Thu"	"Midday"	"034"	0	3	4	7
7279	2007-07-11	"Wed"	"Evening"	"520"	5	2	0	7
7278	2007-07-11	"Wed"	"Midday"	"396"	3	9	6	18
7277	2007-07-10	"Tue"	"Evening"	"675"	6	7	5	18
7276	2007-07-10	"Tue"	"Midday"	"380"	3	8	0	11
7275	2007-07-09	"Mon"	"Evening"	"538"	5	3	8	16
7274	2007-07-09	"Mon"	"Midday"	"375"	3	7	5	15
7273	2007-07-08	"Sun"	"Evening"	"792"	7	9	2	18
7272	2007-07-08	"Sun"	"Midday"	"975"	9	7	5	21
7271	2007-07-07	"Sat"	"Evening"	"145"	1	4	5	10
7270	2007-07-07	"Sat"	"Midday"	"683"	6	8	3	17
7269	2007-07-06	"Fri"	"Evening"	"643"	6	4	3	13
7268	2007-07-06	"Fri"	"Midday"	"702"	7	0	2	9
7267	2007-07-05	"Thu"	"Evening"	"436"	4	3	6	13
7266	2007-07-05	"Thu"	"Midday"	"261"	2	6	1	9
7265	2007-07-04	"Wed"	"Evening"	"004"	0	0	4	4
7264	2007-07-04	"Wed"	"Midday"	"369"	3	6	9	18
7263	2007-07-03	"Tue"	"Evening"	"847"	8	4	7	19
7262	2007-07-03	"Tue"	"Midday"	"602"	6	0	2	8
7261	2007-07-02	"Mon"	"Evening"	"774"	7	7	4	18
7260	2007-07-02	"Mon"	"Midday"	"462"	4	6	2	12
7259	2007-07-01	"Sun"	"Evening"	"806"	8	0	6	14
7258	2007-07-01	"Sun"	"Midday"	"792"	7	9	2	18
7257	2007-06-30	"Sat"	"Evening"	"743"	7	4	3	14
7256	2007-06-30	"Sat"	"Midday"	"961"	9	6	1	16
7255	2007-06-29	"Fri"	"Evening"	"989"	9	8	9	26
7254	2007-06-29	"Fri"	"Midday"	"128"	1	2	8	11
7253	2007-06-28	"Thu"	"Evening"	"404"	4	0	4	8
7252	2007-06-28	"Thu"	"Midday"	"603"	6	0	3	9
7251	2007-06-27	"Wed"	"Evening"	"996"	9	9	6	24
7250	2007-06-27	"Wed"	"Midday"	"507"	5	0	7	12
7249	2007-06-26	"Tue"	"Evening"	"595"	5	9	5	19
7248	2007-06-26	"Tue"	"Midday"	"406"	4	0	6	10
7247	2007-06-25	"Mon"	"Evening"	"360"	3	6	0	9
7246	2007-06-25	"Mon"	"Midday"	"875"	8	7	5	20
7245	2007-06-24	"Sun"	"Evening"	"324"	3	2	4	9
7244	2007-06-24	"Sun"	"Midday"	"524"	5	2	4	11
7243	2007-06-23	"Sat"	"Evening"	"822"	8	2	2	12
7242	2007-06-23	"Sat"	"Midday"	"837"	8	3	7	18
7241	2007-06-22	"Fri"	"Evening"	"420"	4	2	0	6
7240	2007-06-22	"Fri"	"Midday"	"170"	1	7	0	8
7239	2007-06-21	"Thu"	"Evening"	"445"	4	4	5	13
7238	2007-06-21	"Thu"	"Midday"	"080"	0	8	0	8
7237	2007-06-20	"Wed"	"Evening"	"991"	9	9	1	19
7236	2007-06-20	"Wed"	"Midday"	"917"	9	1	7	17
7235	2007-06-19	"Tue"	"Evening"	"270"	2	7	0	9
7234	2007-06-19	"Tue"	"Midday"	"924"	9	2	4	15
7233	2007-06-18	"Mon"	"Evening"	"929"	9	2	9	20
7232	2007-06-18	"Mon"	"Midday"	"472"	4	7	2	13
7231	2007-06-17	"Sun"	"Evening"	"255"	2	5	5	12
7230	2007-06-17	"Sun"	"Midday"	"956"	9	5	6	20
7229	2007-06-16	"Sat"	"Evening"	"517"	5	1	7	13
7228	2007-06-16	"Sat"	"Midday"	"187"	1	8	7	16
7227	2007-06-15	"Fri"	"Evening"	"498"	4	9	8	21
7226	2007-06-15	"Fri"	"Midday"	"066"	0	6	6	12
7225	2007-06-14	"Thu"	"Evening"	"728"	7	2	8	17
7224	2007-06-14	"Thu"	"Midday"	"152"	1	5	2	8
7223	2007-06-13	"Wed"	"Evening"	"050"	0	5	0	5
7222	2007-06-13	"Wed"	"Midday"	"557"	5	5	7	17
7221	2007-06-12	"Tue"	"Evening"	"178"	1	7	8	16
7220	2007-06-12	"Tue"	"Midday"	"222"	2	2	2	6
7219	2007-06-11	"Mon"	"Evening"	"909"	9	0	9	18
7218	2007-06-11	"Mon"	"Midday"	"468"	4	6	8	18
7217	2007-06-10	"Sun"	"Evening"	"432"	4	3	2	9
7216	2007-06-10	"Sun"	"Midday"	"914"	9	1	4	14
7215	2007-06-09	"Sat"	"Evening"	"332"	3	3	2	8
7214	2007-06-09	"Sat"	"Midday"	"310"	3	1	0	4
7213	2007-06-08	"Fri"	"Evening"	"127"	1	2	7	10
7212	2007-06-08	"Fri"	"Midday"	"078"	0	7	8	15
7211	2007-06-07	"Thu"	"Evening"	"620"	6	2	0	8
7210	2007-06-07	"Thu"	"Midday"	"263"	2	6	3	11
7209	2007-06-06	"Wed"	"Evening"	"999"	9	9	9	27
7208	2007-06-06	"Wed"	"Midday"	"858"	8	5	8	21
7207	2007-06-05	"Tue"	"Evening"	"542"	5	4	2	11
7206	2007-06-05	"Tue"	"Midday"	"629"	6	2	9	17
7205	2007-06-04	"Mon"	"Evening"	"049"	0	4	9	13
7204	2007-06-04	"Mon"	"Midday"	"890"	8	9	0	17
7203	2007-06-03	"Sun"	"Evening"	"565"	5	6	5	16
7202	2007-06-03	"Sun"	"Midday"	"814"	8	1	4	13
7201	2007-06-02	"Sat"	"Evening"	"240"	2	4	0	6
7200	2007-06-02	"Sat"	"Midday"	"288"	2	8	8	18
7199	2007-06-01	"Fri"	"Evening"	"249"	2	4	9	15
7198	2007-06-01	"Fri"	"Midday"	"149"	1	4	9	14
7197	2007-05-31	"Thu"	"Evening"	"120"	1	2	0	3
7196	2007-05-31	"Thu"	"Midday"	"489"	4	8	9	21
7195	2007-05-30	"Wed"	"Evening"	"131"	1	3	1	5
7194	2007-05-30	"Wed"	"Midday"	"795"	7	9	5	21
7193	2007-05-29	"Tue"	"Evening"	"141"	1	4	1	6
7192	2007-05-29	"Tue"	"Midday"	"743"	7	4	3	14
7191	2007-05-28	"Mon"	"Evening"	"434"	4	3	4	11
7190	2007-05-28	"Mon"	"Midday"	"078"	0	7	8	15
7189	2007-05-27	"Sun"	"Evening"	"483"	4	8	3	15
7188	2007-05-27	"Sun"	"Midday"	"612"	6	1	2	9
7187	2007-05-26	"Sat"	"Evening"	"593"	5	9	3	17
7186	2007-05-26	"Sat"	"Midday"	"383"	3	8	3	14
7185	2007-05-25	"Fri"	"Evening"	"788"	7	8	8	23
7184	2007-05-25	"Fri"	"Midday"	"387"	3	8	7	18
7183	2007-05-24	"Thu"	"Evening"	"854"	8	5	4	17
7182	2007-05-24	"Thu"	"Midday"	"870"	8	7	0	15
7181	2007-05-23	"Wed"	"Evening"	"974"	9	7	4	20
7180	2007-05-23	"Wed"	"Midday"	"439"	4	3	9	16
7179	2007-05-22	"Tue"	"Evening"	"564"	5	6	4	15
7178	2007-05-22	"Tue"	"Midday"	"980"	9	8	0	17
7177	2007-05-21	"Mon"	"Evening"	"416"	4	1	6	11
7176	2007-05-21	"Mon"	"Midday"	"604"	6	0	4	10
7175	2007-05-20	"Sun"	"Evening"	"491"	4	9	1	14
7174	2007-05-20	"Sun"	"Midday"	"776"	7	7	6	20
7173	2007-05-19	"Sat"	"Evening"	"956"	9	5	6	20
7172	2007-05-19	"Sat"	"Midday"	"913"	9	1	3	13
7171	2007-05-18	"Fri"	"Evening"	"040"	0	4	0	4
7170	2007-05-18	"Fri"	"Midday"	"236"	2	3	6	11
7169	2007-05-17	"Thu"	"Evening"	"085"	0	8	5	13
7168	2007-05-17	"Thu"	"Midday"	"528"	5	2	8	15
7167	2007-05-16	"Wed"	"Evening"	"500"	5	0	0	5
7166	2007-05-16	"Wed"	"Midday"	"113"	1	1	3	5
7165	2007-05-15	"Tue"	"Evening"	"775"	7	7	5	19
7164	2007-05-15	"Tue"	"Midday"	"261"	2	6	1	9
7163	2007-05-14	"Mon"	"Evening"	"586"	5	8	6	19
7162	2007-05-14	"Mon"	"Midday"	"291"	2	9	1	12
7161	2007-05-13	"Sun"	"Evening"	"999"	9	9	9	27
7160	2007-05-13	"Sun"	"Midday"	"801"	8	0	1	9
7159	2007-05-12	"Sat"	"Evening"	"312"	3	1	2	6
7158	2007-05-12	"Sat"	"Midday"	"552"	5	5	2	12
7157	2007-05-11	"Fri"	"Evening"	"367"	3	6	7	16
7156	2007-05-11	"Fri"	"Midday"	"734"	7	3	4	14
7155	2007-05-10	"Thu"	"Evening"	"388"	3	8	8	19
7154	2007-05-10	"Thu"	"Midday"	"586"	5	8	6	19
7153	2007-05-09	"Wed"	"Evening"	"461"	4	6	1	11
7152	2007-05-09	"Wed"	"Midday"	"641"	6	4	1	11
7151	2007-05-08	"Tue"	"Evening"	"915"	9	1	5	15
7150	2007-05-08	"Tue"	"Midday"	"398"	3	9	8	20
7149	2007-05-07	"Mon"	"Evening"	"430"	4	3	0	7
7148	2007-05-07	"Mon"	"Midday"	"138"	1	3	8	12
7147	2007-05-06	"Sun"	"Evening"	"242"	2	4	2	8
7146	2007-05-06	"Sun"	"Midday"	"211"	2	1	1	4
7145	2007-05-05	"Sat"	"Evening"	"304"	3	0	4	7
7144	2007-05-05	"Sat"	"Midday"	"249"	2	4	9	15
7143	2007-05-04	"Fri"	"Evening"	"630"	6	3	0	9
7142	2007-05-04	"Fri"	"Midday"	"108"	1	0	8	9
7141	2007-05-03	"Thu"	"Evening"	"743"	7	4	3	14
7140	2007-05-03	"Thu"	"Midday"	"923"	9	2	3	14
7139	2007-05-02	"Wed"	"Evening"	"359"	3	5	9	17
7138	2007-05-02	"Wed"	"Midday"	"490"	4	9	0	13
7137	2007-05-01	"Tue"	"Evening"	"554"	5	5	4	14
7136	2007-05-01	"Tue"	"Midday"	"181"	1	8	1	10
7135	2007-04-30	"Mon"	"Evening"	"603"	6	0	3	9
7134	2007-04-30	"Mon"	"Midday"	"745"	7	4	5	16
7133	2007-04-29	"Sun"	"Evening"	"551"	5	5	1	11
7132	2007-04-29	"Sun"	"Midday"	"264"	2	6	4	12
7131	2007-04-28	"Sat"	"Evening"	"861"	8	6	1	15
7130	2007-04-28	"Sat"	"Midday"	"077"	0	7	7	14
7129	2007-04-27	"Fri"	"Evening"	"956"	9	5	6	20
7128	2007-04-27	"Fri"	"Midday"	"079"	0	7	9	16
7127	2007-04-26	"Thu"	"Evening"	"766"	7	6	6	19
7126	2007-04-26	"Thu"	"Midday"	"468"	4	6	8	18
7125	2007-04-25	"Wed"	"Evening"	"678"	6	7	8	21
7124	2007-04-25	"Wed"	"Midday"	"468"	4	6	8	18
7123	2007-04-24	"Tue"	"Evening"	"716"	7	1	6	14
7122	2007-04-24	"Tue"	"Midday"	"897"	8	9	7	24
7121	2007-04-23	"Mon"	"Evening"	"220"	2	2	0	4
7120	2007-04-23	"Mon"	"Midday"	"635"	6	3	5	14
7119	2007-04-22	"Sun"	"Evening"	"760"	7	6	0	13
7118	2007-04-22	"Sun"	"Midday"	"928"	9	2	8	19
7117	2007-04-21	"Sat"	"Evening"	"453"	4	5	3	12
7116	2007-04-21	"Sat"	"Midday"	"671"	6	7	1	14
7115	2007-04-20	"Fri"	"Evening"	"929"	9	2	9	20
7114	2007-04-20	"Fri"	"Midday"	"776"	7	7	6	20
7113	2007-04-19	"Thu"	"Evening"	"650"	6	5	0	11
7112	2007-04-19	"Thu"	"Midday"	"092"	0	9	2	11
7111	2007-04-18	"Wed"	"Evening"	"949"	9	4	9	22
7110	2007-04-18	"Wed"	"Midday"	"718"	7	1	8	16
7109	2007-04-17	"Tue"	"Evening"	"016"	0	1	6	7
7108	2007-04-17	"Tue"	"Midday"	"181"	1	8	1	10
7107	2007-04-16	"Mon"	"Evening"	"516"	5	1	6	12
7106	2007-04-16	"Mon"	"Midday"	"253"	2	5	3	10
7105	2007-04-15	"Sun"	"Evening"	"952"	9	5	2	16
7104	2007-04-15	"Sun"	"Midday"	"776"	7	7	6	20
7103	2007-04-14	"Sat"	"Evening"	"102"	1	0	2	3
7102	2007-04-14	"Sat"	"Midday"	"404"	4	0	4	8
7101	2007-04-13	"Fri"	"Evening"	"645"	6	4	5	15
7100	2007-04-13	"Fri"	"Midday"	"449"	4	4	9	17
7099	2007-04-12	"Thu"	"Evening"	"000"	0	0	0	0
7098	2007-04-12	"Thu"	"Midday"	"125"	1	2	5	8
7097	2007-04-11	"Wed"	"Evening"	"023"	0	2	3	5
7096	2007-04-11	"Wed"	"Midday"	"300"	3	0	0	3
7095	2007-04-10	"Tue"	"Evening"	"380"	3	8	0	11
7094	2007-04-10	"Tue"	"Midday"	"202"	2	0	2	4
7093	2007-04-09	"Mon"	"Evening"	"620"	6	2	0	8
7092	2007-04-09	"Mon"	"Midday"	"059"	0	5	9	14
7091	2007-04-08	"Sun"	"Evening"	"217"	2	1	7	10
7090	2007-04-08	"Sun"	"Midday"	"873"	8	7	3	18
7089	2007-04-07	"Sat"	"Evening"	"922"	9	2	2	13
7088	2007-04-07	"Sat"	"Midday"	"242"	2	4	2	8
7087	2007-04-06	"Fri"	"Evening"	"274"	2	7	4	13
7086	2007-04-06	"Fri"	"Midday"	"858"	8	5	8	21
7085	2007-04-05	"Thu"	"Evening"	"111"	1	1	1	3
7084	2007-04-05	"Thu"	"Midday"	"703"	7	0	3	10
7083	2007-04-04	"Wed"	"Evening"	"886"	8	8	6	22
7082	2007-04-04	"Wed"	"Midday"	"861"	8	6	1	15
7081	2007-04-03	"Tue"	"Evening"	"764"	7	6	4	17
7080	2007-04-03	"Tue"	"Midday"	"049"	0	4	9	13
7079	2007-04-02	"Mon"	"Evening"	"185"	1	8	5	14
7078	2007-04-02	"Mon"	"Midday"	"461"	4	6	1	11
7077	2007-04-01	"Sun"	"Evening"	"580"	5	8	0	13
7076	2007-04-01	"Sun"	"Midday"	"600"	6	0	0	6
7075	2007-03-31	"Sat"	"Evening"	"101"	1	0	1	2
7074	2007-03-31	"Sat"	"Midday"	"420"	4	2	0	6
7073	2007-03-30	"Fri"	"Evening"	"140"	1	4	0	5
7072	2007-03-30	"Fri"	"Midday"	"308"	3	0	8	11
7071	2007-03-29	"Thu"	"Evening"	"718"	7	1	8	16
7070	2007-03-29	"Thu"	"Midday"	"940"	9	4	0	13
7069	2007-03-28	"Wed"	"Evening"	"145"	1	4	5	10
7068	2007-03-28	"Wed"	"Midday"	"669"	6	6	9	21
7067	2007-03-27	"Tue"	"Evening"	"092"	0	9	2	11
7066	2007-03-27	"Tue"	"Midday"	"098"	0	9	8	17
7065	2007-03-26	"Mon"	"Evening"	"178"	1	7	8	16
7064	2007-03-26	"Mon"	"Midday"	"391"	3	9	1	13
7063	2007-03-25	"Sun"	"Evening"	"220"	2	2	0	4
7062	2007-03-25	"Sun"	"Midday"	"035"	0	3	5	8
7061	2007-03-24	"Sat"	"Evening"	"720"	7	2	0	9
7060	2007-03-24	"Sat"	"Midday"	"527"	5	2	7	14
7059	2007-03-23	"Fri"	"Evening"	"932"	9	3	2	14
7058	2007-03-23	"Fri"	"Midday"	"012"	0	1	2	3
7057	2007-03-22	"Thu"	"Evening"	"487"	4	8	7	19
7056	2007-03-22	"Thu"	"Midday"	"164"	1	6	4	11
7055	2007-03-21	"Wed"	"Evening"	"277"	2	7	7	16
7054	2007-03-21	"Wed"	"Midday"	"473"	4	7	3	14
7053	2007-03-20	"Tue"	"Evening"	"642"	6	4	2	12
7052	2007-03-20	"Tue"	"Midday"	"294"	2	9	4	15
7051	2007-03-19	"Mon"	"Evening"	"597"	5	9	7	21
7050	2007-03-19	"Mon"	"Midday"	"385"	3	8	5	16
7049	2007-03-18	"Sun"	"Evening"	"108"	1	0	8	9
7048	2007-03-18	"Sun"	"Midday"	"029"	0	2	9	11
7047	2007-03-17	"Sat"	"Evening"	"320"	3	2	0	5
7046	2007-03-17	"Sat"	"Midday"	"816"	8	1	6	15
7045	2007-03-16	"Fri"	"Evening"	"472"	4	7	2	13
7044	2007-03-16	"Fri"	"Midday"	"075"	0	7	5	12
7043	2007-03-15	"Thu"	"Evening"	"531"	5	3	1	9
7042	2007-03-15	"Thu"	"Midday"	"022"	0	2	2	4
7041	2007-03-14	"Wed"	"Evening"	"477"	4	7	7	18
7040	2007-03-14	"Wed"	"Midday"	"938"	9	3	8	20
7039	2007-03-13	"Tue"	"Evening"	"480"	4	8	0	12
7038	2007-03-13	"Tue"	"Midday"	"591"	5	9	1	15
7037	2007-03-12	"Mon"	"Evening"	"490"	4	9	0	13
7036	2007-03-12	"Mon"	"Midday"	"062"	0	6	2	8
7035	2007-03-11	"Sun"	"Evening"	"789"	7	8	9	24
7034	2007-03-11	"Sun"	"Midday"	"071"	0	7	1	8
7033	2007-03-10	"Sat"	"Evening"	"305"	3	0	5	8
7032	2007-03-10	"Sat"	"Midday"	"447"	4	4	7	15
7031	2007-03-09	"Fri"	"Evening"	"465"	4	6	5	15
7030	2007-03-09	"Fri"	"Midday"	"579"	5	7	9	21
7029	2007-03-08	"Thu"	"Evening"	"702"	7	0	2	9
7028	2007-03-08	"Thu"	"Midday"	"448"	4	4	8	16
7027	2007-03-07	"Wed"	"Evening"	"991"	9	9	1	19
7026	2007-03-07	"Wed"	"Midday"	"259"	2	5	9	16
7025	2007-03-06	"Tue"	"Evening"	"581"	5	8	1	14
7024	2007-03-06	"Tue"	"Midday"	"502"	5	0	2	7
7023	2007-03-05	"Mon"	"Evening"	"986"	9	8	6	23
7022	2007-03-05	"Mon"	"Midday"	"046"	0	4	6	10
7021	2007-03-04	"Sun"	"Evening"	"024"	0	2	4	6
7020	2007-03-04	"Sun"	"Midday"	"296"	2	9	6	17
7019	2007-03-03	"Sat"	"Evening"	"549"	5	4	9	18
7018	2007-03-03	"Sat"	"Midday"	"238"	2	3	8	13
7017	2007-03-02	"Fri"	"Evening"	"402"	4	0	2	6
7016	2007-03-02	"Fri"	"Midday"	"207"	2	0	7	9
7015	2007-03-01	"Thu"	"Evening"	"717"	7	1	7	15
7014	2007-03-01	"Thu"	"Midday"	"874"	8	7	4	19
7013	2007-02-28	"Wed"	"Evening"	"871"	8	7	1	16
7012	2007-02-28	"Wed"	"Midday"	"449"	4	4	9	17
7011	2007-02-27	"Tue"	"Evening"	"601"	6	0	1	7
7010	2007-02-27	"Tue"	"Midday"	"818"	8	1	8	17
7009	2007-02-26	"Mon"	"Evening"	"369"	3	6	9	18
7008	2007-02-26	"Mon"	"Midday"	"335"	3	3	5	11
7007	2007-02-25	"Sun"	"Evening"	"357"	3	5	7	15
7006	2007-02-25	"Sun"	"Midday"	"981"	9	8	1	18
7005	2007-02-24	"Sat"	"Evening"	"879"	8	7	9	24
7004	2007-02-24	"Sat"	"Midday"	"556"	5	5	6	16
7003	2007-02-23	"Fri"	"Evening"	"786"	7	8	6	21
7002	2007-02-23	"Fri"	"Midday"	"409"	4	0	9	13
7001	2007-02-22	"Thu"	"Evening"	"851"	8	5	1	14
7000	2007-02-22	"Thu"	"Midday"	"302"	3	0	2	5
6999	2007-02-21	"Wed"	"Evening"	"096"	0	9	6	15
6998	2007-02-21	"Wed"	"Midday"	"694"	6	9	4	19
6997	2007-02-20	"Tue"	"Evening"	"240"	2	4	0	6
6996	2007-02-20	"Tue"	"Midday"	"717"	7	1	7	15
6995	2007-02-19	"Mon"	"Evening"	"508"	5	0	8	13
6994	2007-02-19	"Mon"	"Midday"	"160"	1	6	0	7
6993	2007-02-18	"Sun"	"Evening"	"801"	8	0	1	9
6992	2007-02-18	"Sun"	"Midday"	"178"	1	7	8	16
6991	2007-02-17	"Sat"	"Evening"	"550"	5	5	0	10
6990	2007-02-17	"Sat"	"Midday"	"320"	3	2	0	5
6989	2007-02-16	"Fri"	"Evening"	"629"	6	2	9	17
6988	2007-02-16	"Fri"	"Midday"	"188"	1	8	8	17
6987	2007-02-15	"Thu"	"Evening"	"440"	4	4	0	8
6986	2007-02-15	"Thu"	"Midday"	"409"	4	0	9	13
6985	2007-02-14	"Wed"	"Evening"	"166"	1	6	6	13
6984	2007-02-14	"Wed"	"Midday"	"274"	2	7	4	13
6983	2007-02-13	"Tue"	"Evening"	"087"	0	8	7	15
6982	2007-02-13	"Tue"	"Midday"	"097"	0	9	7	16
6981	2007-02-12	"Mon"	"Evening"	"360"	3	6	0	9
6980	2007-02-12	"Mon"	"Midday"	"656"	6	5	6	17
6979	2007-02-11	"Sun"	"Evening"	"370"	3	7	0	10
6978	2007-02-11	"Sun"	"Midday"	"249"	2	4	9	15
6977	2007-02-10	"Sat"	"Evening"	"930"	9	3	0	12
6976	2007-02-10	"Sat"	"Midday"	"424"	4	2	4	10
6975	2007-02-09	"Fri"	"Evening"	"856"	8	5	6	19
6974	2007-02-09	"Fri"	"Midday"	"407"	4	0	7	11
6973	2007-02-08	"Thu"	"Evening"	"002"	0	0	2	2
6972	2007-02-08	"Thu"	"Midday"	"232"	2	3	2	7
6971	2007-02-07	"Wed"	"Evening"	"414"	4	1	4	9
6970	2007-02-07	"Wed"	"Midday"	"616"	6	1	6	13
6969	2007-02-06	"Tue"	"Evening"	"092"	0	9	2	11
6968	2007-02-06	"Tue"	"Midday"	"176"	1	7	6	14
6967	2007-02-05	"Mon"	"Evening"	"001"	0	0	1	1
6966	2007-02-05	"Mon"	"Midday"	"285"	2	8	5	15
6965	2007-02-04	"Sun"	"Evening"	"323"	3	2	3	8
6964	2007-02-04	"Sun"	"Midday"	"274"	2	7	4	13
6963	2007-02-03	"Sat"	"Evening"	"860"	8	6	0	14
6962	2007-02-03	"Sat"	"Midday"	"866"	8	6	6	20
6961	2007-02-02	"Fri"	"Evening"	"482"	4	8	2	14
6960	2007-02-02	"Fri"	"Midday"	"559"	5	5	9	19
6959	2007-02-01	"Thu"	"Evening"	"364"	3	6	4	13
6958	2007-02-01	"Thu"	"Midday"	"863"	8	6	3	17
6957	2007-01-31	"Wed"	"Evening"	"338"	3	3	8	14
6956	2007-01-31	"Wed"	"Midday"	"608"	6	0	8	14
6955	2007-01-30	"Tue"	"Evening"	"836"	8	3	6	17
6954	2007-01-30	"Tue"	"Midday"	"568"	5	6	8	19
6953	2007-01-29	"Mon"	"Evening"	"405"	4	0	5	9
6952	2007-01-29	"Mon"	"Midday"	"534"	5	3	4	12
6951	2007-01-28	"Sun"	"Evening"	"782"	7	8	2	17
6950	2007-01-28	"Sun"	"Midday"	"490"	4	9	0	13
6949	2007-01-27	"Sat"	"Evening"	"315"	3	1	5	9
6948	2007-01-27	"Sat"	"Midday"	"894"	8	9	4	21
6947	2007-01-26	"Fri"	"Evening"	"586"	5	8	6	19
6946	2007-01-26	"Fri"	"Midday"	"474"	4	7	4	15
6945	2007-01-25	"Thu"	"Evening"	"871"	8	7	1	16
6944	2007-01-25	"Thu"	"Midday"	"747"	7	4	7	18
6943	2007-01-24	"Wed"	"Evening"	"749"	7	4	9	20
6942	2007-01-24	"Wed"	"Midday"	"605"	6	0	5	11
6941	2007-01-23	"Tue"	"Evening"	"863"	8	6	3	17
6940	2007-01-23	"Tue"	"Midday"	"059"	0	5	9	14
6939	2007-01-22	"Mon"	"Evening"	"862"	8	6	2	16
6938	2007-01-22	"Mon"	"Midday"	"972"	9	7	2	18
6937	2007-01-21	"Sun"	"Evening"	"219"	2	1	9	12
6936	2007-01-21	"Sun"	"Midday"	"533"	5	3	3	11
6935	2007-01-20	"Sat"	"Evening"	"940"	9	4	0	13
6934	2007-01-20	"Sat"	"Midday"	"994"	9	9	4	22
6933	2007-01-19	"Fri"	"Evening"	"187"	1	8	7	16
6932	2007-01-19	"Fri"	"Midday"	"548"	5	4	8	17
6931	2007-01-18	"Thu"	"Evening"	"273"	2	7	3	12
6930	2007-01-18	"Thu"	"Midday"	"862"	8	6	2	16
6929	2007-01-17	"Wed"	"Evening"	"281"	2	8	1	11
6928	2007-01-17	"Wed"	"Midday"	"136"	1	3	6	10
6927	2007-01-16	"Tue"	"Evening"	"785"	7	8	5	20
6926	2007-01-16	"Tue"	"Midday"	"414"	4	1	4	9
6925	2007-01-15	"Mon"	"Evening"	"023"	0	2	3	5
6924	2007-01-15	"Mon"	"Midday"	"652"	6	5	2	13
6923	2007-01-14	"Sun"	"Evening"	"765"	7	6	5	18
6922	2007-01-14	"Sun"	"Midday"	"803"	8	0	3	11
6921	2007-01-13	"Sat"	"Evening"	"406"	4	0	6	10
6920	2007-01-13	"Sat"	"Midday"	"110"	1	1	0	2
6919	2007-01-12	"Fri"	"Evening"	"442"	4	4	2	10
6918	2007-01-12	"Fri"	"Midday"	"508"	5	0	8	13
6917	2007-01-11	"Thu"	"Evening"	"324"	3	2	4	9
6916	2007-01-11	"Thu"	"Midday"	"787"	7	8	7	22
6915	2007-01-10	"Wed"	"Evening"	"018"	0	1	8	9
6914	2007-01-10	"Wed"	"Midday"	"767"	7	6	7	20
6913	2007-01-09	"Tue"	"Evening"	"589"	5	8	9	22
6912	2007-01-09	"Tue"	"Midday"	"680"	6	8	0	14
6911	2007-01-08	"Mon"	"Evening"	"325"	3	2	5	10
6910	2007-01-08	"Mon"	"Midday"	"068"	0	6	8	14
6909	2007-01-07	"Sun"	"Evening"	"571"	5	7	1	13
6908	2007-01-07	"Sun"	"Midday"	"701"	7	0	1	8
6907	2007-01-06	"Sat"	"Evening"	"927"	9	2	7	18
6906	2007-01-06	"Sat"	"Midday"	"236"	2	3	6	11
6905	2007-01-05	"Fri"	"Evening"	"699"	6	9	9	24
6904	2007-01-05	"Fri"	"Midday"	"531"	5	3	1	9
6903	2007-01-04	"Thu"	"Evening"	"637"	6	3	7	16
6902	2007-01-04	"Thu"	"Midday"	"486"	4	8	6	18
6901	2007-01-03	"Wed"	"Evening"	"767"	7	6	7	20
6900	2007-01-03	"Wed"	"Midday"	"017"	0	1	7	8
6899	2007-01-02	"Tue"	"Evening"	"103"	1	0	3	4
6898	2007-01-02	"Tue"	"Midday"	"494"	4	9	4	17
6897	2007-01-01	"Mon"	"Evening"	"166"	1	6	6	13
6896	2007-01-01	"Mon"	"Midday"	"566"	5	6	6	17
6895	2006-12-31	"Sun"	"Evening"	"129"	1	2	9	12
6894	2006-12-31	"Sun"	"Midday"	"192"	1	9	2	12
6893	2006-12-30	"Sat"	"Evening"	"242"	2	4	2	8
6892	2006-12-30	"Sat"	"Midday"	"351"	3	5	1	9
6891	2006-12-29	"Fri"	"Evening"	"309"	3	0	9	12
6890	2006-12-29	"Fri"	"Midday"	"962"	9	6	2	17
6889	2006-12-28	"Thu"	"Evening"	"924"	9	2	4	15
6888	2006-12-28	"Thu"	"Midday"	"543"	5	4	3	12
6887	2006-12-27	"Wed"	"Evening"	"853"	8	5	3	16
6886	2006-12-27	"Wed"	"Midday"	"300"	3	0	0	3
6885	2006-12-26	"Tue"	"Evening"	"039"	0	3	9	12
6884	2006-12-26	"Tue"	"Midday"	"201"	2	0	1	3
6883	2006-12-25	"Mon"	"Evening"	"043"	0	4	3	7
6882	2006-12-25	"Mon"	"Midday"	"072"	0	7	2	9
6881	2006-12-24	"Sun"	"Evening"	"914"	9	1	4	14
6880	2006-12-24	"Sun"	"Midday"	"438"	4	3	8	15
6879	2006-12-23	"Sat"	"Evening"	"526"	5	2	6	13
6878	2006-12-23	"Sat"	"Midday"	"395"	3	9	5	17
6877	2006-12-22	"Fri"	"Evening"	"842"	8	4	2	14
6876	2006-12-22	"Fri"	"Midday"	"655"	6	5	5	16
6875	2006-12-21	"Thu"	"Evening"	"408"	4	0	8	12
6874	2006-12-21	"Thu"	"Midday"	"707"	7	0	7	14
6873	2006-12-20	"Wed"	"Evening"	"726"	7	2	6	15
6872	2006-12-20	"Wed"	"Midday"	"388"	3	8	8	19
6871	2006-12-19	"Tue"	"Evening"	"952"	9	5	2	16
6870	2006-12-19	"Tue"	"Midday"	"131"	1	3	1	5
6869	2006-12-18	"Mon"	"Evening"	"221"	2	2	1	5
6868	2006-12-18	"Mon"	"Midday"	"032"	0	3	2	5
6867	2006-12-17	"Sun"	"Evening"	"960"	9	6	0	15
6866	2006-12-17	"Sun"	"Midday"	"514"	5	1	4	10
6865	2006-12-16	"Sat"	"Evening"	"968"	9	6	8	23
6864	2006-12-16	"Sat"	"Midday"	"942"	9	4	2	15
6863	2006-12-15	"Fri"	"Evening"	"156"	1	5	6	12
6862	2006-12-15	"Fri"	"Midday"	"493"	4	9	3	16
6861	2006-12-14	"Thu"	"Evening"	"128"	1	2	8	11
6860	2006-12-14	"Thu"	"Midday"	"424"	4	2	4	10
6859	2006-12-13	"Wed"	"Evening"	"529"	5	2	9	16
6858	2006-12-13	"Wed"	"Midday"	"138"	1	3	8	12
6857	2006-12-12	"Tue"	"Evening"	"452"	4	5	2	11
6856	2006-12-12	"Tue"	"Midday"	"888"	8	8	8	24
6855	2006-12-11	"Mon"	"Evening"	"967"	9	6	7	22
6854	2006-12-11	"Mon"	"Midday"	"273"	2	7	3	12
6853	2006-12-10	"Sun"	"Evening"	"039"	0	3	9	12
6852	2006-12-10	"Sun"	"Midday"	"713"	7	1	3	11
6851	2006-12-09	"Sat"	"Evening"	"921"	9	2	1	12
6850	2006-12-09	"Sat"	"Midday"	"916"	9	1	6	16
6849	2006-12-08	"Fri"	"Evening"	"514"	5	1	4	10
6848	2006-12-08	"Fri"	"Midday"	"460"	4	6	0	10
6847	2006-12-07	"Thu"	"Evening"	"327"	3	2	7	12
6846	2006-12-07	"Thu"	"Midday"	"844"	8	4	4	16
6845	2006-12-06	"Wed"	"Evening"	"694"	6	9	4	19
6844	2006-12-06	"Wed"	"Midday"	"212"	2	1	2	5
6843	2006-12-05	"Tue"	"Evening"	"451"	4	5	1	10
6842	2006-12-05	"Tue"	"Midday"	"902"	9	0	2	11
6841	2006-12-04	"Mon"	"Evening"	"103"	1	0	3	4
6840	2006-12-04	"Mon"	"Midday"	"181"	1	8	1	10
6839	2006-12-03	"Sun"	"Evening"	"820"	8	2	0	10
6838	2006-12-03	"Sun"	"Midday"	"733"	7	3	3	13
6837	2006-12-02	"Sat"	"Evening"	"858"	8	5	8	21
6836	2006-12-02	"Sat"	"Midday"	"121"	1	2	1	4
6835	2006-12-01	"Fri"	"Evening"	"317"	3	1	7	11
6834	2006-12-01	"Fri"	"Midday"	"209"	2	0	9	11
6833	2006-11-30	"Thu"	"Evening"	"798"	7	9	8	24
6832	2006-11-30	"Thu"	"Midday"	"019"	0	1	9	10
6831	2006-11-29	"Wed"	"Evening"	"027"	0	2	7	9
6830	2006-11-29	"Wed"	"Midday"	"060"	0	6	0	6
6829	2006-11-28	"Tue"	"Evening"	"914"	9	1	4	14
6828	2006-11-28	"Tue"	"Midday"	"620"	6	2	0	8
6827	2006-11-27	"Mon"	"Evening"	"491"	4	9	1	14
6826	2006-11-27	"Mon"	"Midday"	"131"	1	3	1	5
6825	2006-11-26	"Sun"	"Evening"	"277"	2	7	7	16
6824	2006-11-26	"Sun"	"Midday"	"802"	8	0	2	10
6823	2006-11-25	"Sat"	"Evening"	"509"	5	0	9	14
6822	2006-11-25	"Sat"	"Midday"	"338"	3	3	8	14
6821	2006-11-24	"Fri"	"Evening"	"323"	3	2	3	8
6820	2006-11-24	"Fri"	"Midday"	"751"	7	5	1	13
6819	2006-11-23	"Thu"	"Evening"	"917"	9	1	7	17
6818	2006-11-23	"Thu"	"Midday"	"431"	4	3	1	8
6817	2006-11-22	"Wed"	"Evening"	"905"	9	0	5	14
6816	2006-11-22	"Wed"	"Midday"	"829"	8	2	9	19
6815	2006-11-21	"Tue"	"Evening"	"355"	3	5	5	13
6814	2006-11-21	"Tue"	"Midday"	"432"	4	3	2	9
6813	2006-11-20	"Mon"	"Evening"	"026"	0	2	6	8
6812	2006-11-20	"Mon"	"Midday"	"358"	3	5	8	16
6811	2006-11-19	"Sun"	"Evening"	"445"	4	4	5	13
6810	2006-11-19	"Sun"	"Midday"	"630"	6	3	0	9
6809	2006-11-18	"Sat"	"Evening"	"135"	1	3	5	9
6808	2006-11-18	"Sat"	"Midday"	"623"	6	2	3	11
6807	2006-11-17	"Fri"	"Evening"	"777"	7	7	7	21
6806	2006-11-17	"Fri"	"Midday"	"512"	5	1	2	8
6805	2006-11-16	"Thu"	"Evening"	"385"	3	8	5	16
6804	2006-11-16	"Thu"	"Midday"	"870"	8	7	0	15
6803	2006-11-15	"Wed"	"Evening"	"021"	0	2	1	3
6802	2006-11-15	"Wed"	"Midday"	"796"	7	9	6	22
6801	2006-11-14	"Tue"	"Evening"	"715"	7	1	5	13
6800	2006-11-14	"Tue"	"Midday"	"588"	5	8	8	21
6799	2006-11-13	"Mon"	"Evening"	"573"	5	7	3	15
6798	2006-11-13	"Mon"	"Midday"	"323"	3	2	3	8
6797	2006-11-12	"Sun"	"Evening"	"217"	2	1	7	10
6796	2006-11-12	"Sun"	"Midday"	"599"	5	9	9	23
6795	2006-11-11	"Sat"	"Evening"	"370"	3	7	0	10
6794	2006-11-11	"Sat"	"Midday"	"016"	0	1	6	7
6793	2006-11-10	"Fri"	"Evening"	"027"	0	2	7	9
6792	2006-11-10	"Fri"	"Midday"	"177"	1	7	7	15
6791	2006-11-09	"Thu"	"Evening"	"016"	0	1	6	7
6790	2006-11-09	"Thu"	"Midday"	"019"	0	1	9	10
6789	2006-11-08	"Wed"	"Evening"	"325"	3	2	5	10
6788	2006-11-08	"Wed"	"Midday"	"227"	2	2	7	11
6787	2006-11-07	"Tue"	"Evening"	"772"	7	7	2	16
6786	2006-11-07	"Tue"	"Midday"	"856"	8	5	6	19
6785	2006-11-06	"Mon"	"Evening"	"761"	7	6	1	14
6784	2006-11-06	"Mon"	"Midday"	"768"	7	6	8	21
6783	2006-11-05	"Sun"	"Evening"	"702"	7	0	2	9
6782	2006-11-05	"Sun"	"Midday"	"823"	8	2	3	13
6781	2006-11-04	"Sat"	"Evening"	"521"	5	2	1	8
6780	2006-11-04	"Sat"	"Midday"	"041"	0	4	1	5
6779	2006-11-03	"Fri"	"Evening"	"209"	2	0	9	11
6778	2006-11-03	"Fri"	"Midday"	"785"	7	8	5	20
6777	2006-11-02	"Thu"	"Evening"	"146"	1	4	6	11
6776	2006-11-02	"Thu"	"Midday"	"480"	4	8	0	12
6775	2006-11-01	"Wed"	"Evening"	"684"	6	8	4	18
6774	2006-11-01	"Wed"	"Midday"	"594"	5	9	4	18
6773	2006-10-31	"Tue"	"Evening"	"865"	8	6	5	19
6772	2006-10-31	"Tue"	"Midday"	"065"	0	6	5	11
6771	2006-10-30	"Mon"	"Evening"	"846"	8	4	6	18
6770	2006-10-30	"Mon"	"Midday"	"173"	1	7	3	11
6769	2006-10-29	"Sun"	"Evening"	"646"	6	4	6	16
6768	2006-10-29	"Sun"	"Midday"	"985"	9	8	5	22
6767	2006-10-28	"Sat"	"Evening"	"138"	1	3	8	12
6766	2006-10-28	"Sat"	"Midday"	"342"	3	4	2	9
6765	2006-10-27	"Fri"	"Evening"	"821"	8	2	1	11
6764	2006-10-27	"Fri"	"Midday"	"263"	2	6	3	11
6763	2006-10-26	"Thu"	"Evening"	"621"	6	2	1	9
6762	2006-10-26	"Thu"	"Midday"	"041"	0	4	1	5
6761	2006-10-25	"Wed"	"Evening"	"403"	4	0	3	7
6760	2006-10-25	"Wed"	"Midday"	"961"	9	6	1	16
6759	2006-10-24	"Tue"	"Evening"	"559"	5	5	9	19
6758	2006-10-24	"Tue"	"Midday"	"520"	5	2	0	7
6757	2006-10-23	"Mon"	"Evening"	"070"	0	7	0	7
6756	2006-10-23	"Mon"	"Midday"	"618"	6	1	8	15
6755	2006-10-22	"Sun"	"Evening"	"891"	8	9	1	18
6754	2006-10-22	"Sun"	"Midday"	"456"	4	5	6	15
6753	2006-10-21	"Sat"	"Evening"	"893"	8	9	3	20
6752	2006-10-21	"Sat"	"Midday"	"933"	9	3	3	15
6751	2006-10-20	"Fri"	"Evening"	"167"	1	6	7	14
6750	2006-10-20	"Fri"	"Midday"	"348"	3	4	8	15
6749	2006-10-19	"Thu"	"Evening"	"215"	2	1	5	8
6748	2006-10-19	"Thu"	"Midday"	"557"	5	5	7	17
6747	2006-10-18	"Wed"	"Evening"	"974"	9	7	4	20
6746	2006-10-18	"Wed"	"Midday"	"162"	1	6	2	9
6745	2006-10-17	"Tue"	"Evening"	"936"	9	3	6	18
6744	2006-10-17	"Tue"	"Midday"	"541"	5	4	1	10
6743	2006-10-16	"Mon"	"Evening"	"485"	4	8	5	17
6742	2006-10-16	"Mon"	"Midday"	"933"	9	3	3	15
6741	2006-10-15	"Sun"	"Evening"	"437"	4	3	7	14
6740	2006-10-15	"Sun"	"Midday"	"872"	8	7	2	17
6739	2006-10-14	"Sat"	"Evening"	"462"	4	6	2	12
6738	2006-10-14	"Sat"	"Midday"	"837"	8	3	7	18
6737	2006-10-13	"Fri"	"Evening"	"065"	0	6	5	11
6736	2006-10-13	"Fri"	"Midday"	"510"	5	1	0	6
6735	2006-10-12	"Thu"	"Evening"	"320"	3	2	0	5
6734	2006-10-12	"Thu"	"Midday"	"351"	3	5	1	9
6733	2006-10-11	"Wed"	"Evening"	"275"	2	7	5	14
6732	2006-10-11	"Wed"	"Midday"	"673"	6	7	3	16
6731	2006-10-10	"Tue"	"Evening"	"198"	1	9	8	18
6730	2006-10-10	"Tue"	"Midday"	"261"	2	6	1	9
6729	2006-10-09	"Mon"	"Evening"	"510"	5	1	0	6
6728	2006-10-09	"Mon"	"Midday"	"727"	7	2	7	16
6727	2006-10-08	"Sun"	"Evening"	"353"	3	5	3	11
6726	2006-10-08	"Sun"	"Midday"	"650"	6	5	0	11
6725	2006-10-07	"Sat"	"Evening"	"869"	8	6	9	23
6724	2006-10-07	"Sat"	"Midday"	"390"	3	9	0	12
6723	2006-10-06	"Fri"	"Evening"	"256"	2	5	6	13
6722	2006-10-06	"Fri"	"Midday"	"579"	5	7	9	21
6721	2006-10-05	"Thu"	"Evening"	"648"	6	4	8	18
6720	2006-10-05	"Thu"	"Midday"	"210"	2	1	0	3
6719	2006-10-04	"Wed"	"Evening"	"571"	5	7	1	13
6718	2006-10-04	"Wed"	"Midday"	"488"	4	8	8	20
6717	2006-10-03	"Tue"	"Evening"	"637"	6	3	7	16
6716	2006-10-03	"Tue"	"Midday"	"915"	9	1	5	15
6715	2006-10-02	"Mon"	"Evening"	"301"	3	0	1	4
6714	2006-10-02	"Mon"	"Midday"	"892"	8	9	2	19
6713	2006-10-01	"Sun"	"Evening"	"947"	9	4	7	20
6712	2006-10-01	"Sun"	"Midday"	"595"	5	9	5	19
6711	2006-09-30	"Sat"	"Evening"	"091"	0	9	1	10
6710	2006-09-30	"Sat"	"Midday"	"189"	1	8	9	18
6709	2006-09-29	"Fri"	"Evening"	"157"	1	5	7	13
6708	2006-09-29	"Fri"	"Midday"	"637"	6	3	7	16
6707	2006-09-28	"Thu"	"Evening"	"294"	2	9	4	15
6706	2006-09-28	"Thu"	"Midday"	"666"	6	6	6	18
6705	2006-09-27	"Wed"	"Evening"	"729"	7	2	9	18
6704	2006-09-27	"Wed"	"Midday"	"756"	7	5	6	18
6703	2006-09-26	"Tue"	"Evening"	"751"	7	5	1	13
6702	2006-09-26	"Tue"	"Midday"	"160"	1	6	0	7
6701	2006-09-25	"Mon"	"Evening"	"087"	0	8	7	15
6700	2006-09-25	"Mon"	"Midday"	"499"	4	9	9	22
6699	2006-09-24	"Sun"	"Evening"	"396"	3	9	6	18
6698	2006-09-24	"Sun"	"Midday"	"228"	2	2	8	12
6697	2006-09-23	"Sat"	"Evening"	"175"	1	7	5	13
6696	2006-09-23	"Sat"	"Midday"	"048"	0	4	8	12
6695	2006-09-22	"Fri"	"Evening"	"329"	3	2	9	14
6694	2006-09-22	"Fri"	"Midday"	"055"	0	5	5	10
6693	2006-09-21	"Thu"	"Evening"	"951"	9	5	1	15
6692	2006-09-21	"Thu"	"Midday"	"068"	0	6	8	14
6691	2006-09-20	"Wed"	"Evening"	"382"	3	8	2	13
6690	2006-09-20	"Wed"	"Midday"	"084"	0	8	4	12
6689	2006-09-19	"Tue"	"Evening"	"496"	4	9	6	19
6688	2006-09-19	"Tue"	"Midday"	"156"	1	5	6	12
6687	2006-09-18	"Mon"	"Evening"	"978"	9	7	8	24
6686	2006-09-18	"Mon"	"Midday"	"423"	4	2	3	9
6685	2006-09-17	"Sun"	"Evening"	"868"	8	6	8	22
6684	2006-09-17	"Sun"	"Midday"	"455"	4	5	5	14
6683	2006-09-16	"Sat"	"Evening"	"466"	4	6	6	16
6682	2006-09-16	"Sat"	"Midday"	"862"	8	6	2	16
6681	2006-09-15	"Fri"	"Evening"	"347"	3	4	7	14
6680	2006-09-15	"Fri"	"Midday"	"154"	1	5	4	10
6679	2006-09-14	"Thu"	"Evening"	"802"	8	0	2	10
6678	2006-09-14	"Thu"	"Midday"	"084"	0	8	4	12
6677	2006-09-13	"Wed"	"Evening"	"662"	6	6	2	14
6676	2006-09-13	"Wed"	"Midday"	"372"	3	7	2	12
6675	2006-09-12	"Tue"	"Evening"	"100"	1	0	0	1
6674	2006-09-12	"Tue"	"Midday"	"379"	3	7	9	19
6673	2006-09-11	"Mon"	"Evening"	"395"	3	9	5	17
6672	2006-09-11	"Mon"	"Midday"	"933"	9	3	3	15
6671	2006-09-10	"Sun"	"Evening"	"424"	4	2	4	10
6670	2006-09-10	"Sun"	"Midday"	"918"	9	1	8	18
6669	2006-09-09	"Sat"	"Evening"	"550"	5	5	0	10
6668	2006-09-09	"Sat"	"Midday"	"701"	7	0	1	8
6667	2006-09-08	"Fri"	"Evening"	"449"	4	4	9	17
6666	2006-09-08	"Fri"	"Midday"	"233"	2	3	3	8
6665	2006-09-07	"Thu"	"Evening"	"803"	8	0	3	11
6664	2006-09-07	"Thu"	"Midday"	"199"	1	9	9	19
6663	2006-09-06	"Wed"	"Evening"	"468"	4	6	8	18
6662	2006-09-06	"Wed"	"Midday"	"066"	0	6	6	12
6661	2006-09-05	"Tue"	"Evening"	"178"	1	7	8	16
6660	2006-09-05	"Tue"	"Midday"	"139"	1	3	9	13
6659	2006-09-04	"Mon"	"Evening"	"563"	5	6	3	14
6658	2006-09-04	"Mon"	"Midday"	"500"	5	0	0	5
6657	2006-09-03	"Sun"	"Evening"	"396"	3	9	6	18
6656	2006-09-03	"Sun"	"Midday"	"943"	9	4	3	16
6655	2006-09-02	"Sat"	"Evening"	"874"	8	7	4	19
6654	2006-09-02	"Sat"	"Midday"	"358"	3	5	8	16
6653	2006-09-01	"Fri"	"Evening"	"416"	4	1	6	11
6652	2006-09-01	"Fri"	"Midday"	"939"	9	3	9	21
6651	2006-08-31	"Thu"	"Evening"	"473"	4	7	3	14
6650	2006-08-31	"Thu"	"Midday"	"766"	7	6	6	19
6649	2006-08-30	"Wed"	"Evening"	"114"	1	1	4	6
6648	2006-08-30	"Wed"	"Midday"	"773"	7	7	3	17
6647	2006-08-29	"Tue"	"Evening"	"137"	1	3	7	11
6646	2006-08-29	"Tue"	"Midday"	"176"	1	7	6	14
6645	2006-08-28	"Mon"	"Evening"	"884"	8	8	4	20
6644	2006-08-28	"Mon"	"Midday"	"168"	1	6	8	15
6643	2006-08-27	"Sun"	"Evening"	"704"	7	0	4	11
6642	2006-08-27	"Sun"	"Midday"	"538"	5	3	8	16
6641	2006-08-26	"Sat"	"Evening"	"307"	3	0	7	10
6640	2006-08-26	"Sat"	"Midday"	"198"	1	9	8	18
6639	2006-08-25	"Fri"	"Evening"	"158"	1	5	8	14
6638	2006-08-25	"Fri"	"Midday"	"607"	6	0	7	13
6637	2006-08-24	"Thu"	"Evening"	"330"	3	3	0	6
6636	2006-08-24	"Thu"	"Midday"	"577"	5	7	7	19
6635	2006-08-23	"Wed"	"Evening"	"572"	5	7	2	14
6634	2006-08-23	"Wed"	"Midday"	"586"	5	8	6	19
6633	2006-08-22	"Tue"	"Evening"	"746"	7	4	6	17
6632	2006-08-22	"Tue"	"Midday"	"943"	9	4	3	16
6631	2006-08-21	"Mon"	"Evening"	"470"	4	7	0	11
6630	2006-08-21	"Mon"	"Midday"	"123"	1	2	3	6
6629	2006-08-20	"Sun"	"Evening"	"242"	2	4	2	8
6628	2006-08-20	"Sun"	"Midday"	"614"	6	1	4	11
6627	2006-08-19	"Sat"	"Evening"	"132"	1	3	2	6
6626	2006-08-19	"Sat"	"Midday"	"722"	7	2	2	11
6625	2006-08-18	"Fri"	"Evening"	"448"	4	4	8	16
6624	2006-08-18	"Fri"	"Midday"	"929"	9	2	9	20
6623	2006-08-17	"Thu"	"Evening"	"106"	1	0	6	7
6622	2006-08-17	"Thu"	"Midday"	"247"	2	4	7	13
6621	2006-08-16	"Wed"	"Evening"	"636"	6	3	6	15
6620	2006-08-16	"Wed"	"Midday"	"240"	2	4	0	6
6619	2006-08-15	"Tue"	"Evening"	"022"	0	2	2	4
6618	2006-08-15	"Tue"	"Midday"	"669"	6	6	9	21
6617	2006-08-14	"Mon"	"Evening"	"682"	6	8	2	16
6616	2006-08-14	"Mon"	"Midday"	"895"	8	9	5	22
6615	2006-08-13	"Sun"	"Evening"	"490"	4	9	0	13
6614	2006-08-13	"Sun"	"Midday"	"744"	7	4	4	15
6613	2006-08-12	"Sat"	"Evening"	"044"	0	4	4	8
6612	2006-08-12	"Sat"	"Midday"	"871"	8	7	1	16
6611	2006-08-11	"Fri"	"Evening"	"922"	9	2	2	13
6610	2006-08-11	"Fri"	"Midday"	"604"	6	0	4	10
6609	2006-08-10	"Thu"	"Evening"	"197"	1	9	7	17
6608	2006-08-10	"Thu"	"Midday"	"126"	1	2	6	9
6607	2006-08-09	"Wed"	"Evening"	"888"	8	8	8	24
6606	2006-08-09	"Wed"	"Midday"	"509"	5	0	9	14
6605	2006-08-08	"Tue"	"Evening"	"771"	7	7	1	15
6604	2006-08-08	"Tue"	"Midday"	"589"	5	8	9	22
6603	2006-08-07	"Mon"	"Evening"	"360"	3	6	0	9
6602	2006-08-07	"Mon"	"Midday"	"826"	8	2	6	16
6601	2006-08-06	"Sun"	"Evening"	"604"	6	0	4	10
6600	2006-08-06	"Sun"	"Midday"	"876"	8	7	6	21
6599	2006-08-05	"Sat"	"Evening"	"983"	9	8	3	20
6598	2006-08-05	"Sat"	"Midday"	"359"	3	5	9	17
6597	2006-08-04	"Fri"	"Evening"	"501"	5	0	1	6
6596	2006-08-04	"Fri"	"Midday"	"648"	6	4	8	18
6595	2006-08-03	"Thu"	"Evening"	"948"	9	4	8	21
6594	2006-08-03	"Thu"	"Midday"	"743"	7	4	3	14
6593	2006-08-02	"Wed"	"Evening"	"935"	9	3	5	17
6592	2006-08-02	"Wed"	"Midday"	"559"	5	5	9	19
6591	2006-08-01	"Tue"	"Evening"	"005"	0	0	5	5
6590	2006-08-01	"Tue"	"Midday"	"140"	1	4	0	5
6589	2006-07-31	"Mon"	"Evening"	"048"	0	4	8	12
6588	2006-07-31	"Mon"	"Midday"	"385"	3	8	5	16
6587	2006-07-30	"Sun"	"Evening"	"434"	4	3	4	11
6586	2006-07-30	"Sun"	"Midday"	"092"	0	9	2	11
6585	2006-07-29	"Sat"	"Evening"	"384"	3	8	4	15
6584	2006-07-29	"Sat"	"Midday"	"956"	9	5	6	20
6583	2006-07-28	"Fri"	"Evening"	"201"	2	0	1	3
6582	2006-07-28	"Fri"	"Midday"	"043"	0	4	3	7
6581	2006-07-27	"Thu"	"Evening"	"969"	9	6	9	24
6580	2006-07-27	"Thu"	"Midday"	"027"	0	2	7	9
6579	2006-07-26	"Wed"	"Evening"	"961"	9	6	1	16
6578	2006-07-26	"Wed"	"Midday"	"396"	3	9	6	18
6577	2006-07-25	"Tue"	"Evening"	"824"	8	2	4	14
6576	2006-07-25	"Tue"	"Midday"	"929"	9	2	9	20
6575	2006-07-24	"Mon"	"Evening"	"649"	6	4	9	19
6574	2006-07-24	"Mon"	"Midday"	"686"	6	8	6	20
6573	2006-07-23	"Sun"	"Evening"	"159"	1	5	9	15
6572	2006-07-23	"Sun"	"Midday"	"954"	9	5	4	18
6571	2006-07-22	"Sat"	"Evening"	"025"	0	2	5	7
6570	2006-07-22	"Sat"	"Midday"	"685"	6	8	5	19
6569	2006-07-21	"Fri"	"Evening"	"429"	4	2	9	15
6568	2006-07-21	"Fri"	"Midday"	"506"	5	0	6	11
6567	2006-07-20	"Thu"	"Evening"	"647"	6	4	7	17
6566	2006-07-20	"Thu"	"Midday"	"622"	6	2	2	10
6565	2006-07-19	"Wed"	"Evening"	"115"	1	1	5	7
6564	2006-07-19	"Wed"	"Midday"	"772"	7	7	2	16
6563	2006-07-18	"Tue"	"Evening"	"368"	3	6	8	17
6562	2006-07-18	"Tue"	"Midday"	"501"	5	0	1	6
6561	2006-07-17	"Mon"	"Evening"	"507"	5	0	7	12
6560	2006-07-17	"Mon"	"Midday"	"308"	3	0	8	11
6559	2006-07-16	"Sun"	"Evening"	"964"	9	6	4	19
6558	2006-07-16	"Sun"	"Midday"	"468"	4	6	8	18
6557	2006-07-15	"Sat"	"Evening"	"928"	9	2	8	19
6556	2006-07-15	"Sat"	"Midday"	"894"	8	9	4	21
6555	2006-07-14	"Fri"	"Evening"	"041"	0	4	1	5
6554	2006-07-14	"Fri"	"Midday"	"030"	0	3	0	3
6553	2006-07-13	"Thu"	"Evening"	"721"	7	2	1	10
6552	2006-07-13	"Thu"	"Midday"	"071"	0	7	1	8
6551	2006-07-12	"Wed"	"Evening"	"964"	9	6	4	19
6550	2006-07-12	"Wed"	"Midday"	"979"	9	7	9	25
6549	2006-07-11	"Tue"	"Evening"	"508"	5	0	8	13
6548	2006-07-11	"Tue"	"Midday"	"669"	6	6	9	21
6547	2006-07-10	"Mon"	"Evening"	"266"	2	6	6	14
6546	2006-07-10	"Mon"	"Midday"	"464"	4	6	4	14
6545	2006-07-09	"Sun"	"Evening"	"091"	0	9	1	10
6544	2006-07-09	"Sun"	"Midday"	"813"	8	1	3	12
6543	2006-07-08	"Sat"	"Evening"	"385"	3	8	5	16
6542	2006-07-08	"Sat"	"Midday"	"480"	4	8	0	12
6541	2006-07-07	"Fri"	"Evening"	"362"	3	6	2	11
6540	2006-07-07	"Fri"	"Midday"	"917"	9	1	7	17
6539	2006-07-06	"Thu"	"Evening"	"033"	0	3	3	6
6538	2006-07-06	"Thu"	"Midday"	"182"	1	8	2	11
6537	2006-07-05	"Wed"	"Evening"	"684"	6	8	4	18
6536	2006-07-05	"Wed"	"Midday"	"249"	2	4	9	15
6535	2006-07-04	"Tue"	"Evening"	"237"	2	3	7	12
6534	2006-07-04	"Tue"	"Midday"	"989"	9	8	9	26
6533	2006-07-03	"Mon"	"Evening"	"944"	9	4	4	17
6532	2006-07-03	"Mon"	"Midday"	"230"	2	3	0	5
6531	2006-07-02	"Sun"	"Evening"	"482"	4	8	2	14
6530	2006-07-02	"Sun"	"Midday"	"943"	9	4	3	16
6529	2006-07-01	"Sat"	"Evening"	"449"	4	4	9	17
6528	2006-07-01	"Sat"	"Midday"	"573"	5	7	3	15
6527	2006-06-30	"Fri"	"Evening"	"951"	9	5	1	15
6526	2006-06-30	"Fri"	"Midday"	"056"	0	5	6	11
6525	2006-06-29	"Thu"	"Evening"	"103"	1	0	3	4
6524	2006-06-29	"Thu"	"Midday"	"696"	6	9	6	21
6523	2006-06-28	"Wed"	"Evening"	"230"	2	3	0	5
6522	2006-06-28	"Wed"	"Midday"	"482"	4	8	2	14
6521	2006-06-27	"Tue"	"Evening"	"047"	0	4	7	11
6520	2006-06-27	"Tue"	"Midday"	"534"	5	3	4	12
6519	2006-06-26	"Mon"	"Evening"	"199"	1	9	9	19
6518	2006-06-26	"Mon"	"Midday"	"904"	9	0	4	13
6517	2006-06-25	"Sun"	"Evening"	"737"	7	3	7	17
6516	2006-06-25	"Sun"	"Midday"	"726"	7	2	6	15
6515	2006-06-24	"Sat"	"Evening"	"908"	9	0	8	17
6514	2006-06-24	"Sat"	"Midday"	"842"	8	4	2	14
6513	2006-06-23	"Fri"	"Evening"	"586"	5	8	6	19
6512	2006-06-23	"Fri"	"Midday"	"581"	5	8	1	14
6511	2006-06-22	"Thu"	"Evening"	"225"	2	2	5	9
6510	2006-06-22	"Thu"	"Midday"	"663"	6	6	3	15
6509	2006-06-21	"Wed"	"Evening"	"090"	0	9	0	9
6508	2006-06-21	"Wed"	"Midday"	"008"	0	0	8	8
6507	2006-06-20	"Tue"	"Evening"	"757"	7	5	7	19
6506	2006-06-20	"Tue"	"Midday"	"622"	6	2	2	10
6505	2006-06-19	"Mon"	"Evening"	"315"	3	1	5	9
6504	2006-06-19	"Mon"	"Midday"	"362"	3	6	2	11
6503	2006-06-18	"Sun"	"Evening"	"199"	1	9	9	19
6502	2006-06-18	"Sun"	"Midday"	"983"	9	8	3	20
6501	2006-06-17	"Sat"	"Evening"	"364"	3	6	4	13
6500	2006-06-17	"Sat"	"Midday"	"994"	9	9	4	22
6499	2006-06-16	"Fri"	"Evening"	"491"	4	9	1	14
6498	2006-06-16	"Fri"	"Midday"	"770"	7	7	0	14
6497	2006-06-15	"Thu"	"Evening"	"384"	3	8	4	15
6496	2006-06-15	"Thu"	"Midday"	"689"	6	8	9	23
6495	2006-06-14	"Wed"	"Evening"	"888"	8	8	8	24
6494	2006-06-14	"Wed"	"Midday"	"949"	9	4	9	22
6493	2006-06-13	"Tue"	"Evening"	"553"	5	5	3	13
6492	2006-06-13	"Tue"	"Midday"	"270"	2	7	0	9
6491	2006-06-12	"Mon"	"Evening"	"024"	0	2	4	6
6490	2006-06-12	"Mon"	"Midday"	"812"	8	1	2	11
6489	2006-06-11	"Sun"	"Evening"	"757"	7	5	7	19
6488	2006-06-11	"Sun"	"Midday"	"442"	4	4	2	10
6487	2006-06-10	"Sat"	"Evening"	"935"	9	3	5	17
6486	2006-06-10	"Sat"	"Midday"	"572"	5	7	2	14
6485	2006-06-09	"Fri"	"Evening"	"449"	4	4	9	17
6484	2006-06-09	"Fri"	"Midday"	"486"	4	8	6	18
6483	2006-06-08	"Thu"	"Evening"	"053"	0	5	3	8
6482	2006-06-08	"Thu"	"Midday"	"485"	4	8	5	17
6481	2006-06-07	"Wed"	"Evening"	"303"	3	0	3	6
6480	2006-06-07	"Wed"	"Midday"	"571"	5	7	1	13
6479	2006-06-06	"Tue"	"Evening"	"754"	7	5	4	16
6478	2006-06-06	"Tue"	"Midday"	"583"	5	8	3	16
6477	2006-06-05	"Mon"	"Evening"	"467"	4	6	7	17
6476	2006-06-05	"Mon"	"Midday"	"015"	0	1	5	6
6475	2006-06-04	"Sun"	"Evening"	"546"	5	4	6	15
6474	2006-06-04	"Sun"	"Midday"	"856"	8	5	6	19
6473	2006-06-03	"Sat"	"Evening"	"462"	4	6	2	12
6472	2006-06-03	"Sat"	"Midday"	"017"	0	1	7	8
6471	2006-06-02	"Fri"	"Evening"	"682"	6	8	2	16
6470	2006-06-02	"Fri"	"Midday"	"928"	9	2	8	19
6469	2006-06-01	"Thu"	"Evening"	"029"	0	2	9	11
6468	2006-06-01	"Thu"	"Midday"	"519"	5	1	9	15
6467	2006-05-31	"Wed"	"Evening"	"113"	1	1	3	5
6466	2006-05-31	"Wed"	"Midday"	"522"	5	2	2	9
6465	2006-05-30	"Tue"	"Evening"	"671"	6	7	1	14
6464	2006-05-30	"Tue"	"Midday"	"712"	7	1	2	10
6463	2006-05-29	"Mon"	"Evening"	"074"	0	7	4	11
6462	2006-05-29	"Mon"	"Midday"	"215"	2	1	5	8
6461	2006-05-28	"Sun"	"Evening"	"146"	1	4	6	11
6460	2006-05-28	"Sun"	"Midday"	"157"	1	5	7	13
6459	2006-05-27	"Sat"	"Evening"	"450"	4	5	0	9
6458	2006-05-27	"Sat"	"Midday"	"681"	6	8	1	15
6457	2006-05-26	"Fri"	"Evening"	"135"	1	3	5	9
6456	2006-05-26	"Fri"	"Midday"	"380"	3	8	0	11
6455	2006-05-25	"Thu"	"Evening"	"628"	6	2	8	16
6454	2006-05-25	"Thu"	"Midday"	"801"	8	0	1	9
6453	2006-05-24	"Wed"	"Evening"	"392"	3	9	2	14
6452	2006-05-24	"Wed"	"Midday"	"562"	5	6	2	13
6451	2006-05-23	"Tue"	"Evening"	"934"	9	3	4	16
6450	2006-05-23	"Tue"	"Midday"	"873"	8	7	3	18
6449	2006-05-22	"Mon"	"Evening"	"335"	3	3	5	11
6448	2006-05-22	"Mon"	"Midday"	"695"	6	9	5	20
6447	2006-05-21	"Sun"	"Evening"	"215"	2	1	5	8
6446	2006-05-21	"Sun"	"Midday"	"246"	2	4	6	12
6445	2006-05-20	"Sat"	"Evening"	"714"	7	1	4	12
6444	2006-05-20	"Sat"	"Midday"	"099"	0	9	9	18
6443	2006-05-19	"Fri"	"Evening"	"454"	4	5	4	13
6442	2006-05-19	"Fri"	"Midday"	"364"	3	6	4	13
6441	2006-05-18	"Thu"	"Evening"	"388"	3	8	8	19
6440	2006-05-18	"Thu"	"Midday"	"632"	6	3	2	11
6439	2006-05-17	"Wed"	"Evening"	"245"	2	4	5	11
6438	2006-05-17	"Wed"	"Midday"	"496"	4	9	6	19
6437	2006-05-16	"Tue"	"Evening"	"101"	1	0	1	2
6436	2006-05-16	"Tue"	"Midday"	"489"	4	8	9	21
6435	2006-05-15	"Mon"	"Evening"	"845"	8	4	5	17
6434	2006-05-15	"Mon"	"Midday"	"627"	6	2	7	15
6433	2006-05-14	"Sun"	"Evening"	"171"	1	7	1	9
6432	2006-05-14	"Sun"	"Midday"	"686"	6	8	6	20
6431	2006-05-13	"Sat"	"Evening"	"447"	4	4	7	15
6430	2006-05-13	"Sat"	"Midday"	"866"	8	6	6	20
6429	2006-05-12	"Fri"	"Evening"	"629"	6	2	9	17
6428	2006-05-12	"Fri"	"Midday"	"412"	4	1	2	7
6427	2006-05-11	"Thu"	"Evening"	"154"	1	5	4	10
6426	2006-05-11	"Thu"	"Midday"	"574"	5	7	4	16
6425	2006-05-10	"Wed"	"Evening"	"080"	0	8	0	8
6424	2006-05-10	"Wed"	"Midday"	"480"	4	8	0	12
6423	2006-05-09	"Tue"	"Evening"	"680"	6	8	0	14
6422	2006-05-09	"Tue"	"Midday"	"576"	5	7	6	18
6421	2006-05-08	"Mon"	"Evening"	"953"	9	5	3	17
6420	2006-05-08	"Mon"	"Midday"	"197"	1	9	7	17
6419	2006-05-07	"Sun"	"Evening"	"357"	3	5	7	15
6418	2006-05-07	"Sun"	"Midday"	"351"	3	5	1	9
6417	2006-05-06	"Sat"	"Evening"	"224"	2	2	4	8
6416	2006-05-06	"Sat"	"Midday"	"657"	6	5	7	18
6415	2006-05-05	"Fri"	"Evening"	"195"	1	9	5	15
6414	2006-05-05	"Fri"	"Midday"	"764"	7	6	4	17
6413	2006-05-04	"Thu"	"Evening"	"720"	7	2	0	9
6412	2006-05-04	"Thu"	"Midday"	"655"	6	5	5	16
6411	2006-05-03	"Wed"	"Evening"	"143"	1	4	3	8
6410	2006-05-03	"Wed"	"Midday"	"516"	5	1	6	12
6409	2006-05-02	"Tue"	"Evening"	"434"	4	3	4	11
6408	2006-05-02	"Tue"	"Midday"	"638"	6	3	8	17
6407	2006-05-01	"Mon"	"Evening"	"801"	8	0	1	9
6406	2006-05-01	"Mon"	"Midday"	"382"	3	8	2	13
6405	2006-04-30	"Sun"	"Evening"	"340"	3	4	0	7
6404	2006-04-30	"Sun"	"Midday"	"622"	6	2	2	10
6403	2006-04-29	"Sat"	"Evening"	"143"	1	4	3	8
6402	2006-04-29	"Sat"	"Midday"	"794"	7	9	4	20
6401	2006-04-28	"Fri"	"Evening"	"582"	5	8	2	15
6400	2006-04-28	"Fri"	"Midday"	"793"	7	9	3	19
6399	2006-04-27	"Thu"	"Evening"	"351"	3	5	1	9
6398	2006-04-27	"Thu"	"Midday"	"068"	0	6	8	14
6397	2006-04-26	"Wed"	"Evening"	"127"	1	2	7	10
6396	2006-04-26	"Wed"	"Midday"	"770"	7	7	0	14
6395	2006-04-25	"Tue"	"Evening"	"771"	7	7	1	15
6394	2006-04-25	"Tue"	"Midday"	"314"	3	1	4	8
6393	2006-04-24	"Mon"	"Evening"	"720"	7	2	0	9
6392	2006-04-24	"Mon"	"Midday"	"560"	5	6	0	11
6391	2006-04-23	"Sun"	"Evening"	"641"	6	4	1	11
6390	2006-04-23	"Sun"	"Midday"	"820"	8	2	0	10
6389	2006-04-22	"Sat"	"Evening"	"478"	4	7	8	19
6388	2006-04-22	"Sat"	"Midday"	"577"	5	7	7	19
6387	2006-04-21	"Fri"	"Evening"	"252"	2	5	2	9
6386	2006-04-21	"Fri"	"Midday"	"529"	5	2	9	16
6385	2006-04-20	"Thu"	"Evening"	"024"	0	2	4	6
6384	2006-04-20	"Thu"	"Midday"	"159"	1	5	9	15
6383	2006-04-19	"Wed"	"Evening"	"392"	3	9	2	14
6382	2006-04-19	"Wed"	"Midday"	"159"	1	5	9	15
6381	2006-04-18	"Tue"	"Evening"	"501"	5	0	1	6
6380	2006-04-18	"Tue"	"Midday"	"183"	1	8	3	12
6379	2006-04-17	"Mon"	"Evening"	"410"	4	1	0	5
6378	2006-04-17	"Mon"	"Midday"	"304"	3	0	4	7
6377	2006-04-16	"Sun"	"Evening"	"174"	1	7	4	12
6376	2006-04-16	"Sun"	"Midday"	"618"	6	1	8	15
6375	2006-04-15	"Sat"	"Evening"	"152"	1	5	2	8
6374	2006-04-15	"Sat"	"Midday"	"734"	7	3	4	14
6373	2006-04-14	"Fri"	"Evening"	"314"	3	1	4	8
6372	2006-04-14	"Fri"	"Midday"	"863"	8	6	3	17
6371	2006-04-13	"Thu"	"Evening"	"839"	8	3	9	20
6370	2006-04-13	"Thu"	"Midday"	"739"	7	3	9	19
6369	2006-04-12	"Wed"	"Evening"	"390"	3	9	0	12
6368	2006-04-12	"Wed"	"Midday"	"624"	6	2	4	12
6367	2006-04-11	"Tue"	"Evening"	"726"	7	2	6	15
6366	2006-04-11	"Tue"	"Midday"	"220"	2	2	0	4
6365	2006-04-10	"Mon"	"Evening"	"530"	5	3	0	8
6364	2006-04-10	"Mon"	"Midday"	"575"	5	7	5	17
6363	2006-04-09	"Sun"	"Evening"	"019"	0	1	9	10
6362	2006-04-09	"Sun"	"Midday"	"853"	8	5	3	16
6361	2006-04-08	"Sat"	"Evening"	"048"	0	4	8	12
6360	2006-04-08	"Sat"	"Midday"	"082"	0	8	2	10
6359	2006-04-07	"Fri"	"Evening"	"490"	4	9	0	13
6358	2006-04-07	"Fri"	"Midday"	"349"	3	4	9	16
6357	2006-04-06	"Thu"	"Evening"	"352"	3	5	2	10
6356	2006-04-06	"Thu"	"Midday"	"331"	3	3	1	7
6355	2006-04-05	"Wed"	"Evening"	"184"	1	8	4	13
6354	2006-04-05	"Wed"	"Midday"	"661"	6	6	1	13
6353	2006-04-04	"Tue"	"Evening"	"363"	3	6	3	12
6352	2006-04-04	"Tue"	"Midday"	"742"	7	4	2	13
6351	2006-04-03	"Mon"	"Evening"	"378"	3	7	8	18
6350	2006-04-03	"Mon"	"Midday"	"389"	3	8	9	20
6349	2006-04-02	"Sun"	"Evening"	"654"	6	5	4	15
6348	2006-04-02	"Sun"	"Midday"	"559"	5	5	9	19
6347	2006-04-01	"Sat"	"Evening"	"542"	5	4	2	11
6346	2006-04-01	"Sat"	"Midday"	"360"	3	6	0	9
6345	2006-03-31	"Fri"	"Evening"	"946"	9	4	6	19
6344	2006-03-31	"Fri"	"Midday"	"399"	3	9	9	21
6343	2006-03-30	"Thu"	"Evening"	"893"	8	9	3	20
6342	2006-03-30	"Thu"	"Midday"	"743"	7	4	3	14
6341	2006-03-29	"Wed"	"Evening"	"043"	0	4	3	7
6340	2006-03-29	"Wed"	"Midday"	"943"	9	4	3	16
6339	2006-03-28	"Tue"	"Evening"	"052"	0	5	2	7
6338	2006-03-28	"Tue"	"Midday"	"235"	2	3	5	10
6337	2006-03-27	"Mon"	"Evening"	"305"	3	0	5	8
6336	2006-03-27	"Mon"	"Midday"	"284"	2	8	4	14
6335	2006-03-26	"Sun"	"Evening"	"021"	0	2	1	3
6334	2006-03-26	"Sun"	"Midday"	"196"	1	9	6	16
6333	2006-03-25	"Sat"	"Evening"	"183"	1	8	3	12
6332	2006-03-25	"Sat"	"Midday"	"799"	7	9	9	25
6331	2006-03-24	"Fri"	"Evening"	"174"	1	7	4	12
6330	2006-03-24	"Fri"	"Midday"	"783"	7	8	3	18
6329	2006-03-23	"Thu"	"Evening"	"827"	8	2	7	17
6328	2006-03-23	"Thu"	"Midday"	"920"	9	2	0	11
6327	2006-03-22	"Wed"	"Evening"	"471"	4	7	1	12
6326	2006-03-22	"Wed"	"Midday"	"130"	1	3	0	4
6325	2006-03-21	"Tue"	"Evening"	"051"	0	5	1	6
6324	2006-03-21	"Tue"	"Midday"	"322"	3	2	2	7
6323	2006-03-20	"Mon"	"Evening"	"275"	2	7	5	14
6322	2006-03-20	"Mon"	"Midday"	"099"	0	9	9	18
6321	2006-03-19	"Sun"	"Evening"	"279"	2	7	9	18
6320	2006-03-19	"Sun"	"Midday"	"285"	2	8	5	15
6319	2006-03-18	"Sat"	"Evening"	"802"	8	0	2	10
6318	2006-03-18	"Sat"	"Midday"	"218"	2	1	8	11
6317	2006-03-17	"Fri"	"Evening"	"967"	9	6	7	22
6316	2006-03-17	"Fri"	"Midday"	"806"	8	0	6	14
6315	2006-03-16	"Thu"	"Evening"	"735"	7	3	5	15
6314	2006-03-16	"Thu"	"Midday"	"671"	6	7	1	14
6313	2006-03-15	"Wed"	"Evening"	"125"	1	2	5	8
6312	2006-03-15	"Wed"	"Midday"	"516"	5	1	6	12
6311	2006-03-14	"Tue"	"Evening"	"511"	5	1	1	7
6310	2006-03-14	"Tue"	"Midday"	"435"	4	3	5	12
6309	2006-03-13	"Mon"	"Evening"	"998"	9	9	8	26
6308	2006-03-13	"Mon"	"Midday"	"942"	9	4	2	15
6307	2006-03-12	"Sun"	"Evening"	"258"	2	5	8	15
6306	2006-03-12	"Sun"	"Midday"	"104"	1	0	4	5
6305	2006-03-11	"Sat"	"Evening"	"636"	6	3	6	15
6304	2006-03-11	"Sat"	"Midday"	"891"	8	9	1	18
6303	2006-03-10	"Fri"	"Evening"	"451"	4	5	1	10
6302	2006-03-10	"Fri"	"Midday"	"380"	3	8	0	11
6301	2006-03-09	"Thu"	"Evening"	"111"	1	1	1	3
6300	2006-03-09	"Thu"	"Midday"	"150"	1	5	0	6
6299	2006-03-08	"Wed"	"Evening"	"813"	8	1	3	12
6298	2006-03-08	"Wed"	"Midday"	"825"	8	2	5	15
6297	2006-03-07	"Tue"	"Evening"	"563"	5	6	3	14
6296	2006-03-07	"Tue"	"Midday"	"570"	5	7	0	12
6295	2006-03-06	"Mon"	"Evening"	"808"	8	0	8	16
6294	2006-03-06	"Mon"	"Midday"	"117"	1	1	7	9
6293	2006-03-05	"Sun"	"Evening"	"436"	4	3	6	13
6292	2006-03-05	"Sun"	"Midday"	"789"	7	8	9	24
6291	2006-03-04	"Sat"	"Evening"	"030"	0	3	0	3
6290	2006-03-04	"Sat"	"Midday"	"840"	8	4	0	12
6289	2006-03-03	"Fri"	"Evening"	"493"	4	9	3	16
6288	2006-03-03	"Fri"	"Midday"	"931"	9	3	1	13
6287	2006-03-02	"Thu"	"Evening"	"445"	4	4	5	13
6286	2006-03-02	"Thu"	"Midday"	"641"	6	4	1	11
6285	2006-03-01	"Wed"	"Evening"	"997"	9	9	7	25
6284	2006-03-01	"Wed"	"Midday"	"038"	0	3	8	11
6283	2006-02-28	"Tue"	"Evening"	"323"	3	2	3	8
6282	2006-02-28	"Tue"	"Midday"	"892"	8	9	2	19
6281	2006-02-27	"Mon"	"Evening"	"490"	4	9	0	13
6280	2006-02-27	"Mon"	"Midday"	"690"	6	9	0	15
6279	2006-02-26	"Sun"	"Evening"	"326"	3	2	6	11
6278	2006-02-26	"Sun"	"Midday"	"757"	7	5	7	19
6277	2006-02-25	"Sat"	"Evening"	"195"	1	9	5	15
6276	2006-02-25	"Sat"	"Midday"	"091"	0	9	1	10
6275	2006-02-24	"Fri"	"Evening"	"675"	6	7	5	18
6274	2006-02-24	"Fri"	"Midday"	"084"	0	8	4	12
6273	2006-02-23	"Thu"	"Evening"	"172"	1	7	2	10
6272	2006-02-23	"Thu"	"Midday"	"416"	4	1	6	11
6271	2006-02-22	"Wed"	"Evening"	"481"	4	8	1	13
6270	2006-02-22	"Wed"	"Midday"	"597"	5	9	7	21
6269	2006-02-21	"Tue"	"Evening"	"211"	2	1	1	4
6268	2006-02-21	"Tue"	"Midday"	"830"	8	3	0	11
6267	2006-02-20	"Mon"	"Evening"	"471"	4	7	1	12
6266	2006-02-20	"Mon"	"Midday"	"281"	2	8	1	11
6265	2006-02-19	"Sun"	"Evening"	"219"	2	1	9	12
6264	2006-02-19	"Sun"	"Midday"	"173"	1	7	3	11
6263	2006-02-18	"Sat"	"Evening"	"443"	4	4	3	11
6262	2006-02-18	"Sat"	"Midday"	"966"	9	6	6	21
6261	2006-02-17	"Fri"	"Evening"	"078"	0	7	8	15
6260	2006-02-17	"Fri"	"Midday"	"253"	2	5	3	10
6259	2006-02-16	"Thu"	"Evening"	"131"	1	3	1	5
6258	2006-02-16	"Thu"	"Midday"	"521"	5	2	1	8
6257	2006-02-15	"Wed"	"Evening"	"471"	4	7	1	12
6256	2006-02-15	"Wed"	"Midday"	"238"	2	3	8	13
6255	2006-02-14	"Tue"	"Evening"	"487"	4	8	7	19
6254	2006-02-14	"Tue"	"Midday"	"067"	0	6	7	13
6253	2006-02-13	"Mon"	"Evening"	"370"	3	7	0	10
6252	2006-02-13	"Mon"	"Midday"	"203"	2	0	3	5
6251	2006-02-12	"Sun"	"Evening"	"243"	2	4	3	9
6250	2006-02-12	"Sun"	"Midday"	"893"	8	9	3	20
6249	2006-02-11	"Sat"	"Evening"	"870"	8	7	0	15
6248	2006-02-11	"Sat"	"Midday"	"889"	8	8	9	25
6247	2006-02-10	"Fri"	"Evening"	"253"	2	5	3	10
6246	2006-02-10	"Fri"	"Midday"	"434"	4	3	4	11
6245	2006-02-09	"Thu"	"Evening"	"470"	4	7	0	11
6244	2006-02-09	"Thu"	"Midday"	"717"	7	1	7	15
6243	2006-02-08	"Wed"	"Evening"	"870"	8	7	0	15
6242	2006-02-08	"Wed"	"Midday"	"354"	3	5	4	12
6241	2006-02-07	"Tue"	"Evening"	"301"	3	0	1	4
6240	2006-02-07	"Tue"	"Midday"	"652"	6	5	2	13
6239	2006-02-06	"Mon"	"Evening"	"912"	9	1	2	12
6238	2006-02-06	"Mon"	"Midday"	"516"	5	1	6	12
6237	2006-02-05	"Sun"	"Evening"	"568"	5	6	8	19
6236	2006-02-05	"Sun"	"Midday"	"724"	7	2	4	13
6235	2006-02-04	"Sat"	"Evening"	"167"	1	6	7	14
6234	2006-02-04	"Sat"	"Midday"	"984"	9	8	4	21
6233	2006-02-03	"Fri"	"Evening"	"264"	2	6	4	12
6232	2006-02-03	"Fri"	"Midday"	"648"	6	4	8	18
6231	2006-02-02	"Thu"	"Evening"	"781"	7	8	1	16
6230	2006-02-02	"Thu"	"Midday"	"636"	6	3	6	15
6229	2006-02-01	"Wed"	"Evening"	"620"	6	2	0	8
6228	2006-02-01	"Wed"	"Midday"	"450"	4	5	0	9
6227	2006-01-31	"Tue"	"Evening"	"661"	6	6	1	13
6226	2006-01-31	"Tue"	"Midday"	"602"	6	0	2	8
6225	2006-01-30	"Mon"	"Evening"	"768"	7	6	8	21
6224	2006-01-30	"Mon"	"Midday"	"680"	6	8	0	14
6223	2006-01-29	"Sun"	"Evening"	"603"	6	0	3	9
6222	2006-01-29	"Sun"	"Midday"	"801"	8	0	1	9
6221	2006-01-28	"Sat"	"Evening"	"703"	7	0	3	10
6220	2006-01-28	"Sat"	"Midday"	"872"	8	7	2	17
6219	2006-01-27	"Fri"	"Evening"	"610"	6	1	0	7
6218	2006-01-27	"Fri"	"Midday"	"777"	7	7	7	21
6217	2006-01-26	"Thu"	"Evening"	"084"	0	8	4	12
6216	2006-01-26	"Thu"	"Midday"	"256"	2	5	6	13
6215	2006-01-25	"Wed"	"Evening"	"968"	9	6	8	23
6214	2006-01-25	"Wed"	"Midday"	"344"	3	4	4	11
6213	2006-01-24	"Tue"	"Evening"	"274"	2	7	4	13
6212	2006-01-24	"Tue"	"Midday"	"814"	8	1	4	13
6211	2006-01-23	"Mon"	"Evening"	"801"	8	0	1	9
6210	2006-01-23	"Mon"	"Midday"	"001"	0	0	1	1
6209	2006-01-22	"Sun"	"Evening"	"036"	0	3	6	9
6208	2006-01-22	"Sun"	"Midday"	"324"	3	2	4	9
6207	2006-01-21	"Sat"	"Evening"	"781"	7	8	1	16
6206	2006-01-21	"Sat"	"Midday"	"356"	3	5	6	14
6205	2006-01-20	"Fri"	"Evening"	"683"	6	8	3	17
6204	2006-01-20	"Fri"	"Midday"	"293"	2	9	3	14
6203	2006-01-19	"Thu"	"Evening"	"576"	5	7	6	18
6202	2006-01-19	"Thu"	"Midday"	"693"	6	9	3	18
6201	2006-01-18	"Wed"	"Evening"	"171"	1	7	1	9
6200	2006-01-18	"Wed"	"Midday"	"722"	7	2	2	11
6199	2006-01-17	"Tue"	"Evening"	"480"	4	8	0	12
6198	2006-01-17	"Tue"	"Midday"	"346"	3	4	6	13
6197	2006-01-16	"Mon"	"Evening"	"257"	2	5	7	14
6196	2006-01-16	"Mon"	"Midday"	"813"	8	1	3	12
6195	2006-01-15	"Sun"	"Evening"	"697"	6	9	7	22
6194	2006-01-15	"Sun"	"Midday"	"143"	1	4	3	8
6193	2006-01-14	"Sat"	"Evening"	"234"	2	3	4	9
6192	2006-01-14	"Sat"	"Midday"	"437"	4	3	7	14
6191	2006-01-13	"Fri"	"Evening"	"197"	1	9	7	17
6190	2006-01-13	"Fri"	"Midday"	"125"	1	2	5	8
6189	2006-01-12	"Thu"	"Evening"	"789"	7	8	9	24
6188	2006-01-12	"Thu"	"Midday"	"891"	8	9	1	18
6187	2006-01-11	"Wed"	"Evening"	"953"	9	5	3	17
6186	2006-01-11	"Wed"	"Midday"	"541"	5	4	1	10
6185	2006-01-10	"Tue"	"Evening"	"472"	4	7	2	13
6184	2006-01-10	"Tue"	"Midday"	"573"	5	7	3	15
6183	2006-01-09	"Mon"	"Evening"	"645"	6	4	5	15
6182	2006-01-09	"Mon"	"Midday"	"073"	0	7	3	10
6181	2006-01-08	"Sun"	"Evening"	"974"	9	7	4	20
6180	2006-01-08	"Sun"	"Midday"	"850"	8	5	0	13
6179	2006-01-07	"Sat"	"Evening"	"749"	7	4	9	20
6178	2006-01-07	"Sat"	"Midday"	"232"	2	3	2	7
6177	2006-01-06	"Fri"	"Evening"	"564"	5	6	4	15
6176	2006-01-06	"Fri"	"Midday"	"134"	1	3	4	8
6175	2006-01-05	"Thu"	"Evening"	"087"	0	8	7	15
6174	2006-01-05	"Thu"	"Midday"	"981"	9	8	1	18
6173	2006-01-04	"Wed"	"Evening"	"584"	5	8	4	17
6172	2006-01-04	"Wed"	"Midday"	"735"	7	3	5	15
6171	2006-01-03	"Tue"	"Evening"	"682"	6	8	2	16
6170	2006-01-03	"Tue"	"Midday"	"066"	0	6	6	12
6169	2006-01-02	"Mon"	"Evening"	"526"	5	2	6	13
6168	2006-01-02	"Mon"	"Midday"	"218"	2	1	8	11
6167	2006-01-01	"Sun"	"Evening"	"413"	4	1	3	8
6166	2006-01-01	"Sun"	"Midday"	"472"	4	7	2	13
6165	2005-12-31	"Sat"	"Evening"	"261"	2	6	1	9
6164	2005-12-31	"Sat"	"Midday"	"318"	3	1	8	12
6163	2005-12-30	"Fri"	"Evening"	"711"	7	1	1	9
6162	2005-12-30	"Fri"	"Midday"	"271"	2	7	1	10
6161	2005-12-29	"Thu"	"Evening"	"397"	3	9	7	19
6160	2005-12-29	"Thu"	"Midday"	"551"	5	5	1	11
6159	2005-12-28	"Wed"	"Evening"	"607"	6	0	7	13
6158	2005-12-28	"Wed"	"Midday"	"437"	4	3	7	14
6157	2005-12-27	"Tue"	"Evening"	"566"	5	6	6	17
6156	2005-12-27	"Tue"	"Midday"	"148"	1	4	8	13
6155	2005-12-26	"Mon"	"Evening"	"174"	1	7	4	12
6154	2005-12-26	"Mon"	"Midday"	"241"	2	4	1	7
6153	2005-12-25	"Sun"	"Evening"	"635"	6	3	5	14
6152	2005-12-25	"Sun"	"Midday"	"082"	0	8	2	10
6151	2005-12-24	"Sat"	"Evening"	"369"	3	6	9	18
6150	2005-12-24	"Sat"	"Midday"	"383"	3	8	3	14
6149	2005-12-23	"Fri"	"Evening"	"439"	4	3	9	16
6148	2005-12-23	"Fri"	"Midday"	"206"	2	0	6	8
6147	2005-12-22	"Thu"	"Evening"	"923"	9	2	3	14
6146	2005-12-22	"Thu"	"Midday"	"044"	0	4	4	8
6145	2005-12-21	"Wed"	"Evening"	"708"	7	0	8	15
6144	2005-12-21	"Wed"	"Midday"	"866"	8	6	6	20
6143	2005-12-20	"Tue"	"Evening"	"942"	9	4	2	15
6142	2005-12-20	"Tue"	"Midday"	"314"	3	1	4	8
6141	2005-12-19	"Mon"	"Evening"	"084"	0	8	4	12
6140	2005-12-19	"Mon"	"Midday"	"438"	4	3	8	15
6139	2005-12-18	"Sun"	"Evening"	"934"	9	3	4	16
6138	2005-12-18	"Sun"	"Midday"	"219"	2	1	9	12
6137	2005-12-17	"Sat"	"Evening"	"291"	2	9	1	12
6136	2005-12-17	"Sat"	"Midday"	"157"	1	5	7	13
6135	2005-12-16	"Fri"	"Evening"	"967"	9	6	7	22
6134	2005-12-16	"Fri"	"Midday"	"030"	0	3	0	3
6133	2005-12-15	"Thu"	"Evening"	"357"	3	5	7	15
6132	2005-12-15	"Thu"	"Midday"	"088"	0	8	8	16
6131	2005-12-14	"Wed"	"Evening"	"511"	5	1	1	7
6130	2005-12-14	"Wed"	"Midday"	"219"	2	1	9	12
6129	2005-12-13	"Tue"	"Evening"	"624"	6	2	4	12
6128	2005-12-13	"Tue"	"Midday"	"683"	6	8	3	17
6127	2005-12-12	"Mon"	"Evening"	"981"	9	8	1	18
6126	2005-12-12	"Mon"	"Midday"	"966"	9	6	6	21
6125	2005-12-11	"Sun"	"Evening"	"184"	1	8	4	13
6124	2005-12-11	"Sun"	"Midday"	"012"	0	1	2	3
6123	2005-12-10	"Sat"	"Evening"	"189"	1	8	9	18
6122	2005-12-10	"Sat"	"Midday"	"667"	6	6	7	19
6121	2005-12-09	"Fri"	"Evening"	"189"	1	8	9	18
6120	2005-12-09	"Fri"	"Midday"	"609"	6	0	9	15
6119	2005-12-08	"Thu"	"Evening"	"223"	2	2	3	7
6118	2005-12-08	"Thu"	"Midday"	"729"	7	2	9	18
6117	2005-12-07	"Wed"	"Evening"	"245"	2	4	5	11
6116	2005-12-07	"Wed"	"Midday"	"154"	1	5	4	10
6115	2005-12-06	"Tue"	"Evening"	"034"	0	3	4	7
6114	2005-12-06	"Tue"	"Midday"	"980"	9	8	0	17
6113	2005-12-05	"Mon"	"Evening"	"204"	2	0	4	6
6112	2005-12-05	"Mon"	"Midday"	"874"	8	7	4	19
6111	2005-12-04	"Sun"	"Evening"	"295"	2	9	5	16
6110	2005-12-04	"Sun"	"Midday"	"227"	2	2	7	11
6109	2005-12-03	"Sat"	"Evening"	"008"	0	0	8	8
6108	2005-12-03	"Sat"	"Midday"	"602"	6	0	2	8
6107	2005-12-02	"Fri"	"Evening"	"483"	4	8	3	15
6106	2005-12-02	"Fri"	"Midday"	"141"	1	4	1	6
6105	2005-12-01	"Thu"	"Evening"	"060"	0	6	0	6
6104	2005-12-01	"Thu"	"Midday"	"504"	5	0	4	9
6103	2005-11-30	"Wed"	"Evening"	"558"	5	5	8	18
6102	2005-11-30	"Wed"	"Midday"	"193"	1	9	3	13
6101	2005-11-29	"Tue"	"Evening"	"440"	4	4	0	8
6100	2005-11-29	"Tue"	"Midday"	"147"	1	4	7	12
6099	2005-11-28	"Mon"	"Evening"	"441"	4	4	1	9
6098	2005-11-28	"Mon"	"Midday"	"692"	6	9	2	17
6097	2005-11-27	"Sun"	"Evening"	"686"	6	8	6	20
6096	2005-11-27	"Sun"	"Midday"	"030"	0	3	0	3
6095	2005-11-26	"Sat"	"Evening"	"617"	6	1	7	14
6094	2005-11-26	"Sat"	"Midday"	"126"	1	2	6	9
6093	2005-11-25	"Fri"	"Evening"	"378"	3	7	8	18
6092	2005-11-25	"Fri"	"Midday"	"732"	7	3	2	12
6091	2005-11-24	"Thu"	"Evening"	"681"	6	8	1	15
6090	2005-11-24	"Thu"	"Midday"	"796"	7	9	6	22
6089	2005-11-23	"Wed"	"Evening"	"069"	0	6	9	15
6088	2005-11-23	"Wed"	"Midday"	"157"	1	5	7	13
6087	2005-11-22	"Tue"	"Evening"	"621"	6	2	1	9
6086	2005-11-22	"Tue"	"Midday"	"011"	0	1	1	2
6085	2005-11-21	"Mon"	"Evening"	"972"	9	7	2	18
6084	2005-11-21	"Mon"	"Midday"	"296"	2	9	6	17
6083	2005-11-20	"Sun"	"Evening"	"467"	4	6	7	17
6082	2005-11-20	"Sun"	"Midday"	"495"	4	9	5	18
6081	2005-11-19	"Sat"	"Evening"	"501"	5	0	1	6
6080	2005-11-19	"Sat"	"Midday"	"079"	0	7	9	16
6079	2005-11-18	"Fri"	"Evening"	"428"	4	2	8	14
6078	2005-11-18	"Fri"	"Midday"	"161"	1	6	1	8
6077	2005-11-17	"Thu"	"Evening"	"135"	1	3	5	9
6076	2005-11-17	"Thu"	"Midday"	"464"	4	6	4	14
6075	2005-11-16	"Wed"	"Evening"	"188"	1	8	8	17
6074	2005-11-16	"Wed"	"Midday"	"649"	6	4	9	19
6073	2005-11-15	"Tue"	"Evening"	"213"	2	1	3	6
6072	2005-11-15	"Tue"	"Midday"	"657"	6	5	7	18
6071	2005-11-14	"Mon"	"Evening"	"311"	3	1	1	5
6070	2005-11-14	"Mon"	"Midday"	"193"	1	9	3	13
6069	2005-11-13	"Sun"	"Evening"	"050"	0	5	0	5
6068	2005-11-13	"Sun"	"Midday"	"613"	6	1	3	10
6067	2005-11-12	"Sat"	"Evening"	"599"	5	9	9	23
6066	2005-11-12	"Sat"	"Midday"	"430"	4	3	0	7
6065	2005-11-11	"Fri"	"Evening"	"823"	8	2	3	13
6064	2005-11-11	"Fri"	"Midday"	"261"	2	6	1	9
6063	2005-11-10	"Thu"	"Evening"	"211"	2	1	1	4
6062	2005-11-10	"Thu"	"Midday"	"213"	2	1	3	6
6061	2005-11-09	"Wed"	"Evening"	"748"	7	4	8	19
6060	2005-11-09	"Wed"	"Midday"	"847"	8	4	7	19
6059	2005-11-08	"Tue"	"Evening"	"176"	1	7	6	14
6058	2005-11-08	"Tue"	"Midday"	"238"	2	3	8	13
6057	2005-11-07	"Mon"	"Evening"	"255"	2	5	5	12
6056	2005-11-07	"Mon"	"Midday"	"971"	9	7	1	17
6055	2005-11-06	"Sun"	"Evening"	"396"	3	9	6	18
6054	2005-11-06	"Sun"	"Midday"	"187"	1	8	7	16
6053	2005-11-05	"Sat"	"Evening"	"400"	4	0	0	4
6052	2005-11-05	"Sat"	"Midday"	"162"	1	6	2	9
6051	2005-11-04	"Fri"	"Evening"	"229"	2	2	9	13
6050	2005-11-04	"Fri"	"Midday"	"437"	4	3	7	14
6049	2005-11-03	"Thu"	"Evening"	"346"	3	4	6	13
6048	2005-11-03	"Thu"	"Midday"	"076"	0	7	6	13
6047	2005-11-02	"Wed"	"Evening"	"450"	4	5	0	9
6046	2005-11-02	"Wed"	"Midday"	"519"	5	1	9	15
6045	2005-11-01	"Tue"	"Evening"	"591"	5	9	1	15
6044	2005-11-01	"Tue"	"Midday"	"063"	0	6	3	9
6043	2005-10-31	"Mon"	"Evening"	"661"	6	6	1	13
6042	2005-10-31	"Mon"	"Midday"	"881"	8	8	1	17
6041	2005-10-30	"Sun"	"Evening"	"456"	4	5	6	15
6040	2005-10-30	"Sun"	"Midday"	"328"	3	2	8	13
6039	2005-10-29	"Sat"	"Evening"	"234"	2	3	4	9
6038	2005-10-29	"Sat"	"Midday"	"659"	6	5	9	20
6037	2005-10-28	"Fri"	"Evening"	"725"	7	2	5	14
6036	2005-10-28	"Fri"	"Midday"	"209"	2	0	9	11
6035	2005-10-27	"Thu"	"Evening"	"306"	3	0	6	9
6034	2005-10-27	"Thu"	"Midday"	"038"	0	3	8	11
6033	2005-10-26	"Wed"	"Evening"	"346"	3	4	6	13
6032	2005-10-26	"Wed"	"Midday"	"094"	0	9	4	13
6031	2005-10-25	"Tue"	"Evening"	"647"	6	4	7	17
6030	2005-10-25	"Tue"	"Midday"	"222"	2	2	2	6
6029	2005-10-24	"Mon"	"Evening"	"399"	3	9	9	21
6028	2005-10-24	"Mon"	"Midday"	"329"	3	2	9	14
6027	2005-10-23	"Sun"	"Evening"	"868"	8	6	8	22
6026	2005-10-23	"Sun"	"Midday"	"165"	1	6	5	12
6025	2005-10-22	"Sat"	"Evening"	"832"	8	3	2	13
6024	2005-10-22	"Sat"	"Midday"	"718"	7	1	8	16
6023	2005-10-21	"Fri"	"Evening"	"598"	5	9	8	22
6022	2005-10-21	"Fri"	"Midday"	"585"	5	8	5	18
6021	2005-10-20	"Thu"	"Evening"	"644"	6	4	4	14
6020	2005-10-20	"Thu"	"Midday"	"735"	7	3	5	15
6019	2005-10-19	"Wed"	"Evening"	"608"	6	0	8	14
6018	2005-10-19	"Wed"	"Midday"	"567"	5	6	7	18
6017	2005-10-18	"Tue"	"Evening"	"939"	9	3	9	21
6016	2005-10-18	"Tue"	"Midday"	"015"	0	1	5	6
6015	2005-10-17	"Mon"	"Evening"	"588"	5	8	8	21
6014	2005-10-17	"Mon"	"Midday"	"540"	5	4	0	9
6013	2005-10-16	"Sun"	"Evening"	"095"	0	9	5	14
6012	2005-10-16	"Sun"	"Midday"	"551"	5	5	1	11
6011	2005-10-15	"Sat"	"Evening"	"974"	9	7	4	20
6010	2005-10-15	"Sat"	"Midday"	"686"	6	8	6	20
6009	2005-10-14	"Fri"	"Evening"	"133"	1	3	3	7
6008	2005-10-14	"Fri"	"Midday"	"322"	3	2	2	7
6007	2005-10-13	"Thu"	"Evening"	"769"	7	6	9	22
6006	2005-10-13	"Thu"	"Midday"	"057"	0	5	7	12
6005	2005-10-12	"Wed"	"Evening"	"122"	1	2	2	5
6004	2005-10-12	"Wed"	"Midday"	"732"	7	3	2	12
6003	2005-10-11	"Tue"	"Evening"	"570"	5	7	0	12
6002	2005-10-11	"Tue"	"Midday"	"829"	8	2	9	19
6001	2005-10-10	"Mon"	"Evening"	"832"	8	3	2	13
6000	2005-10-10	"Mon"	"Midday"	"296"	2	9	6	17
5999	2005-10-09	"Sun"	"Evening"	"632"	6	3	2	11
5998	2005-10-09	"Sun"	"Midday"	"749"	7	4	9	20
5997	2005-10-08	"Sat"	"Evening"	"645"	6	4	5	15
5996	2005-10-08	"Sat"	"Midday"	"584"	5	8	4	17
5995	2005-10-07	"Fri"	"Evening"	"056"	0	5	6	11
5994	2005-10-07	"Fri"	"Midday"	"262"	2	6	2	10
5993	2005-10-06	"Thu"	"Evening"	"373"	3	7	3	13
5992	2005-10-06	"Thu"	"Midday"	"931"	9	3	1	13
5991	2005-10-05	"Wed"	"Evening"	"989"	9	8	9	26
5990	2005-10-05	"Wed"	"Midday"	"676"	6	7	6	19
5989	2005-10-04	"Tue"	"Evening"	"584"	5	8	4	17
5988	2005-10-04	"Tue"	"Midday"	"930"	9	3	0	12
5987	2005-10-03	"Mon"	"Evening"	"950"	9	5	0	14
5986	2005-10-03	"Mon"	"Midday"	"102"	1	0	2	3
5985	2005-10-02	"Sun"	"Evening"	"361"	3	6	1	10
5984	2005-10-02	"Sun"	"Midday"	"549"	5	4	9	18
5983	2005-10-01	"Sat"	"Evening"	"217"	2	1	7	10
5982	2005-10-01	"Sat"	"Midday"	"930"	9	3	0	12
5981	2005-09-30	"Fri"	"Evening"	"041"	0	4	1	5
5980	2005-09-30	"Fri"	"Midday"	"574"	5	7	4	16
5979	2005-09-29	"Thu"	"Evening"	"520"	5	2	0	7
5978	2005-09-29	"Thu"	"Midday"	"097"	0	9	7	16
5977	2005-09-28	"Wed"	"Evening"	"112"	1	1	2	4
5976	2005-09-28	"Wed"	"Midday"	"301"	3	0	1	4
5975	2005-09-27	"Tue"	"Evening"	"914"	9	1	4	14
5974	2005-09-27	"Tue"	"Midday"	"041"	0	4	1	5
5973	2005-09-26	"Mon"	"Evening"	"644"	6	4	4	14
5972	2005-09-26	"Mon"	"Midday"	"309"	3	0	9	12
5971	2005-09-25	"Sun"	"Evening"	"409"	4	0	9	13
5970	2005-09-25	"Sun"	"Midday"	"528"	5	2	8	15
5969	2005-09-24	"Sat"	"Evening"	"739"	7	3	9	19
5968	2005-09-24	"Sat"	"Midday"	"137"	1	3	7	11
5967	2005-09-23	"Fri"	"Evening"	"530"	5	3	0	8
5966	2005-09-23	"Fri"	"Midday"	"080"	0	8	0	8
5965	2005-09-22	"Thu"	"Evening"	"040"	0	4	0	4
5964	2005-09-22	"Thu"	"Midday"	"001"	0	0	1	1
5963	2005-09-21	"Wed"	"Evening"	"495"	4	9	5	18
5962	2005-09-21	"Wed"	"Midday"	"918"	9	1	8	18
5961	2005-09-20	"Tue"	"Evening"	"540"	5	4	0	9
5960	2005-09-20	"Tue"	"Midday"	"958"	9	5	8	22
5959	2005-09-19	"Mon"	"Evening"	"093"	0	9	3	12
5958	2005-09-19	"Mon"	"Midday"	"257"	2	5	7	14
5957	2005-09-18	"Sun"	"Evening"	"916"	9	1	6	16
5956	2005-09-18	"Sun"	"Midday"	"660"	6	6	0	12
5955	2005-09-17	"Sat"	"Evening"	"096"	0	9	6	15
5954	2005-09-17	"Sat"	"Midday"	"153"	1	5	3	9
5953	2005-09-16	"Fri"	"Evening"	"394"	3	9	4	16
5952	2005-09-16	"Fri"	"Midday"	"486"	4	8	6	18
5951	2005-09-15	"Thu"	"Evening"	"822"	8	2	2	12
5950	2005-09-15	"Thu"	"Midday"	"064"	0	6	4	10
5949	2005-09-14	"Wed"	"Evening"	"207"	2	0	7	9
5948	2005-09-14	"Wed"	"Midday"	"691"	6	9	1	16
5947	2005-09-13	"Tue"	"Evening"	"128"	1	2	8	11
5946	2005-09-13	"Tue"	"Midday"	"526"	5	2	6	13
5945	2005-09-12	"Mon"	"Evening"	"209"	2	0	9	11
5944	2005-09-12	"Mon"	"Midday"	"250"	2	5	0	7
5943	2005-09-11	"Sun"	"Evening"	"504"	5	0	4	9
5942	2005-09-11	"Sun"	"Midday"	"919"	9	1	9	19
5941	2005-09-10	"Sat"	"Evening"	"643"	6	4	3	13
5940	2005-09-10	"Sat"	"Midday"	"775"	7	7	5	19
5939	2005-09-09	"Fri"	"Evening"	"832"	8	3	2	13
5938	2005-09-09	"Fri"	"Midday"	"469"	4	6	9	19
5937	2005-09-08	"Thu"	"Evening"	"228"	2	2	8	12
5936	2005-09-08	"Thu"	"Midday"	"778"	7	7	8	22
5935	2005-09-07	"Wed"	"Evening"	"987"	9	8	7	24
5934	2005-09-07	"Wed"	"Midday"	"794"	7	9	4	20
5933	2005-09-06	"Tue"	"Evening"	"946"	9	4	6	19
5932	2005-09-06	"Tue"	"Midday"	"545"	5	4	5	14
5931	2005-09-05	"Mon"	"Evening"	"015"	0	1	5	6
5930	2005-09-05	"Mon"	"Midday"	"269"	2	6	9	17
5929	2005-09-04	"Sun"	"Evening"	"160"	1	6	0	7
5928	2005-09-04	"Sun"	"Midday"	"256"	2	5	6	13
5927	2005-09-03	"Sat"	"Evening"	"214"	2	1	4	7
5926	2005-09-03	"Sat"	"Midday"	"388"	3	8	8	19
5925	2005-09-02	"Fri"	"Evening"	"303"	3	0	3	6
5924	2005-09-02	"Fri"	"Midday"	"159"	1	5	9	15
5923	2005-09-01	"Thu"	"Evening"	"737"	7	3	7	17
5922	2005-09-01	"Thu"	"Midday"	"475"	4	7	5	16
5921	2005-08-31	"Wed"	"Evening"	"806"	8	0	6	14
5920	2005-08-31	"Wed"	"Midday"	"281"	2	8	1	11
5919	2005-08-30	"Tue"	"Evening"	"752"	7	5	2	14
5918	2005-08-30	"Tue"	"Midday"	"856"	8	5	6	19
5917	2005-08-29	"Mon"	"Evening"	"195"	1	9	5	15
5916	2005-08-29	"Mon"	"Midday"	"215"	2	1	5	8
5915	2005-08-28	"Sun"	"Evening"	"406"	4	0	6	10
5914	2005-08-28	"Sun"	"Midday"	"652"	6	5	2	13
5913	2005-08-27	"Sat"	"Evening"	"274"	2	7	4	13
5912	2005-08-27	"Sat"	"Midday"	"733"	7	3	3	13
5911	2005-08-26	"Fri"	"Evening"	"463"	4	6	3	13
5910	2005-08-26	"Fri"	"Midday"	"157"	1	5	7	13
5909	2005-08-25	"Thu"	"Evening"	"060"	0	6	0	6
5908	2005-08-25	"Thu"	"Midday"	"472"	4	7	2	13
5907	2005-08-24	"Wed"	"Evening"	"981"	9	8	1	18
5906	2005-08-24	"Wed"	"Midday"	"042"	0	4	2	6
5905	2005-08-23	"Tue"	"Evening"	"669"	6	6	9	21
5904	2005-08-23	"Tue"	"Midday"	"734"	7	3	4	14
5903	2005-08-22	"Mon"	"Evening"	"993"	9	9	3	21
5902	2005-08-22	"Mon"	"Midday"	"414"	4	1	4	9
5901	2005-08-21	"Sun"	"Evening"	"506"	5	0	6	11
5900	2005-08-21	"Sun"	"Midday"	"112"	1	1	2	4
5899	2005-08-20	"Sat"	"Evening"	"230"	2	3	0	5
5898	2005-08-20	"Sat"	"Midday"	"528"	5	2	8	15
5897	2005-08-19	"Fri"	"Evening"	"973"	9	7	3	19
5896	2005-08-19	"Fri"	"Midday"	"170"	1	7	0	8
5895	2005-08-18	"Thu"	"Evening"	"032"	0	3	2	5
5894	2005-08-18	"Thu"	"Midday"	"916"	9	1	6	16
5893	2005-08-17	"Wed"	"Evening"	"713"	7	1	3	11
5892	2005-08-17	"Wed"	"Midday"	"325"	3	2	5	10
5891	2005-08-16	"Tue"	"Evening"	"803"	8	0	3	11
5890	2005-08-16	"Tue"	"Midday"	"227"	2	2	7	11
5889	2005-08-15	"Mon"	"Evening"	"571"	5	7	1	13
5888	2005-08-15	"Mon"	"Midday"	"222"	2	2	2	6
5887	2005-08-14	"Sun"	"Evening"	"660"	6	6	0	12
5886	2005-08-14	"Sun"	"Midday"	"122"	1	2	2	5
5885	2005-08-13	"Sat"	"Evening"	"397"	3	9	7	19
5884	2005-08-13	"Sat"	"Midday"	"192"	1	9	2	12
5883	2005-08-12	"Fri"	"Evening"	"516"	5	1	6	12
5882	2005-08-12	"Fri"	"Midday"	"674"	6	7	4	17
5881	2005-08-11	"Thu"	"Evening"	"147"	1	4	7	12
5880	2005-08-11	"Thu"	"Midday"	"438"	4	3	8	15
5879	2005-08-10	"Wed"	"Evening"	"073"	0	7	3	10
5878	2005-08-10	"Wed"	"Midday"	"260"	2	6	0	8
5877	2005-08-09	"Tue"	"Evening"	"255"	2	5	5	12
5876	2005-08-09	"Tue"	"Midday"	"060"	0	6	0	6
5875	2005-08-08	"Mon"	"Evening"	"830"	8	3	0	11
5874	2005-08-08	"Mon"	"Midday"	"281"	2	8	1	11
5873	2005-08-07	"Sun"	"Evening"	"329"	3	2	9	14
5872	2005-08-07	"Sun"	"Midday"	"639"	6	3	9	18
5871	2005-08-06	"Sat"	"Evening"	"106"	1	0	6	7
5870	2005-08-06	"Sat"	"Midday"	"751"	7	5	1	13
5869	2005-08-05	"Fri"	"Evening"	"125"	1	2	5	8
5868	2005-08-05	"Fri"	"Midday"	"532"	5	3	2	10
5867	2005-08-04	"Thu"	"Evening"	"473"	4	7	3	14
5866	2005-08-04	"Thu"	"Midday"	"386"	3	8	6	17
5865	2005-08-03	"Wed"	"Evening"	"585"	5	8	5	18
5864	2005-08-03	"Wed"	"Midday"	"355"	3	5	5	13
5863	2005-08-02	"Tue"	"Evening"	"821"	8	2	1	11
5862	2005-08-02	"Tue"	"Midday"	"811"	8	1	1	10
5861	2005-08-01	"Mon"	"Evening"	"077"	0	7	7	14
5860	2005-08-01	"Mon"	"Midday"	"834"	8	3	4	15
5859	2005-07-31	"Sun"	"Evening"	"415"	4	1	5	10
5858	2005-07-31	"Sun"	"Midday"	"199"	1	9	9	19
5857	2005-07-30	"Sat"	"Evening"	"610"	6	1	0	7
5856	2005-07-30	"Sat"	"Midday"	"987"	9	8	7	24
5855	2005-07-29	"Fri"	"Evening"	"244"	2	4	4	10
5854	2005-07-29	"Fri"	"Midday"	"516"	5	1	6	12
5853	2005-07-28	"Thu"	"Evening"	"305"	3	0	5	8
5852	2005-07-28	"Thu"	"Midday"	"621"	6	2	1	9
5851	2005-07-27	"Wed"	"Evening"	"144"	1	4	4	9
5850	2005-07-27	"Wed"	"Midday"	"823"	8	2	3	13
5849	2005-07-26	"Tue"	"Evening"	"861"	8	6	1	15
5848	2005-07-26	"Tue"	"Midday"	"366"	3	6	6	15
5847	2005-07-25	"Mon"	"Evening"	"175"	1	7	5	13
5846	2005-07-25	"Mon"	"Midday"	"853"	8	5	3	16
5845	2005-07-24	"Sun"	"Evening"	"811"	8	1	1	10
5844	2005-07-24	"Sun"	"Midday"	"606"	6	0	6	12
5843	2005-07-23	"Sat"	"Evening"	"902"	9	0	2	11
5842	2005-07-23	"Sat"	"Midday"	"911"	9	1	1	11
5841	2005-07-22	"Fri"	"Evening"	"293"	2	9	3	14
5840	2005-07-22	"Fri"	"Midday"	"134"	1	3	4	8
5839	2005-07-21	"Thu"	"Evening"	"509"	5	0	9	14
5838	2005-07-21	"Thu"	"Midday"	"439"	4	3	9	16
5837	2005-07-20	"Wed"	"Evening"	"411"	4	1	1	6
5836	2005-07-20	"Wed"	"Midday"	"124"	1	2	4	7
5835	2005-07-19	"Tue"	"Evening"	"670"	6	7	0	13
5834	2005-07-19	"Tue"	"Midday"	"495"	4	9	5	18
5833	2005-07-18	"Mon"	"Evening"	"839"	8	3	9	20
5832	2005-07-18	"Mon"	"Midday"	"877"	8	7	7	22
5831	2005-07-17	"Sun"	"Evening"	"473"	4	7	3	14
5830	2005-07-17	"Sun"	"Midday"	"796"	7	9	6	22
5829	2005-07-16	"Sat"	"Evening"	"411"	4	1	1	6
5828	2005-07-16	"Sat"	"Midday"	"384"	3	8	4	15
5827	2005-07-15	"Fri"	"Evening"	"068"	0	6	8	14
5826	2005-07-15	"Fri"	"Midday"	"134"	1	3	4	8
5825	2005-07-14	"Thu"	"Evening"	"900"	9	0	0	9
5824	2005-07-14	"Thu"	"Midday"	"058"	0	5	8	13
5823	2005-07-13	"Wed"	"Evening"	"969"	9	6	9	24
5822	2005-07-13	"Wed"	"Midday"	"046"	0	4	6	10
5821	2005-07-12	"Tue"	"Evening"	"695"	6	9	5	20
5820	2005-07-12	"Tue"	"Midday"	"695"	6	9	5	20
5819	2005-07-11	"Mon"	"Evening"	"547"	5	4	7	16
5818	2005-07-11	"Mon"	"Midday"	"211"	2	1	1	4
5817	2005-07-10	"Sun"	"Evening"	"475"	4	7	5	16
5816	2005-07-10	"Sun"	"Midday"	"536"	5	3	6	14
5815	2005-07-09	"Sat"	"Evening"	"873"	8	7	3	18
5814	2005-07-09	"Sat"	"Midday"	"412"	4	1	2	7
5813	2005-07-08	"Fri"	"Evening"	"655"	6	5	5	16
5812	2005-07-08	"Fri"	"Midday"	"417"	4	1	7	12
5811	2005-07-07	"Thu"	"Evening"	"965"	9	6	5	20
5810	2005-07-07	"Thu"	"Midday"	"261"	2	6	1	9
5809	2005-07-06	"Wed"	"Evening"	"701"	7	0	1	8
5808	2005-07-06	"Wed"	"Midday"	"463"	4	6	3	13
5807	2005-07-05	"Tue"	"Evening"	"434"	4	3	4	11
5806	2005-07-05	"Tue"	"Midday"	"505"	5	0	5	10
5805	2005-07-04	"Mon"	"Evening"	"473"	4	7	3	14
5804	2005-07-04	"Mon"	"Midday"	"026"	0	2	6	8
5803	2005-07-03	"Sun"	"Evening"	"492"	4	9	2	15
5802	2005-07-03	"Sun"	"Midday"	"106"	1	0	6	7
5801	2005-07-02	"Sat"	"Evening"	"871"	8	7	1	16
5800	2005-07-02	"Sat"	"Midday"	"672"	6	7	2	15
5799	2005-07-01	"Fri"	"Evening"	"680"	6	8	0	14
5798	2005-07-01	"Fri"	"Midday"	"640"	6	4	0	10
5797	2005-06-30	"Thu"	"Evening"	"242"	2	4	2	8
5796	2005-06-30	"Thu"	"Midday"	"071"	0	7	1	8
5795	2005-06-29	"Wed"	"Evening"	"092"	0	9	2	11
5794	2005-06-29	"Wed"	"Midday"	"218"	2	1	8	11
5793	2005-06-28	"Tue"	"Evening"	"275"	2	7	5	14
5792	2005-06-28	"Tue"	"Midday"	"059"	0	5	9	14
5791	2005-06-27	"Mon"	"Evening"	"637"	6	3	7	16
5790	2005-06-27	"Mon"	"Midday"	"716"	7	1	6	14
5789	2005-06-26	"Sun"	"Evening"	"017"	0	1	7	8
5788	2005-06-26	"Sun"	"Midday"	"123"	1	2	3	6
5787	2005-06-25	"Sat"	"Evening"	"871"	8	7	1	16
5786	2005-06-25	"Sat"	"Midday"	"670"	6	7	0	13
5785	2005-06-24	"Fri"	"Evening"	"638"	6	3	8	17
5784	2005-06-24	"Fri"	"Midday"	"941"	9	4	1	14
5783	2005-06-23	"Thu"	"Evening"	"039"	0	3	9	12
5782	2005-06-23	"Thu"	"Midday"	"642"	6	4	2	12
5781	2005-06-22	"Wed"	"Evening"	"607"	6	0	7	13
5780	2005-06-22	"Wed"	"Midday"	"585"	5	8	5	18
5779	2005-06-21	"Tue"	"Evening"	"220"	2	2	0	4
5778	2005-06-21	"Tue"	"Midday"	"244"	2	4	4	10
5777	2005-06-20	"Mon"	"Evening"	"750"	7	5	0	12
5776	2005-06-20	"Mon"	"Midday"	"594"	5	9	4	18
5775	2005-06-19	"Sun"	"Evening"	"008"	0	0	8	8
5774	2005-06-19	"Sun"	"Midday"	"023"	0	2	3	5
5773	2005-06-18	"Sat"	"Evening"	"840"	8	4	0	12
5772	2005-06-18	"Sat"	"Midday"	"182"	1	8	2	11
5771	2005-06-17	"Fri"	"Evening"	"298"	2	9	8	19
5770	2005-06-17	"Fri"	"Midday"	"230"	2	3	0	5
5769	2005-06-16	"Thu"	"Evening"	"101"	1	0	1	2
5768	2005-06-16	"Thu"	"Midday"	"684"	6	8	4	18
5767	2005-06-15	"Wed"	"Evening"	"839"	8	3	9	20
5766	2005-06-15	"Wed"	"Midday"	"370"	3	7	0	10
5765	2005-06-14	"Tue"	"Evening"	"380"	3	8	0	11
5764	2005-06-14	"Tue"	"Midday"	"106"	1	0	6	7
5763	2005-06-13	"Mon"	"Evening"	"090"	0	9	0	9
5762	2005-06-13	"Mon"	"Midday"	"194"	1	9	4	14
5761	2005-06-12	"Sun"	"Evening"	"279"	2	7	9	18
5760	2005-06-12	"Sun"	"Midday"	"977"	9	7	7	23
5759	2005-06-11	"Sat"	"Evening"	"804"	8	0	4	12
5758	2005-06-11	"Sat"	"Midday"	"279"	2	7	9	18
5757	2005-06-10	"Fri"	"Evening"	"461"	4	6	1	11
5756	2005-06-10	"Fri"	"Midday"	"594"	5	9	4	18
5755	2005-06-09	"Thu"	"Evening"	"872"	8	7	2	17
5754	2005-06-09	"Thu"	"Midday"	"192"	1	9	2	12
5753	2005-06-08	"Wed"	"Evening"	"351"	3	5	1	9
5752	2005-06-08	"Wed"	"Midday"	"598"	5	9	8	22
5751	2005-06-07	"Tue"	"Evening"	"906"	9	0	6	15
5750	2005-06-07	"Tue"	"Midday"	"306"	3	0	6	9
5749	2005-06-06	"Mon"	"Evening"	"576"	5	7	6	18
5748	2005-06-06	"Mon"	"Midday"	"788"	7	8	8	23
5747	2005-06-05	"Sun"	"Evening"	"063"	0	6	3	9
5746	2005-06-05	"Sun"	"Midday"	"531"	5	3	1	9
5745	2005-06-04	"Sat"	"Evening"	"782"	7	8	2	17
5744	2005-06-04	"Sat"	"Midday"	"101"	1	0	1	2
5743	2005-06-03	"Fri"	"Evening"	"984"	9	8	4	21
5742	2005-06-03	"Fri"	"Midday"	"231"	2	3	1	6
5741	2005-06-02	"Thu"	"Evening"	"543"	5	4	3	12
5740	2005-06-02	"Thu"	"Midday"	"508"	5	0	8	13
5739	2005-06-01	"Wed"	"Evening"	"778"	7	7	8	22
5738	2005-06-01	"Wed"	"Midday"	"767"	7	6	7	20
5737	2005-05-31	"Tue"	"Evening"	"628"	6	2	8	16
5736	2005-05-31	"Tue"	"Midday"	"681"	6	8	1	15
5735	2005-05-30	"Mon"	"Evening"	"813"	8	1	3	12
5734	2005-05-30	"Mon"	"Midday"	"916"	9	1	6	16
5733	2005-05-29	"Sun"	"Evening"	"646"	6	4	6	16
5732	2005-05-29	"Sun"	"Midday"	"174"	1	7	4	12
5731	2005-05-28	"Sat"	"Evening"	"885"	8	8	5	21
5730	2005-05-28	"Sat"	"Midday"	"717"	7	1	7	15
5729	2005-05-27	"Fri"	"Evening"	"542"	5	4	2	11
5728	2005-05-27	"Fri"	"Midday"	"313"	3	1	3	7
5727	2005-05-26	"Thu"	"Evening"	"308"	3	0	8	11
5726	2005-05-26	"Thu"	"Midday"	"846"	8	4	6	18
5725	2005-05-25	"Wed"	"Evening"	"065"	0	6	5	11
5724	2005-05-25	"Wed"	"Midday"	"857"	8	5	7	20
5723	2005-05-24	"Tue"	"Evening"	"084"	0	8	4	12
5722	2005-05-24	"Tue"	"Midday"	"596"	5	9	6	20
5721	2005-05-23	"Mon"	"Evening"	"646"	6	4	6	16
5720	2005-05-23	"Mon"	"Midday"	"876"	8	7	6	21
5719	2005-05-22	"Sun"	"Evening"	"116"	1	1	6	8
5718	2005-05-22	"Sun"	"Midday"	"271"	2	7	1	10
5717	2005-05-21	"Sat"	"Evening"	"501"	5	0	1	6
5716	2005-05-21	"Sat"	"Midday"	"099"	0	9	9	18
5715	2005-05-20	"Fri"	"Evening"	"914"	9	1	4	14
5714	2005-05-20	"Fri"	"Midday"	"273"	2	7	3	12
5713	2005-05-19	"Thu"	"Evening"	"073"	0	7	3	10
5712	2005-05-19	"Thu"	"Midday"	"959"	9	5	9	23
5711	2005-05-18	"Wed"	"Evening"	"845"	8	4	5	17
5710	2005-05-18	"Wed"	"Midday"	"372"	3	7	2	12
5709	2005-05-17	"Tue"	"Evening"	"289"	2	8	9	19
5708	2005-05-17	"Tue"	"Midday"	"674"	6	7	4	17
5707	2005-05-16	"Mon"	"Evening"	"055"	0	5	5	10
5706	2005-05-16	"Mon"	"Midday"	"633"	6	3	3	12
5705	2005-05-15	"Sun"	"Evening"	"229"	2	2	9	13
5704	2005-05-15	"Sun"	"Midday"	"947"	9	4	7	20
5703	2005-05-14	"Sat"	"Evening"	"453"	4	5	3	12
5702	2005-05-14	"Sat"	"Midday"	"392"	3	9	2	14
5701	2005-05-13	"Fri"	"Evening"	"397"	3	9	7	19
5700	2005-05-13	"Fri"	"Midday"	"830"	8	3	0	11
5699	2005-05-12	"Thu"	"Evening"	"122"	1	2	2	5
5698	2005-05-12	"Thu"	"Midday"	"036"	0	3	6	9
5697	2005-05-11	"Wed"	"Evening"	"893"	8	9	3	20
5696	2005-05-11	"Wed"	"Midday"	"779"	7	7	9	23
5695	2005-05-10	"Tue"	"Evening"	"734"	7	3	4	14
5694	2005-05-10	"Tue"	"Midday"	"080"	0	8	0	8
5693	2005-05-09	"Mon"	"Evening"	"448"	4	4	8	16
5692	2005-05-09	"Mon"	"Midday"	"274"	2	7	4	13
5691	2005-05-08	"Sun"	"Evening"	"676"	6	7	6	19
5690	2005-05-08	"Sun"	"Midday"	"091"	0	9	1	10
5689	2005-05-07	"Sat"	"Evening"	"211"	2	1	1	4
5688	2005-05-07	"Sat"	"Midday"	"273"	2	7	3	12
5687	2005-05-06	"Fri"	"Evening"	"655"	6	5	5	16
5686	2005-05-06	"Fri"	"Midday"	"184"	1	8	4	13
5685	2005-05-05	"Thu"	"Evening"	"072"	0	7	2	9
5684	2005-05-05	"Thu"	"Midday"	"813"	8	1	3	12
5683	2005-05-04	"Wed"	"Evening"	"775"	7	7	5	19
5682	2005-05-04	"Wed"	"Midday"	"846"	8	4	6	18
5681	2005-05-03	"Tue"	"Evening"	"979"	9	7	9	25
5680	2005-05-03	"Tue"	"Midday"	"406"	4	0	6	10
5679	2005-05-02	"Mon"	"Evening"	"123"	1	2	3	6
5678	2005-05-02	"Mon"	"Midday"	"977"	9	7	7	23
5677	2005-05-01	"Sun"	"Evening"	"669"	6	6	9	21
5676	2005-05-01	"Sun"	"Midday"	"735"	7	3	5	15
5675	2005-04-30	"Sat"	"Evening"	"380"	3	8	0	11
5674	2005-04-30	"Sat"	"Midday"	"925"	9	2	5	16
5673	2005-04-29	"Fri"	"Evening"	"560"	5	6	0	11
5672	2005-04-29	"Fri"	"Midday"	"105"	1	0	5	6
5671	2005-04-28	"Thu"	"Evening"	"702"	7	0	2	9
5670	2005-04-28	"Thu"	"Midday"	"020"	0	2	0	2
5669	2005-04-27	"Wed"	"Evening"	"634"	6	3	4	13
5668	2005-04-27	"Wed"	"Midday"	"413"	4	1	3	8
5667	2005-04-26	"Tue"	"Evening"	"168"	1	6	8	15
5666	2005-04-26	"Tue"	"Midday"	"722"	7	2	2	11
5665	2005-04-25	"Mon"	"Evening"	"832"	8	3	2	13
5664	2005-04-25	"Mon"	"Midday"	"987"	9	8	7	24
5663	2005-04-24	"Sun"	"Evening"	"471"	4	7	1	12
5662	2005-04-24	"Sun"	"Midday"	"317"	3	1	7	11
5661	2005-04-23	"Sat"	"Evening"	"133"	1	3	3	7
5660	2005-04-23	"Sat"	"Midday"	"883"	8	8	3	19
5659	2005-04-22	"Fri"	"Evening"	"897"	8	9	7	24
5658	2005-04-22	"Fri"	"Midday"	"783"	7	8	3	18
5657	2005-04-21	"Thu"	"Evening"	"606"	6	0	6	12
5656	2005-04-21	"Thu"	"Midday"	"776"	7	7	6	20
5655	2005-04-20	"Wed"	"Evening"	"797"	7	9	7	23
5654	2005-04-20	"Wed"	"Midday"	"211"	2	1	1	4
5653	2005-04-19	"Tue"	"Evening"	"818"	8	1	8	17
5652	2005-04-19	"Tue"	"Midday"	"390"	3	9	0	12
5651	2005-04-18	"Mon"	"Evening"	"693"	6	9	3	18
5650	2005-04-18	"Mon"	"Midday"	"019"	0	1	9	10
5649	2005-04-17	"Sun"	"Evening"	"410"	4	1	0	5
5648	2005-04-17	"Sun"	"Midday"	"025"	0	2	5	7
5647	2005-04-16	"Sat"	"Evening"	"162"	1	6	2	9
5646	2005-04-16	"Sat"	"Midday"	"489"	4	8	9	21
5645	2005-04-15	"Fri"	"Evening"	"225"	2	2	5	9
5644	2005-04-15	"Fri"	"Midday"	"580"	5	8	0	13
5643	2005-04-14	"Thu"	"Evening"	"640"	6	4	0	10
5642	2005-04-14	"Thu"	"Midday"	"373"	3	7	3	13
5641	2005-04-13	"Wed"	"Evening"	"205"	2	0	5	7
5640	2005-04-13	"Wed"	"Midday"	"922"	9	2	2	13
5639	2005-04-12	"Tue"	"Evening"	"827"	8	2	7	17
5638	2005-04-12	"Tue"	"Midday"	"787"	7	8	7	22
5637	2005-04-11	"Mon"	"Evening"	"014"	0	1	4	5
5636	2005-04-11	"Mon"	"Midday"	"479"	4	7	9	20
5635	2005-04-10	"Sun"	"Evening"	"212"	2	1	2	5
5634	2005-04-10	"Sun"	"Midday"	"158"	1	5	8	14
5633	2005-04-09	"Sat"	"Evening"	"259"	2	5	9	16
5632	2005-04-09	"Sat"	"Midday"	"402"	4	0	2	6
5631	2005-04-08	"Fri"	"Evening"	"483"	4	8	3	15
5630	2005-04-08	"Fri"	"Midday"	"823"	8	2	3	13
5629	2005-04-07	"Thu"	"Evening"	"598"	5	9	8	22
5628	2005-04-07	"Thu"	"Midday"	"879"	8	7	9	24
5627	2005-04-06	"Wed"	"Evening"	"065"	0	6	5	11
5626	2005-04-06	"Wed"	"Midday"	"462"	4	6	2	12
5625	2005-04-05	"Tue"	"Evening"	"768"	7	6	8	21
5624	2005-04-05	"Tue"	"Midday"	"789"	7	8	9	24
5623	2005-04-04	"Mon"	"Evening"	"001"	0	0	1	1
5622	2005-04-04	"Mon"	"Midday"	"555"	5	5	5	15
5621	2005-04-03	"Sun"	"Evening"	"913"	9	1	3	13
5620	2005-04-03	"Sun"	"Midday"	"898"	8	9	8	25
5619	2005-04-02	"Sat"	"Evening"	"957"	9	5	7	21
5618	2005-04-02	"Sat"	"Midday"	"498"	4	9	8	21
5617	2005-04-01	"Fri"	"Evening"	"440"	4	4	0	8
5616	2005-04-01	"Fri"	"Midday"	"375"	3	7	5	15
5615	2005-03-31	"Thu"	"Evening"	"882"	8	8	2	18
5614	2005-03-31	"Thu"	"Midday"	"076"	0	7	6	13
5613	2005-03-30	"Wed"	"Evening"	"767"	7	6	7	20
5612	2005-03-30	"Wed"	"Midday"	"327"	3	2	7	12
5611	2005-03-29	"Tue"	"Evening"	"872"	8	7	2	17
5610	2005-03-29	"Tue"	"Midday"	"261"	2	6	1	9
5609	2005-03-28	"Mon"	"Evening"	"597"	5	9	7	21
5608	2005-03-28	"Mon"	"Midday"	"051"	0	5	1	6
5607	2005-03-27	"Sun"	"Evening"	"525"	5	2	5	12
5606	2005-03-27	"Sun"	"Midday"	"514"	5	1	4	10
5605	2005-03-26	"Sat"	"Evening"	"859"	8	5	9	22
5604	2005-03-26	"Sat"	"Midday"	"530"	5	3	0	8
5603	2005-03-25	"Fri"	"Evening"	"296"	2	9	6	17
5602	2005-03-25	"Fri"	"Midday"	"389"	3	8	9	20
5601	2005-03-24	"Thu"	"Evening"	"051"	0	5	1	6
5600	2005-03-24	"Thu"	"Midday"	"939"	9	3	9	21
5599	2005-03-23	"Wed"	"Evening"	"425"	4	2	5	11
5598	2005-03-23	"Wed"	"Midday"	"926"	9	2	6	17
5597	2005-03-22	"Tue"	"Evening"	"433"	4	3	3	10
5596	2005-03-22	"Tue"	"Midday"	"510"	5	1	0	6
5595	2005-03-21	"Mon"	"Evening"	"351"	3	5	1	9
5594	2005-03-21	"Mon"	"Midday"	"721"	7	2	1	10
5593	2005-03-20	"Sun"	"Evening"	"536"	5	3	6	14
5592	2005-03-20	"Sun"	"Midday"	"987"	9	8	7	24
5591	2005-03-19	"Sat"	"Evening"	"876"	8	7	6	21
5590	2005-03-19	"Sat"	"Midday"	"155"	1	5	5	11
5589	2005-03-18	"Fri"	"Evening"	"032"	0	3	2	5
5588	2005-03-18	"Fri"	"Midday"	"750"	7	5	0	12
5587	2005-03-17	"Thu"	"Evening"	"983"	9	8	3	20
5586	2005-03-17	"Thu"	"Midday"	"497"	4	9	7	20
5585	2005-03-16	"Wed"	"Evening"	"918"	9	1	8	18
5584	2005-03-16	"Wed"	"Midday"	"479"	4	7	9	20
5583	2005-03-15	"Tue"	"Evening"	"832"	8	3	2	13
5582	2005-03-15	"Tue"	"Midday"	"317"	3	1	7	11
5581	2005-03-14	"Mon"	"Evening"	"675"	6	7	5	18
5580	2005-03-14	"Mon"	"Midday"	"402"	4	0	2	6
5579	2005-03-13	"Sun"	"Evening"	"272"	2	7	2	11
5578	2005-03-13	"Sun"	"Midday"	"237"	2	3	7	12
5577	2005-03-12	"Sat"	"Evening"	"189"	1	8	9	18
5576	2005-03-12	"Sat"	"Midday"	"218"	2	1	8	11
5575	2005-03-11	"Fri"	"Evening"	"482"	4	8	2	14
5574	2005-03-11	"Fri"	"Midday"	"908"	9	0	8	17
5573	2005-03-10	"Thu"	"Evening"	"058"	0	5	8	13
5572	2005-03-10	"Thu"	"Midday"	"112"	1	1	2	4
5571	2005-03-09	"Wed"	"Evening"	"243"	2	4	3	9
5570	2005-03-09	"Wed"	"Midday"	"862"	8	6	2	16
5569	2005-03-08	"Tue"	"Evening"	"271"	2	7	1	10
5568	2005-03-08	"Tue"	"Midday"	"846"	8	4	6	18
5567	2005-03-07	"Mon"	"Evening"	"397"	3	9	7	19
5566	2005-03-07	"Mon"	"Midday"	"778"	7	7	8	22
5565	2005-03-06	"Sun"	"Evening"	"369"	3	6	9	18
5564	2005-03-06	"Sun"	"Midday"	"018"	0	1	8	9
5563	2005-03-05	"Sat"	"Evening"	"431"	4	3	1	8
5562	2005-03-05	"Sat"	"Midday"	"574"	5	7	4	16
5561	2005-03-04	"Fri"	"Evening"	"851"	8	5	1	14
5560	2005-03-04	"Fri"	"Midday"	"966"	9	6	6	21
5559	2005-03-03	"Thu"	"Evening"	"808"	8	0	8	16
5558	2005-03-03	"Thu"	"Midday"	"193"	1	9	3	13
5557	2005-03-02	"Wed"	"Evening"	"031"	0	3	1	4
5556	2005-03-02	"Wed"	"Midday"	"232"	2	3	2	7
5555	2005-03-01	"Tue"	"Evening"	"290"	2	9	0	11
5554	2005-03-01	"Tue"	"Midday"	"130"	1	3	0	4
5553	2005-02-28	"Mon"	"Evening"	"263"	2	6	3	11
5552	2005-02-28	"Mon"	"Midday"	"957"	9	5	7	21
5551	2005-02-27	"Sun"	"Evening"	"037"	0	3	7	10
5550	2005-02-27	"Sun"	"Midday"	"675"	6	7	5	18
5549	2005-02-26	"Sat"	"Evening"	"509"	5	0	9	14
5548	2005-02-26	"Sat"	"Midday"	"745"	7	4	5	16
5547	2005-02-25	"Fri"	"Evening"	"163"	1	6	3	10
5546	2005-02-25	"Fri"	"Midday"	"088"	0	8	8	16
5545	2005-02-24	"Thu"	"Evening"	"562"	5	6	2	13
5544	2005-02-24	"Thu"	"Midday"	"503"	5	0	3	8
5543	2005-02-23	"Wed"	"Evening"	"359"	3	5	9	17
5542	2005-02-23	"Wed"	"Midday"	"686"	6	8	6	20
5541	2005-02-22	"Tue"	"Evening"	"952"	9	5	2	16
5540	2005-02-22	"Tue"	"Midday"	"693"	6	9	3	18
5539	2005-02-21	"Mon"	"Evening"	"582"	5	8	2	15
5538	2005-02-21	"Mon"	"Midday"	"937"	9	3	7	19
5537	2005-02-20	"Sun"	"Evening"	"540"	5	4	0	9
5536	2005-02-20	"Sun"	"Midday"	"121"	1	2	1	4
5535	2005-02-19	"Sat"	"Evening"	"851"	8	5	1	14
5534	2005-02-19	"Sat"	"Midday"	"397"	3	9	7	19
5533	2005-02-18	"Fri"	"Evening"	"858"	8	5	8	21
5532	2005-02-18	"Fri"	"Midday"	"922"	9	2	2	13
5531	2005-02-17	"Thu"	"Evening"	"798"	7	9	8	24
5530	2005-02-17	"Thu"	"Midday"	"048"	0	4	8	12
5529	2005-02-16	"Wed"	"Evening"	"828"	8	2	8	18
5528	2005-02-16	"Wed"	"Midday"	"561"	5	6	1	12
5527	2005-02-15	"Tue"	"Evening"	"387"	3	8	7	18
5526	2005-02-15	"Tue"	"Midday"	"045"	0	4	5	9
5525	2005-02-14	"Mon"	"Evening"	"207"	2	0	7	9
5524	2005-02-14	"Mon"	"Midday"	"175"	1	7	5	13
5523	2005-02-13	"Sun"	"Evening"	"473"	4	7	3	14
5522	2005-02-13	"Sun"	"Midday"	"443"	4	4	3	11
5521	2005-02-12	"Sat"	"Evening"	"303"	3	0	3	6
5520	2005-02-12	"Sat"	"Midday"	"058"	0	5	8	13
5519	2005-02-11	"Fri"	"Evening"	"043"	0	4	3	7
5518	2005-02-11	"Fri"	"Midday"	"728"	7	2	8	17
5517	2005-02-10	"Thu"	"Evening"	"604"	6	0	4	10
5516	2005-02-10	"Thu"	"Midday"	"605"	6	0	5	11
5515	2005-02-09	"Wed"	"Evening"	"674"	6	7	4	17
5514	2005-02-09	"Wed"	"Midday"	"775"	7	7	5	19
5513	2005-02-08	"Tue"	"Evening"	"958"	9	5	8	22
5512	2005-02-08	"Tue"	"Midday"	"300"	3	0	0	3
5511	2005-02-07	"Mon"	"Evening"	"707"	7	0	7	14
5510	2005-02-07	"Mon"	"Midday"	"976"	9	7	6	22
5509	2005-02-06	"Sun"	"Evening"	"548"	5	4	8	17
5508	2005-02-06	"Sun"	"Midday"	"775"	7	7	5	19
5507	2005-02-05	"Sat"	"Evening"	"889"	8	8	9	25
5506	2005-02-05	"Sat"	"Midday"	"562"	5	6	2	13
5505	2005-02-04	"Fri"	"Evening"	"618"	6	1	8	15
5504	2005-02-04	"Fri"	"Midday"	"737"	7	3	7	17
5503	2005-02-03	"Thu"	"Evening"	"087"	0	8	7	15
5502	2005-02-03	"Thu"	"Midday"	"482"	4	8	2	14
5501	2005-02-02	"Wed"	"Evening"	"256"	2	5	6	13
5500	2005-02-02	"Wed"	"Midday"	"804"	8	0	4	12
5499	2005-02-01	"Tue"	"Evening"	"688"	6	8	8	22
5498	2005-02-01	"Tue"	"Midday"	"589"	5	8	9	22
5497	2005-01-31	"Mon"	"Evening"	"655"	6	5	5	16
5496	2005-01-31	"Mon"	"Midday"	"346"	3	4	6	13
5495	2005-01-30	"Sun"	"Evening"	"163"	1	6	3	10
5494	2005-01-30	"Sun"	"Midday"	"811"	8	1	1	10
5493	2005-01-29	"Sat"	"Evening"	"402"	4	0	2	6
5492	2005-01-29	"Sat"	"Midday"	"797"	7	9	7	23
5491	2005-01-28	"Fri"	"Evening"	"213"	2	1	3	6
5490	2005-01-28	"Fri"	"Midday"	"791"	7	9	1	17
5489	2005-01-27	"Thu"	"Evening"	"206"	2	0	6	8
5488	2005-01-27	"Thu"	"Midday"	"687"	6	8	7	21
5487	2005-01-26	"Wed"	"Evening"	"437"	4	3	7	14
5486	2005-01-26	"Wed"	"Midday"	"170"	1	7	0	8
5485	2005-01-25	"Tue"	"Evening"	"978"	9	7	8	24
5484	2005-01-25	"Tue"	"Midday"	"075"	0	7	5	12
5483	2005-01-24	"Mon"	"Evening"	"320"	3	2	0	5
5482	2005-01-24	"Mon"	"Midday"	"797"	7	9	7	23
5481	2005-01-23	"Sun"	"Evening"	"885"	8	8	5	21
5480	2005-01-23	"Sun"	"Midday"	"988"	9	8	8	25
5479	2005-01-22	"Sat"	"Evening"	"435"	4	3	5	12
5478	2005-01-22	"Sat"	"Midday"	"206"	2	0	6	8
5477	2005-01-21	"Fri"	"Evening"	"546"	5	4	6	15
5476	2005-01-21	"Fri"	"Midday"	"815"	8	1	5	14
5475	2005-01-20	"Thu"	"Evening"	"104"	1	0	4	5
5474	2005-01-20	"Thu"	"Midday"	"445"	4	4	5	13
5473	2005-01-19	"Wed"	"Evening"	"590"	5	9	0	14
5472	2005-01-19	"Wed"	"Midday"	"284"	2	8	4	14
5471	2005-01-18	"Tue"	"Evening"	"080"	0	8	0	8
5470	2005-01-18	"Tue"	"Midday"	"343"	3	4	3	10
5469	2005-01-17	"Mon"	"Evening"	"060"	0	6	0	6
5468	2005-01-17	"Mon"	"Midday"	"805"	8	0	5	13
5467	2005-01-16	"Sun"	"Evening"	"761"	7	6	1	14
5466	2005-01-16	"Sun"	"Midday"	"679"	6	7	9	22
5465	2005-01-15	"Sat"	"Evening"	"035"	0	3	5	8
5464	2005-01-15	"Sat"	"Midday"	"483"	4	8	3	15
5463	2005-01-14	"Fri"	"Evening"	"814"	8	1	4	13
5462	2005-01-14	"Fri"	"Midday"	"447"	4	4	7	15
5461	2005-01-13	"Thu"	"Evening"	"584"	5	8	4	17
5460	2005-01-13	"Thu"	"Midday"	"520"	5	2	0	7
5459	2005-01-12	"Wed"	"Evening"	"354"	3	5	4	12
5458	2005-01-12	"Wed"	"Midday"	"515"	5	1	5	11
5457	2005-01-11	"Tue"	"Evening"	"392"	3	9	2	14
5456	2005-01-11	"Tue"	"Midday"	"798"	7	9	8	24
5455	2005-01-10	"Mon"	"Evening"	"386"	3	8	6	17
5454	2005-01-10	"Mon"	"Midday"	"435"	4	3	5	12
5453	2005-01-09	"Sun"	"Evening"	"564"	5	6	4	15
5452	2005-01-09	"Sun"	"Midday"	"969"	9	6	9	24
5451	2005-01-08	"Sat"	"Evening"	"857"	8	5	7	20
5450	2005-01-08	"Sat"	"Midday"	"052"	0	5	2	7
5449	2005-01-07	"Fri"	"Evening"	"790"	7	9	0	16
5448	2005-01-07	"Fri"	"Midday"	"471"	4	7	1	12
5447	2005-01-06	"Thu"	"Evening"	"999"	9	9	9	27
5446	2005-01-06	"Thu"	"Midday"	"766"	7	6	6	19
5445	2005-01-05	"Wed"	"Evening"	"922"	9	2	2	13
5444	2005-01-05	"Wed"	"Midday"	"526"	5	2	6	13
5443	2005-01-04	"Tue"	"Evening"	"122"	1	2	2	5
5442	2005-01-04	"Tue"	"Midday"	"367"	3	6	7	16
5441	2005-01-03	"Mon"	"Evening"	"654"	6	5	4	15
5440	2005-01-03	"Mon"	"Midday"	"605"	6	0	5	11
5439	2005-01-02	"Sun"	"Evening"	"851"	8	5	1	14
5438	2005-01-02	"Sun"	"Midday"	"013"	0	1	3	4
5437	2005-01-01	"Sat"	"Evening"	"823"	8	2	3	13
5436	2005-01-01	"Sat"	"Midday"	"332"	3	3	2	8
5435	2004-12-31	"Fri"	"Evening"	"377"	3	7	7	17
5434	2004-12-31	"Fri"	"Midday"	"563"	5	6	3	14
5433	2004-12-30	"Thu"	"Evening"	"471"	4	7	1	12
5432	2004-12-30	"Thu"	"Midday"	"397"	3	9	7	19
5431	2004-12-29	"Wed"	"Evening"	"260"	2	6	0	8
5430	2004-12-29	"Wed"	"Midday"	"256"	2	5	6	13
5429	2004-12-28	"Tue"	"Evening"	"965"	9	6	5	20
5428	2004-12-28	"Tue"	"Midday"	"889"	8	8	9	25
5427	2004-12-27	"Mon"	"Evening"	"859"	8	5	9	22
5426	2004-12-27	"Mon"	"Midday"	"922"	9	2	2	13
5425	2004-12-26	"Sun"	"Evening"	"542"	5	4	2	11
5424	2004-12-26	"Sun"	"Midday"	"350"	3	5	0	8
5423	2004-12-25	"Sat"	"Evening"	"227"	2	2	7	11
5422	2004-12-25	"Sat"	"Midday"	"136"	1	3	6	10
5421	2004-12-24	"Fri"	"Evening"	"362"	3	6	2	11
5420	2004-12-24	"Fri"	"Midday"	"109"	1	0	9	10
5419	2004-12-23	"Thu"	"Evening"	"553"	5	5	3	13
5418	2004-12-23	"Thu"	"Midday"	"104"	1	0	4	5
5417	2004-12-22	"Wed"	"Evening"	"972"	9	7	2	18
5416	2004-12-22	"Wed"	"Midday"	"383"	3	8	3	14
5415	2004-12-21	"Tue"	"Evening"	"961"	9	6	1	16
5414	2004-12-21	"Tue"	"Midday"	"631"	6	3	1	10
5413	2004-12-20	"Mon"	"Evening"	"931"	9	3	1	13
5412	2004-12-20	"Mon"	"Midday"	"460"	4	6	0	10
5411	2004-12-19	"Sun"	"Evening"	"135"	1	3	5	9
5410	2004-12-19	"Sun"	"Midday"	"982"	9	8	2	19
5409	2004-12-18	"Sat"	"Evening"	"765"	7	6	5	18
5408	2004-12-18	"Sat"	"Midday"	"373"	3	7	3	13
5407	2004-12-17	"Fri"	"Evening"	"024"	0	2	4	6
5406	2004-12-17	"Fri"	"Midday"	"521"	5	2	1	8
5405	2004-12-16	"Thu"	"Evening"	"712"	7	1	2	10
5404	2004-12-16	"Thu"	"Midday"	"243"	2	4	3	9
5403	2004-12-15	"Wed"	"Evening"	"661"	6	6	1	13
5402	2004-12-15	"Wed"	"Midday"	"525"	5	2	5	12
5401	2004-12-14	"Tue"	"Evening"	"187"	1	8	7	16
5400	2004-12-14	"Tue"	"Midday"	"521"	5	2	1	8
5399	2004-12-13	"Mon"	"Evening"	"215"	2	1	5	8
5398	2004-12-13	"Mon"	"Midday"	"238"	2	3	8	13
5397	2004-12-12	"Sun"	"Evening"	"537"	5	3	7	15
5396	2004-12-12	"Sun"	"Midday"	"096"	0	9	6	15
5395	2004-12-11	"Sat"	"Evening"	"880"	8	8	0	16
5394	2004-12-11	"Sat"	"Midday"	"304"	3	0	4	7
5393	2004-12-10	"Fri"	"Evening"	"566"	5	6	6	17
5392	2004-12-10	"Fri"	"Midday"	"302"	3	0	2	5
5391	2004-12-09	"Thu"	"Evening"	"184"	1	8	4	13
5390	2004-12-09	"Thu"	"Midday"	"412"	4	1	2	7
5389	2004-12-08	"Wed"	"Evening"	"026"	0	2	6	8
5388	2004-12-08	"Wed"	"Midday"	"014"	0	1	4	5
5387	2004-12-07	"Tue"	"Evening"	"773"	7	7	3	17
5386	2004-12-07	"Tue"	"Midday"	"333"	3	3	3	9
5385	2004-12-06	"Mon"	"Evening"	"427"	4	2	7	13
5384	2004-12-06	"Mon"	"Midday"	"880"	8	8	0	16
5383	2004-12-05	"Sun"	"Evening"	"243"	2	4	3	9
5382	2004-12-05	"Sun"	"Midday"	"742"	7	4	2	13
5381	2004-12-04	"Sat"	"Evening"	"736"	7	3	6	16
5380	2004-12-04	"Sat"	"Midday"	"706"	7	0	6	13
5379	2004-12-03	"Fri"	"Evening"	"244"	2	4	4	10
5378	2004-12-03	"Fri"	"Midday"	"470"	4	7	0	11
5377	2004-12-02	"Thu"	"Evening"	"009"	0	0	9	9
5376	2004-12-02	"Thu"	"Midday"	"076"	0	7	6	13
5375	2004-12-01	"Wed"	"Evening"	"666"	6	6	6	18
5374	2004-12-01	"Wed"	"Midday"	"247"	2	4	7	13
5373	2004-11-30	"Tue"	"Evening"	"319"	3	1	9	13
5372	2004-11-30	"Tue"	"Midday"	"927"	9	2	7	18
5371	2004-11-29	"Mon"	"Evening"	"476"	4	7	6	17
5370	2004-11-29	"Mon"	"Midday"	"418"	4	1	8	13
5369	2004-11-28	"Sun"	"Evening"	"173"	1	7	3	11
5368	2004-11-28	"Sun"	"Midday"	"532"	5	3	2	10
5367	2004-11-27	"Sat"	"Evening"	"656"	6	5	6	17
5366	2004-11-27	"Sat"	"Midday"	"098"	0	9	8	17
5365	2004-11-26	"Fri"	"Evening"	"138"	1	3	8	12
5364	2004-11-26	"Fri"	"Midday"	"160"	1	6	0	7
5363	2004-11-25	"Thu"	"Evening"	"072"	0	7	2	9
5362	2004-11-25	"Thu"	"Midday"	"178"	1	7	8	16
5361	2004-11-24	"Wed"	"Evening"	"516"	5	1	6	12
5360	2004-11-24	"Wed"	"Midday"	"299"	2	9	9	20
5359	2004-11-23	"Tue"	"Evening"	"615"	6	1	5	12
5358	2004-11-23	"Tue"	"Midday"	"722"	7	2	2	11
5357	2004-11-22	"Mon"	"Evening"	"364"	3	6	4	13
5356	2004-11-22	"Mon"	"Midday"	"712"	7	1	2	10
5355	2004-11-21	"Sun"	"Evening"	"405"	4	0	5	9
5354	2004-11-21	"Sun"	"Midday"	"165"	1	6	5	12
5353	2004-11-20	"Sat"	"Evening"	"999"	9	9	9	27
5352	2004-11-20	"Sat"	"Midday"	"785"	7	8	5	20
5351	2004-11-19	"Fri"	"Evening"	"939"	9	3	9	21
5350	2004-11-19	"Fri"	"Midday"	"381"	3	8	1	12
5349	2004-11-18	"Thu"	"Evening"	"644"	6	4	4	14
5348	2004-11-18	"Thu"	"Midday"	"100"	1	0	0	1
5347	2004-11-17	"Wed"	"Evening"	"973"	9	7	3	19
5346	2004-11-17	"Wed"	"Midday"	"726"	7	2	6	15
5345	2004-11-16	"Tue"	"Evening"	"513"	5	1	3	9
5344	2004-11-16	"Tue"	"Midday"	"666"	6	6	6	18
5343	2004-11-15	"Mon"	"Evening"	"006"	0	0	6	6
5342	2004-11-15	"Mon"	"Midday"	"925"	9	2	5	16
5341	2004-11-14	"Sun"	"Evening"	"019"	0	1	9	10
5340	2004-11-14	"Sun"	"Midday"	"415"	4	1	5	10
5339	2004-11-13	"Sat"	"Evening"	"133"	1	3	3	7
5338	2004-11-13	"Sat"	"Midday"	"560"	5	6	0	11
5337	2004-11-12	"Fri"	"Evening"	"191"	1	9	1	11
5336	2004-11-12	"Fri"	"Midday"	"307"	3	0	7	10
5335	2004-11-11	"Thu"	"Evening"	"972"	9	7	2	18
5334	2004-11-11	"Thu"	"Midday"	"060"	0	6	0	6
5333	2004-11-10	"Wed"	"Evening"	"962"	9	6	2	17
5332	2004-11-10	"Wed"	"Midday"	"686"	6	8	6	20
5331	2004-11-09	"Tue"	"Evening"	"659"	6	5	9	20
5330	2004-11-09	"Tue"	"Midday"	"151"	1	5	1	7
5329	2004-11-08	"Mon"	"Evening"	"020"	0	2	0	2
5328	2004-11-08	"Mon"	"Midday"	"797"	7	9	7	23
5327	2004-11-07	"Sun"	"Evening"	"430"	4	3	0	7
5326	2004-11-07	"Sun"	"Midday"	"661"	6	6	1	13
5325	2004-11-06	"Sat"	"Evening"	"199"	1	9	9	19
5324	2004-11-06	"Sat"	"Midday"	"203"	2	0	3	5
5323	2004-11-05	"Fri"	"Evening"	"120"	1	2	0	3
5322	2004-11-05	"Fri"	"Midday"	"650"	6	5	0	11
5321	2004-11-04	"Thu"	"Evening"	"460"	4	6	0	10
5320	2004-11-04	"Thu"	"Midday"	"107"	1	0	7	8
5319	2004-11-03	"Wed"	"Evening"	"348"	3	4	8	15
5318	2004-11-03	"Wed"	"Midday"	"431"	4	3	1	8
5317	2004-11-02	"Tue"	"Evening"	"824"	8	2	4	14
5316	2004-11-02	"Tue"	"Midday"	"085"	0	8	5	13
5315	2004-11-01	"Mon"	"Evening"	"840"	8	4	0	12
5314	2004-11-01	"Mon"	"Midday"	"082"	0	8	2	10
5313	2004-10-31	"Sun"	"Evening"	"034"	0	3	4	7
5312	2004-10-31	"Sun"	"Midday"	"460"	4	6	0	10
5311	2004-10-30	"Sat"	"Evening"	"178"	1	7	8	16
5310	2004-10-30	"Sat"	"Midday"	"200"	2	0	0	2
5309	2004-10-29	"Fri"	"Evening"	"149"	1	4	9	14
5308	2004-10-29	"Fri"	"Midday"	"006"	0	0	6	6
5307	2004-10-28	"Thu"	"Evening"	"607"	6	0	7	13
5306	2004-10-28	"Thu"	"Midday"	"009"	0	0	9	9
5305	2004-10-27	"Wed"	"Evening"	"488"	4	8	8	20
5304	2004-10-27	"Wed"	"Midday"	"421"	4	2	1	7
5303	2004-10-26	"Tue"	"Evening"	"155"	1	5	5	11
5302	2004-10-26	"Tue"	"Midday"	"849"	8	4	9	21
5301	2004-10-25	"Mon"	"Evening"	"040"	0	4	0	4
5300	2004-10-25	"Mon"	"Midday"	"995"	9	9	5	23
5299	2004-10-24	"Sun"	"Evening"	"205"	2	0	5	7
5298	2004-10-24	"Sun"	"Midday"	"879"	8	7	9	24
5297	2004-10-23	"Sat"	"Evening"	"587"	5	8	7	20
5296	2004-10-23	"Sat"	"Midday"	"846"	8	4	6	18
5295	2004-10-22	"Fri"	"Evening"	"201"	2	0	1	3
5294	2004-10-22	"Fri"	"Midday"	"730"	7	3	0	10
5293	2004-10-21	"Thu"	"Evening"	"974"	9	7	4	20
5292	2004-10-21	"Thu"	"Midday"	"987"	9	8	7	24
5291	2004-10-20	"Wed"	"Evening"	"643"	6	4	3	13
5290	2004-10-20	"Wed"	"Midday"	"088"	0	8	8	16
5289	2004-10-19	"Tue"	"Evening"	"021"	0	2	1	3
5288	2004-10-19	"Tue"	"Midday"	"611"	6	1	1	8
5287	2004-10-18	"Mon"	"Evening"	"098"	0	9	8	17
5286	2004-10-18	"Mon"	"Midday"	"658"	6	5	8	19
5285	2004-10-17	"Sun"	"Evening"	"327"	3	2	7	12
5284	2004-10-17	"Sun"	"Midday"	"861"	8	6	1	15
5283	2004-10-16	"Sat"	"Evening"	"358"	3	5	8	16
5282	2004-10-16	"Sat"	"Midday"	"187"	1	8	7	16
5281	2004-10-15	"Fri"	"Evening"	"965"	9	6	5	20
5280	2004-10-15	"Fri"	"Midday"	"015"	0	1	5	6
5279	2004-10-14	"Thu"	"Evening"	"590"	5	9	0	14
5278	2004-10-14	"Thu"	"Midday"	"158"	1	5	8	14
5277	2004-10-13	"Wed"	"Evening"	"595"	5	9	5	19
5276	2004-10-13	"Wed"	"Midday"	"082"	0	8	2	10
5275	2004-10-12	"Tue"	"Evening"	"658"	6	5	8	19
5274	2004-10-12	"Tue"	"Midday"	"358"	3	5	8	16
5273	2004-10-11	"Mon"	"Evening"	"512"	5	1	2	8
5272	2004-10-11	"Mon"	"Midday"	"108"	1	0	8	9
5271	2004-10-10	"Sun"	"Evening"	"083"	0	8	3	11
5270	2004-10-10	"Sun"	"Midday"	"071"	0	7	1	8
5269	2004-10-09	"Sat"	"Evening"	"385"	3	8	5	16
5268	2004-10-09	"Sat"	"Midday"	"199"	1	9	9	19
5267	2004-10-08	"Fri"	"Evening"	"196"	1	9	6	16
5266	2004-10-08	"Fri"	"Midday"	"800"	8	0	0	8
5265	2004-10-07	"Thu"	"Evening"	"063"	0	6	3	9
5264	2004-10-07	"Thu"	"Midday"	"525"	5	2	5	12
5263	2004-10-06	"Wed"	"Evening"	"889"	8	8	9	25
5262	2004-10-06	"Wed"	"Midday"	"032"	0	3	2	5
5261	2004-10-05	"Tue"	"Evening"	"613"	6	1	3	10
5260	2004-10-05	"Tue"	"Midday"	"972"	9	7	2	18
5259	2004-10-04	"Mon"	"Evening"	"674"	6	7	4	17
5258	2004-10-04	"Mon"	"Midday"	"096"	0	9	6	15
5257	2004-10-03	"Sun"	"Evening"	"533"	5	3	3	11
5256	2004-10-03	"Sun"	"Midday"	"915"	9	1	5	15
5255	2004-10-02	"Sat"	"Evening"	"757"	7	5	7	19
5254	2004-10-02	"Sat"	"Midday"	"601"	6	0	1	7
5253	2004-10-01	"Fri"	"Evening"	"048"	0	4	8	12
5252	2004-10-01	"Fri"	"Midday"	"212"	2	1	2	5
5251	2004-09-30	"Thu"	"Evening"	"362"	3	6	2	11
5250	2004-09-30	"Thu"	"Midday"	"386"	3	8	6	17
5249	2004-09-29	"Wed"	"Evening"	"735"	7	3	5	15
5248	2004-09-29	"Wed"	"Midday"	"948"	9	4	8	21
5247	2004-09-28	"Tue"	"Evening"	"784"	7	8	4	19
5246	2004-09-28	"Tue"	"Midday"	"192"	1	9	2	12
5245	2004-09-27	"Mon"	"Evening"	"263"	2	6	3	11
5244	2004-09-27	"Mon"	"Midday"	"216"	2	1	6	9
5243	2004-09-26	"Sun"	"Evening"	"458"	4	5	8	17
5242	2004-09-26	"Sun"	"Midday"	"120"	1	2	0	3
5241	2004-09-25	"Sat"	"Evening"	"028"	0	2	8	10
5240	2004-09-25	"Sat"	"Midday"	"175"	1	7	5	13
5239	2004-09-24	"Fri"	"Evening"	"098"	0	9	8	17
5238	2004-09-24	"Fri"	"Midday"	"318"	3	1	8	12
5237	2004-09-23	"Thu"	"Evening"	"171"	1	7	1	9
5236	2004-09-23	"Thu"	"Midday"	"473"	4	7	3	14
5235	2004-09-22	"Wed"	"Evening"	"871"	8	7	1	16
5234	2004-09-22	"Wed"	"Midday"	"742"	7	4	2	13
5233	2004-09-21	"Tue"	"Evening"	"204"	2	0	4	6
5232	2004-09-21	"Tue"	"Midday"	"342"	3	4	2	9
5231	2004-09-20	"Mon"	"Evening"	"057"	0	5	7	12
5230	2004-09-20	"Mon"	"Midday"	"634"	6	3	4	13
5229	2004-09-19	"Sun"	"Evening"	"967"	9	6	7	22
5228	2004-09-19	"Sun"	"Midday"	"690"	6	9	0	15
5227	2004-09-18	"Sat"	"Evening"	"822"	8	2	2	12
5226	2004-09-18	"Sat"	"Midday"	"517"	5	1	7	13
5225	2004-09-17	"Fri"	"Evening"	"927"	9	2	7	18
5224	2004-09-17	"Fri"	"Midday"	"094"	0	9	4	13
5223	2004-09-16	"Thu"	"Evening"	"945"	9	4	5	18
5222	2004-09-16	"Thu"	"Midday"	"640"	6	4	0	10
5221	2004-09-15	"Wed"	"Evening"	"547"	5	4	7	16
5220	2004-09-15	"Wed"	"Midday"	"330"	3	3	0	6
5219	2004-09-14	"Tue"	"Evening"	"274"	2	7	4	13
5218	2004-09-14	"Tue"	"Midday"	"801"	8	0	1	9
5217	2004-09-13	"Mon"	"Evening"	"695"	6	9	5	20
5216	2004-09-13	"Mon"	"Midday"	"534"	5	3	4	12
5215	2004-09-12	"Sun"	"Evening"	"282"	2	8	2	12
5214	2004-09-12	"Sun"	"Midday"	"371"	3	7	1	11
5213	2004-09-11	"Sat"	"Evening"	"550"	5	5	0	10
5212	2004-09-11	"Sat"	"Midday"	"745"	7	4	5	16
5211	2004-09-10	"Fri"	"Evening"	"867"	8	6	7	21
5210	2004-09-10	"Fri"	"Midday"	"032"	0	3	2	5
5209	2004-09-09	"Thu"	"Evening"	"827"	8	2	7	17
5208	2004-09-09	"Thu"	"Midday"	"339"	3	3	9	15
5207	2004-09-08	"Wed"	"Evening"	"106"	1	0	6	7
5206	2004-09-08	"Wed"	"Midday"	"308"	3	0	8	11
5205	2004-09-07	"Tue"	"Evening"	"810"	8	1	0	9
5204	2004-09-07	"Tue"	"Midday"	"718"	7	1	8	16
5203	2004-09-06	"Mon"	"Evening"	"870"	8	7	0	15
5202	2004-09-06	"Mon"	"Midday"	"694"	6	9	4	19
5201	2004-09-05	"Sun"	"Evening"	"547"	5	4	7	16
5200	2004-09-05	"Sun"	"Midday"	"725"	7	2	5	14
5199	2004-09-04	"Sat"	"Evening"	"492"	4	9	2	15
5198	2004-09-04	"Sat"	"Midday"	"550"	5	5	0	10
5197	2004-09-03	"Fri"	"Evening"	"831"	8	3	1	12
5196	2004-09-03	"Fri"	"Midday"	"740"	7	4	0	11
5195	2004-09-02	"Thu"	"Evening"	"715"	7	1	5	13
5194	2004-09-02	"Thu"	"Midday"	"989"	9	8	9	26
5193	2004-09-01	"Wed"	"Evening"	"850"	8	5	0	13
5192	2004-09-01	"Wed"	"Midday"	"723"	7	2	3	12
5191	2004-08-31	"Tue"	"Evening"	"998"	9	9	8	26
5190	2004-08-31	"Tue"	"Midday"	"848"	8	4	8	20
5189	2004-08-30	"Mon"	"Evening"	"731"	7	3	1	11
5188	2004-08-30	"Mon"	"Midday"	"523"	5	2	3	10
5187	2004-08-29	"Sun"	"Evening"	"222"	2	2	2	6
5186	2004-08-29	"Sun"	"Midday"	"192"	1	9	2	12
5185	2004-08-28	"Sat"	"Evening"	"313"	3	1	3	7
5184	2004-08-28	"Sat"	"Midday"	"131"	1	3	1	5
5183	2004-08-27	"Fri"	"Evening"	"425"	4	2	5	11
5182	2004-08-27	"Fri"	"Midday"	"215"	2	1	5	8
5181	2004-08-26	"Thu"	"Evening"	"351"	3	5	1	9
5180	2004-08-26	"Thu"	"Midday"	"785"	7	8	5	20
5179	2004-08-25	"Wed"	"Evening"	"464"	4	6	4	14
5178	2004-08-25	"Wed"	"Midday"	"384"	3	8	4	15
5177	2004-08-24	"Tue"	"Evening"	"960"	9	6	0	15
5176	2004-08-24	"Tue"	"Midday"	"407"	4	0	7	11
5175	2004-08-23	"Mon"	"Evening"	"115"	1	1	5	7
5174	2004-08-23	"Mon"	"Midday"	"623"	6	2	3	11
5173	2004-08-22	"Sun"	"Evening"	"898"	8	9	8	25
5172	2004-08-22	"Sun"	"Midday"	"814"	8	1	4	13
5171	2004-08-21	"Sat"	"Evening"	"998"	9	9	8	26
5170	2004-08-21	"Sat"	"Midday"	"915"	9	1	5	15
5169	2004-08-20	"Fri"	"Evening"	"287"	2	8	7	17
5168	2004-08-20	"Fri"	"Midday"	"027"	0	2	7	9
5167	2004-08-19	"Thu"	"Evening"	"970"	9	7	0	16
5166	2004-08-19	"Thu"	"Midday"	"823"	8	2	3	13
5165	2004-08-18	"Wed"	"Evening"	"078"	0	7	8	15
5164	2004-08-18	"Wed"	"Midday"	"089"	0	8	9	17
5163	2004-08-17	"Tue"	"Evening"	"122"	1	2	2	5
5162	2004-08-17	"Tue"	"Midday"	"545"	5	4	5	14
5161	2004-08-16	"Mon"	"Evening"	"481"	4	8	1	13
5160	2004-08-16	"Mon"	"Midday"	"143"	1	4	3	8
5159	2004-08-15	"Sun"	"Evening"	"889"	8	8	9	25
5158	2004-08-15	"Sun"	"Midday"	"701"	7	0	1	8
5157	2004-08-14	"Sat"	"Evening"	"056"	0	5	6	11
5156	2004-08-14	"Sat"	"Midday"	"530"	5	3	0	8
5155	2004-08-13	"Fri"	"Evening"	"576"	5	7	6	18
5154	2004-08-13	"Fri"	"Midday"	"765"	7	6	5	18
5153	2004-08-12	"Thu"	"Evening"	"200"	2	0	0	2
5152	2004-08-12	"Thu"	"Midday"	"530"	5	3	0	8
5151	2004-08-11	"Wed"	"Evening"	"238"	2	3	8	13
5150	2004-08-11	"Wed"	"Midday"	"708"	7	0	8	15
5149	2004-08-10	"Tue"	"Evening"	"956"	9	5	6	20
5148	2004-08-10	"Tue"	"Midday"	"836"	8	3	6	17
5147	2004-08-09	"Mon"	"Evening"	"251"	2	5	1	8
5146	2004-08-09	"Mon"	"Midday"	"492"	4	9	2	15
5145	2004-08-08	"Sun"	"Evening"	"103"	1	0	3	4
5144	2004-08-08	"Sun"	"Midday"	"313"	3	1	3	7
5143	2004-08-07	"Sat"	"Evening"	"717"	7	1	7	15
5142	2004-08-07	"Sat"	"Midday"	"839"	8	3	9	20
5141	2004-08-06	"Fri"	"Evening"	"971"	9	7	1	17
5140	2004-08-06	"Fri"	"Midday"	"974"	9	7	4	20
5139	2004-08-05	"Thu"	"Evening"	"098"	0	9	8	17
5138	2004-08-05	"Thu"	"Midday"	"656"	6	5	6	17
5137	2004-08-04	"Wed"	"Evening"	"157"	1	5	7	13
5136	2004-08-04	"Wed"	"Midday"	"041"	0	4	1	5
5135	2004-08-03	"Tue"	"Evening"	"420"	4	2	0	6
5134	2004-08-03	"Tue"	"Midday"	"352"	3	5	2	10
5133	2004-08-02	"Mon"	"Evening"	"186"	1	8	6	15
5132	2004-08-02	"Mon"	"Midday"	"507"	5	0	7	12
5131	2004-08-01	"Sun"	"Evening"	"387"	3	8	7	18
5130	2004-08-01	"Sun"	"Midday"	"241"	2	4	1	7
5129	2004-07-31	"Sat"	"Evening"	"911"	9	1	1	11
5128	2004-07-31	"Sat"	"Midday"	"804"	8	0	4	12
5127	2004-07-30	"Fri"	"Evening"	"982"	9	8	2	19
5126	2004-07-30	"Fri"	"Midday"	"421"	4	2	1	7
5125	2004-07-29	"Thu"	"Evening"	"048"	0	4	8	12
5124	2004-07-29	"Thu"	"Midday"	"707"	7	0	7	14
5123	2004-07-28	"Wed"	"Evening"	"029"	0	2	9	11
5122	2004-07-28	"Wed"	"Midday"	"391"	3	9	1	13
5121	2004-07-27	"Tue"	"Evening"	"440"	4	4	0	8
5120	2004-07-27	"Tue"	"Midday"	"428"	4	2	8	14
5119	2004-07-26	"Mon"	"Evening"	"633"	6	3	3	12
5118	2004-07-26	"Mon"	"Midday"	"703"	7	0	3	10
5117	2004-07-25	"Sun"	"Evening"	"878"	8	7	8	23
5116	2004-07-25	"Sun"	"Midday"	"398"	3	9	8	20
5115	2004-07-24	"Sat"	"Evening"	"971"	9	7	1	17
5114	2004-07-24	"Sat"	"Midday"	"946"	9	4	6	19
5113	2004-07-23	"Fri"	"Evening"	"793"	7	9	3	19
5112	2004-07-23	"Fri"	"Midday"	"949"	9	4	9	22
5111	2004-07-22	"Thu"	"Evening"	"479"	4	7	9	20
5110	2004-07-22	"Thu"	"Midday"	"768"	7	6	8	21
5109	2004-07-21	"Wed"	"Evening"	"886"	8	8	6	22
5108	2004-07-21	"Wed"	"Midday"	"942"	9	4	2	15
5107	2004-07-20	"Tue"	"Evening"	"319"	3	1	9	13
5106	2004-07-20	"Tue"	"Midday"	"641"	6	4	1	11
5105	2004-07-19	"Mon"	"Evening"	"306"	3	0	6	9
5104	2004-07-19	"Mon"	"Midday"	"770"	7	7	0	14
5103	2004-07-18	"Sun"	"Evening"	"475"	4	7	5	16
5102	2004-07-18	"Sun"	"Midday"	"575"	5	7	5	17
5101	2004-07-17	"Sat"	"Evening"	"130"	1	3	0	4
5100	2004-07-17	"Sat"	"Midday"	"472"	4	7	2	13
5099	2004-07-16	"Fri"	"Evening"	"695"	6	9	5	20
5098	2004-07-16	"Fri"	"Midday"	"917"	9	1	7	17
5097	2004-07-15	"Thu"	"Evening"	"309"	3	0	9	12
5096	2004-07-15	"Thu"	"Midday"	"268"	2	6	8	16
5095	2004-07-14	"Wed"	"Evening"	"906"	9	0	6	15
5094	2004-07-14	"Wed"	"Midday"	"135"	1	3	5	9
5093	2004-07-13	"Tue"	"Evening"	"969"	9	6	9	24
5092	2004-07-13	"Tue"	"Midday"	"140"	1	4	0	5
5091	2004-07-12	"Mon"	"Evening"	"492"	4	9	2	15
5090	2004-07-12	"Mon"	"Midday"	"199"	1	9	9	19
5089	2004-07-11	"Sun"	"Evening"	"065"	0	6	5	11
5088	2004-07-11	"Sun"	"Midday"	"390"	3	9	0	12
5087	2004-07-10	"Sat"	"Evening"	"082"	0	8	2	10
5086	2004-07-10	"Sat"	"Midday"	"996"	9	9	6	24
5085	2004-07-09	"Fri"	"Evening"	"158"	1	5	8	14
5084	2004-07-09	"Fri"	"Midday"	"555"	5	5	5	15
5083	2004-07-08	"Thu"	"Evening"	"484"	4	8	4	16
5082	2004-07-08	"Thu"	"Midday"	"610"	6	1	0	7
5081	2004-07-07	"Wed"	"Evening"	"753"	7	5	3	15
5080	2004-07-07	"Wed"	"Midday"	"222"	2	2	2	6
5079	2004-07-06	"Tue"	"Evening"	"196"	1	9	6	16
5078	2004-07-06	"Tue"	"Midday"	"695"	6	9	5	20
5077	2004-07-05	"Mon"	"Evening"	"959"	9	5	9	23
5076	2004-07-05	"Mon"	"Midday"	"702"	7	0	2	9
5075	2004-07-04	"Sun"	"Evening"	"346"	3	4	6	13
5074	2004-07-04	"Sun"	"Midday"	"108"	1	0	8	9
5073	2004-07-03	"Sat"	"Evening"	"511"	5	1	1	7
5072	2004-07-03	"Sat"	"Midday"	"441"	4	4	1	9
5071	2004-07-02	"Fri"	"Evening"	"291"	2	9	1	12
5070	2004-07-02	"Fri"	"Midday"	"511"	5	1	1	7
5069	2004-07-01	"Thu"	"Evening"	"068"	0	6	8	14
5068	2004-07-01	"Thu"	"Midday"	"884"	8	8	4	20
5067	2004-06-30	"Wed"	"Evening"	"985"	9	8	5	22
5066	2004-06-30	"Wed"	"Midday"	"224"	2	2	4	8
5065	2004-06-29	"Tue"	"Evening"	"368"	3	6	8	17
5064	2004-06-29	"Tue"	"Midday"	"762"	7	6	2	15
5063	2004-06-28	"Mon"	"Evening"	"769"	7	6	9	22
5062	2004-06-28	"Mon"	"Midday"	"739"	7	3	9	19
5061	2004-06-27	"Sun"	"Evening"	"039"	0	3	9	12
5060	2004-06-27	"Sun"	"Midday"	"081"	0	8	1	9
5059	2004-06-26	"Sat"	"Evening"	"322"	3	2	2	7
5058	2004-06-26	"Sat"	"Midday"	"816"	8	1	6	15
5057	2004-06-25	"Fri"	"Evening"	"713"	7	1	3	11
5056	2004-06-25	"Fri"	"Midday"	"458"	4	5	8	17
5055	2004-06-24	"Thu"	"Evening"	"830"	8	3	0	11
5054	2004-06-24	"Thu"	"Midday"	"204"	2	0	4	6
5053	2004-06-23	"Wed"	"Evening"	"441"	4	4	1	9
5052	2004-06-23	"Wed"	"Midday"	"452"	4	5	2	11
5051	2004-06-22	"Tue"	"Evening"	"219"	2	1	9	12
5050	2004-06-22	"Tue"	"Midday"	"357"	3	5	7	15
5049	2004-06-21	"Mon"	"Evening"	"467"	4	6	7	17
5048	2004-06-21	"Mon"	"Midday"	"489"	4	8	9	21
5047	2004-06-20	"Sun"	"Evening"	"360"	3	6	0	9
5046	2004-06-20	"Sun"	"Midday"	"468"	4	6	8	18
5045	2004-06-19	"Sat"	"Evening"	"925"	9	2	5	16
5044	2004-06-19	"Sat"	"Midday"	"548"	5	4	8	17
5043	2004-06-18	"Fri"	"Evening"	"026"	0	2	6	8
5042	2004-06-18	"Fri"	"Midday"	"496"	4	9	6	19
5041	2004-06-17	"Thu"	"Evening"	"411"	4	1	1	6
5040	2004-06-17	"Thu"	"Midday"	"016"	0	1	6	7
5039	2004-06-16	"Wed"	"Evening"	"634"	6	3	4	13
5038	2004-06-16	"Wed"	"Midday"	"033"	0	3	3	6
5037	2004-06-15	"Tue"	"Evening"	"584"	5	8	4	17
5036	2004-06-15	"Tue"	"Midday"	"775"	7	7	5	19
5035	2004-06-14	"Mon"	"Evening"	"486"	4	8	6	18
5034	2004-06-14	"Mon"	"Midday"	"315"	3	1	5	9
5033	2004-06-13	"Sun"	"Evening"	"046"	0	4	6	10
5032	2004-06-13	"Sun"	"Midday"	"942"	9	4	2	15
5031	2004-06-12	"Sat"	"Evening"	"697"	6	9	7	22
5030	2004-06-12	"Sat"	"Midday"	"623"	6	2	3	11
5029	2004-06-11	"Fri"	"Evening"	"997"	9	9	7	25
5028	2004-06-11	"Fri"	"Midday"	"536"	5	3	6	14
5027	2004-06-10	"Thu"	"Evening"	"971"	9	7	1	17
5026	2004-06-10	"Thu"	"Midday"	"683"	6	8	3	17
5025	2004-06-09	"Wed"	"Evening"	"049"	0	4	9	13
5024	2004-06-09	"Wed"	"Midday"	"397"	3	9	7	19
5023	2004-06-08	"Tue"	"Evening"	"462"	4	6	2	12
5022	2004-06-08	"Tue"	"Midday"	"411"	4	1	1	6
5021	2004-06-07	"Mon"	"Evening"	"670"	6	7	0	13
5020	2004-06-07	"Mon"	"Midday"	"492"	4	9	2	15
5019	2004-06-06	"Sun"	"Evening"	"944"	9	4	4	17
5018	2004-06-06	"Sun"	"Midday"	"943"	9	4	3	16
5017	2004-06-05	"Sat"	"Evening"	"090"	0	9	0	9
5016	2004-06-05	"Sat"	"Midday"	"337"	3	3	7	13
5015	2004-06-04	"Fri"	"Evening"	"650"	6	5	0	11
5014	2004-06-04	"Fri"	"Midday"	"547"	5	4	7	16
5013	2004-06-03	"Thu"	"Evening"	"370"	3	7	0	10
5012	2004-06-03	"Thu"	"Midday"	"813"	8	1	3	12
5011	2004-06-02	"Wed"	"Evening"	"539"	5	3	9	17
5010	2004-06-02	"Wed"	"Midday"	"056"	0	5	6	11
5009	2004-06-01	"Tue"	"Evening"	"190"	1	9	0	10
5008	2004-06-01	"Tue"	"Midday"	"120"	1	2	0	3
5007	2004-05-31	"Mon"	"Evening"	"662"	6	6	2	14
5006	2004-05-31	"Mon"	"Midday"	"355"	3	5	5	13
5005	2004-05-30	"Sun"	"Evening"	"361"	3	6	1	10
5004	2004-05-30	"Sun"	"Midday"	"850"	8	5	0	13
5003	2004-05-29	"Sat"	"Evening"	"707"	7	0	7	14
5002	2004-05-29	"Sat"	"Midday"	"197"	1	9	7	17
5001	2004-05-28	"Fri"	"Evening"	"765"	7	6	5	18
5000	2004-05-28	"Fri"	"Midday"	"500"	5	0	0	5
4999	2004-05-27	"Thu"	"Evening"	"579"	5	7	9	21
4998	2004-05-27	"Thu"	"Midday"	"684"	6	8	4	18
4997	2004-05-26	"Wed"	"Evening"	"700"	7	0	0	7
4996	2004-05-26	"Wed"	"Midday"	"990"	9	9	0	18
4995	2004-05-25	"Tue"	"Evening"	"053"	0	5	3	8
4994	2004-05-25	"Tue"	"Midday"	"358"	3	5	8	16
4993	2004-05-24	"Mon"	"Evening"	"510"	5	1	0	6
4992	2004-05-24	"Mon"	"Midday"	"702"	7	0	2	9
4991	2004-05-23	"Sun"	"Evening"	"528"	5	2	8	15
4990	2004-05-23	"Sun"	"Midday"	"169"	1	6	9	16
4989	2004-05-22	"Sat"	"Evening"	"031"	0	3	1	4
4988	2004-05-22	"Sat"	"Midday"	"481"	4	8	1	13
4987	2004-05-21	"Fri"	"Evening"	"406"	4	0	6	10
4986	2004-05-21	"Fri"	"Midday"	"351"	3	5	1	9
4985	2004-05-20	"Thu"	"Evening"	"364"	3	6	4	13
4984	2004-05-20	"Thu"	"Midday"	"318"	3	1	8	12
4983	2004-05-19	"Wed"	"Evening"	"433"	4	3	3	10
4982	2004-05-19	"Wed"	"Midday"	"952"	9	5	2	16
4981	2004-05-18	"Tue"	"Evening"	"333"	3	3	3	9
4980	2004-05-18	"Tue"	"Midday"	"894"	8	9	4	21
4979	2004-05-17	"Mon"	"Evening"	"554"	5	5	4	14
4978	2004-05-17	"Mon"	"Midday"	"285"	2	8	5	15
4977	2004-05-16	"Sun"	"Evening"	"167"	1	6	7	14
4976	2004-05-16	"Sun"	"Midday"	"397"	3	9	7	19
4975	2004-05-15	"Sat"	"Evening"	"208"	2	0	8	10
4974	2004-05-15	"Sat"	"Midday"	"631"	6	3	1	10
4973	2004-05-14	"Fri"	"Evening"	"219"	2	1	9	12
4972	2004-05-14	"Fri"	"Midday"	"215"	2	1	5	8
4971	2004-05-13	"Thu"	"Evening"	"649"	6	4	9	19
4970	2004-05-13	"Thu"	"Midday"	"309"	3	0	9	12
4969	2004-05-12	"Wed"	"Evening"	"968"	9	6	8	23
4968	2004-05-12	"Wed"	"Midday"	"621"	6	2	1	9
4967	2004-05-11	"Tue"	"Evening"	"750"	7	5	0	12
4966	2004-05-11	"Tue"	"Midday"	"051"	0	5	1	6
4965	2004-05-10	"Mon"	"Evening"	"523"	5	2	3	10
4964	2004-05-10	"Mon"	"Midday"	"505"	5	0	5	10
4963	2004-05-09	"Sun"	"Evening"	"381"	3	8	1	12
4962	2004-05-09	"Sun"	"Midday"	"184"	1	8	4	13
4961	2004-05-08	"Sat"	"Evening"	"545"	5	4	5	14
4960	2004-05-08	"Sat"	"Midday"	"333"	3	3	3	9
4959	2004-05-07	"Fri"	"Evening"	"009"	0	0	9	9
4958	2004-05-07	"Fri"	"Midday"	"057"	0	5	7	12
4957	2004-05-06	"Thu"	"Evening"	"755"	7	5	5	17
4956	2004-05-06	"Thu"	"Midday"	"750"	7	5	0	12
4955	2004-05-05	"Wed"	"Evening"	"226"	2	2	6	10
4954	2004-05-05	"Wed"	"Midday"	"332"	3	3	2	8
4953	2004-05-04	"Tue"	"Evening"	"180"	1	8	0	9
4952	2004-05-04	"Tue"	"Midday"	"873"	8	7	3	18
4951	2004-05-03	"Mon"	"Evening"	"819"	8	1	9	18
4950	2004-05-03	"Mon"	"Midday"	"167"	1	6	7	14
4949	2004-05-02	"Sun"	"Evening"	"064"	0	6	4	10
4948	2004-05-02	"Sun"	"Midday"	"144"	1	4	4	9
4947	2004-05-01	"Sat"	"Evening"	"508"	5	0	8	13
4946	2004-05-01	"Sat"	"Midday"	"390"	3	9	0	12
4945	2004-04-30	"Fri"	"Evening"	"707"	7	0	7	14
4944	2004-04-30	"Fri"	"Midday"	"314"	3	1	4	8
4943	2004-04-29	"Thu"	"Evening"	"887"	8	8	7	23
4942	2004-04-29	"Thu"	"Midday"	"540"	5	4	0	9
4941	2004-04-28	"Wed"	"Evening"	"517"	5	1	7	13
4940	2004-04-28	"Wed"	"Midday"	"830"	8	3	0	11
4939	2004-04-27	"Tue"	"Evening"	"909"	9	0	9	18
4938	2004-04-27	"Tue"	"Midday"	"136"	1	3	6	10
4937	2004-04-26	"Mon"	"Evening"	"719"	7	1	9	17
4936	2004-04-26	"Mon"	"Midday"	"394"	3	9	4	16
4935	2004-04-25	"Sun"	"Evening"	"338"	3	3	8	14
4934	2004-04-25	"Sun"	"Midday"	"155"	1	5	5	11
4933	2004-04-24	"Sat"	"Evening"	"768"	7	6	8	21
4932	2004-04-24	"Sat"	"Midday"	"185"	1	8	5	14
4931	2004-04-23	"Fri"	"Evening"	"183"	1	8	3	12
4930	2004-04-23	"Fri"	"Midday"	"631"	6	3	1	10
4929	2004-04-22	"Thu"	"Evening"	"225"	2	2	5	9
4928	2004-04-22	"Thu"	"Midday"	"940"	9	4	0	13
4927	2004-04-21	"Wed"	"Evening"	"488"	4	8	8	20
4926	2004-04-21	"Wed"	"Midday"	"202"	2	0	2	4
4925	2004-04-20	"Tue"	"Evening"	"210"	2	1	0	3
4924	2004-04-20	"Tue"	"Midday"	"344"	3	4	4	11
4923	2004-04-19	"Mon"	"Evening"	"717"	7	1	7	15
4922	2004-04-19	"Mon"	"Midday"	"266"	2	6	6	14
4921	2004-04-18	"Sun"	"Evening"	"637"	6	3	7	16
4920	2004-04-18	"Sun"	"Midday"	"971"	9	7	1	17
4919	2004-04-17	"Sat"	"Evening"	"531"	5	3	1	9
4918	2004-04-17	"Sat"	"Midday"	"486"	4	8	6	18
4917	2004-04-16	"Fri"	"Evening"	"235"	2	3	5	10
4916	2004-04-16	"Fri"	"Midday"	"042"	0	4	2	6
4915	2004-04-15	"Thu"	"Evening"	"392"	3	9	2	14
4914	2004-04-15	"Thu"	"Midday"	"211"	2	1	1	4
4913	2004-04-14	"Wed"	"Evening"	"859"	8	5	9	22
4912	2004-04-14	"Wed"	"Midday"	"430"	4	3	0	7
4911	2004-04-13	"Tue"	"Evening"	"526"	5	2	6	13
4910	2004-04-13	"Tue"	"Midday"	"421"	4	2	1	7
4909	2004-04-12	"Mon"	"Evening"	"952"	9	5	2	16
4908	2004-04-12	"Mon"	"Midday"	"250"	2	5	0	7
4907	2004-04-11	"Sun"	"Evening"	"720"	7	2	0	9
4906	2004-04-11	"Sun"	"Midday"	"024"	0	2	4	6
4905	2004-04-10	"Sat"	"Evening"	"171"	1	7	1	9
4904	2004-04-10	"Sat"	"Midday"	"992"	9	9	2	20
4903	2004-04-09	"Fri"	"Evening"	"219"	2	1	9	12
4902	2004-04-09	"Fri"	"Midday"	"303"	3	0	3	6
4901	2004-04-08	"Thu"	"Evening"	"426"	4	2	6	12
4900	2004-04-08	"Thu"	"Midday"	"663"	6	6	3	15
4899	2004-04-07	"Wed"	"Evening"	"465"	4	6	5	15
4898	2004-04-07	"Wed"	"Midday"	"592"	5	9	2	16
4897	2004-04-06	"Tue"	"Evening"	"092"	0	9	2	11
4896	2004-04-06	"Tue"	"Midday"	"894"	8	9	4	21
4895	2004-04-05	"Mon"	"Evening"	"775"	7	7	5	19
4894	2004-04-05	"Mon"	"Midday"	"738"	7	3	8	18
4893	2004-04-04	"Sun"	"Evening"	"975"	9	7	5	21
4892	2004-04-04	"Sun"	"Midday"	"567"	5	6	7	18
4891	2004-04-03	"Sat"	"Evening"	"935"	9	3	5	17
4890	2004-04-03	"Sat"	"Midday"	"980"	9	8	0	17
4889	2004-04-02	"Fri"	"Evening"	"275"	2	7	5	14
4888	2004-04-02	"Fri"	"Midday"	"951"	9	5	1	15
4887	2004-04-01	"Thu"	"Evening"	"286"	2	8	6	16
4886	2004-04-01	"Thu"	"Midday"	"836"	8	3	6	17
4885	2004-03-31	"Wed"	"Evening"	"655"	6	5	5	16
4884	2004-03-31	"Wed"	"Midday"	"519"	5	1	9	15
4883	2004-03-30	"Tue"	"Evening"	"995"	9	9	5	23
4882	2004-03-30	"Tue"	"Midday"	"053"	0	5	3	8
4881	2004-03-29	"Mon"	"Evening"	"064"	0	6	4	10
4880	2004-03-29	"Mon"	"Midday"	"561"	5	6	1	12
4879	2004-03-28	"Sun"	"Evening"	"086"	0	8	6	14
4878	2004-03-28	"Sun"	"Midday"	"661"	6	6	1	13
4877	2004-03-27	"Sat"	"Evening"	"775"	7	7	5	19
4876	2004-03-27	"Sat"	"Midday"	"755"	7	5	5	17
4875	2004-03-26	"Fri"	"Evening"	"194"	1	9	4	14
4874	2004-03-26	"Fri"	"Midday"	"132"	1	3	2	6
4873	2004-03-25	"Thu"	"Evening"	"546"	5	4	6	15
4872	2004-03-25	"Thu"	"Midday"	"914"	9	1	4	14
4871	2004-03-24	"Wed"	"Evening"	"968"	9	6	8	23
4870	2004-03-24	"Wed"	"Midday"	"364"	3	6	4	13
4869	2004-03-23	"Tue"	"Evening"	"835"	8	3	5	16
4868	2004-03-23	"Tue"	"Midday"	"105"	1	0	5	6
4867	2004-03-22	"Mon"	"Evening"	"737"	7	3	7	17
4866	2004-03-22	"Mon"	"Midday"	"224"	2	2	4	8
4865	2004-03-21	"Sun"	"Evening"	"713"	7	1	3	11
4864	2004-03-21	"Sun"	"Midday"	"864"	8	6	4	18
4863	2004-03-20	"Sat"	"Evening"	"291"	2	9	1	12
4862	2004-03-20	"Sat"	"Midday"	"162"	1	6	2	9
4861	2004-03-19	"Fri"	"Evening"	"075"	0	7	5	12
4860	2004-03-19	"Fri"	"Midday"	"320"	3	2	0	5
4859	2004-03-18	"Thu"	"Evening"	"234"	2	3	4	9
4858	2004-03-18	"Thu"	"Midday"	"328"	3	2	8	13
4857	2004-03-17	"Wed"	"Evening"	"802"	8	0	2	10
4856	2004-03-17	"Wed"	"Midday"	"169"	1	6	9	16
4855	2004-03-16	"Tue"	"Evening"	"483"	4	8	3	15
4854	2004-03-16	"Tue"	"Midday"	"971"	9	7	1	17
4853	2004-03-15	"Mon"	"Evening"	"683"	6	8	3	17
4852	2004-03-15	"Mon"	"Midday"	"400"	4	0	0	4
4851	2004-03-14	"Sun"	"Evening"	"756"	7	5	6	18
4850	2004-03-14	"Sun"	"Midday"	"435"	4	3	5	12
4849	2004-03-13	"Sat"	"Evening"	"969"	9	6	9	24
4848	2004-03-13	"Sat"	"Midday"	"030"	0	3	0	3
4847	2004-03-12	"Fri"	"Evening"	"028"	0	2	8	10
4846	2004-03-12	"Fri"	"Midday"	"625"	6	2	5	13
4845	2004-03-11	"Thu"	"Evening"	"109"	1	0	9	10
4844	2004-03-11	"Thu"	"Midday"	"928"	9	2	8	19
4843	2004-03-10	"Wed"	"Evening"	"720"	7	2	0	9
4842	2004-03-10	"Wed"	"Midday"	"043"	0	4	3	7
4841	2004-03-09	"Tue"	"Evening"	"861"	8	6	1	15
4840	2004-03-09	"Tue"	"Midday"	"931"	9	3	1	13
4839	2004-03-08	"Mon"	"Evening"	"239"	2	3	9	14
4838	2004-03-08	"Mon"	"Midday"	"473"	4	7	3	14
4837	2004-03-07	"Sun"	"Evening"	"969"	9	6	9	24
4836	2004-03-07	"Sun"	"Midday"	"576"	5	7	6	18
4835	2004-03-06	"Sat"	"Evening"	"962"	9	6	2	17
4834	2004-03-06	"Sat"	"Midday"	"648"	6	4	8	18
4833	2004-03-05	"Fri"	"Evening"	"467"	4	6	7	17
4832	2004-03-05	"Fri"	"Midday"	"399"	3	9	9	21
4831	2004-03-04	"Thu"	"Evening"	"980"	9	8	0	17
4830	2004-03-04	"Thu"	"Midday"	"270"	2	7	0	9
4829	2004-03-03	"Wed"	"Evening"	"271"	2	7	1	10
4828	2004-03-03	"Wed"	"Midday"	"343"	3	4	3	10
4827	2004-03-02	"Tue"	"Evening"	"109"	1	0	9	10
4826	2004-03-02	"Tue"	"Midday"	"190"	1	9	0	10
4825	2004-03-01	"Mon"	"Evening"	"665"	6	6	5	17
4824	2004-03-01	"Mon"	"Midday"	"727"	7	2	7	16
4823	2004-02-29	"Sun"	"Evening"	"073"	0	7	3	10
4822	2004-02-29	"Sun"	"Midday"	"685"	6	8	5	19
4821	2004-02-28	"Sat"	"Evening"	"411"	4	1	1	6
4820	2004-02-28	"Sat"	"Midday"	"587"	5	8	7	20
4819	2004-02-27	"Fri"	"Evening"	"886"	8	8	6	22
4818	2004-02-27	"Fri"	"Midday"	"106"	1	0	6	7
4817	2004-02-26	"Thu"	"Evening"	"648"	6	4	8	18
4816	2004-02-26	"Thu"	"Midday"	"827"	8	2	7	17
4815	2004-02-25	"Wed"	"Evening"	"272"	2	7	2	11
4814	2004-02-25	"Wed"	"Midday"	"648"	6	4	8	18
4813	2004-02-24	"Tue"	"Evening"	"066"	0	6	6	12
4812	2004-02-24	"Tue"	"Midday"	"897"	8	9	7	24
4811	2004-02-23	"Mon"	"Evening"	"501"	5	0	1	6
4810	2004-02-23	"Mon"	"Midday"	"807"	8	0	7	15
4809	2004-02-22	"Sun"	"Evening"	"122"	1	2	2	5
4808	2004-02-22	"Sun"	"Midday"	"178"	1	7	8	16
4807	2004-02-21	"Sat"	"Evening"	"152"	1	5	2	8
4806	2004-02-21	"Sat"	"Midday"	"046"	0	4	6	10
4805	2004-02-20	"Fri"	"Evening"	"417"	4	1	7	12
4804	2004-02-20	"Fri"	"Midday"	"730"	7	3	0	10
4803	2004-02-19	"Thu"	"Evening"	"433"	4	3	3	10
4802	2004-02-19	"Thu"	"Midday"	"999"	9	9	9	27
4801	2004-02-18	"Wed"	"Evening"	"844"	8	4	4	16
4800	2004-02-18	"Wed"	"Midday"	"985"	9	8	5	22
4799	2004-02-17	"Tue"	"Evening"	"340"	3	4	0	7
4798	2004-02-17	"Tue"	"Midday"	"126"	1	2	6	9
4797	2004-02-16	"Mon"	"Evening"	"232"	2	3	2	7
4796	2004-02-16	"Mon"	"Midday"	"497"	4	9	7	20
4795	2004-02-15	"Sun"	"Evening"	"660"	6	6	0	12
4794	2004-02-15	"Sun"	"Midday"	"384"	3	8	4	15
4793	2004-02-14	"Sat"	"Evening"	"022"	0	2	2	4
4792	2004-02-14	"Sat"	"Midday"	"864"	8	6	4	18
4791	2004-02-13	"Fri"	"Evening"	"750"	7	5	0	12
4790	2004-02-13	"Fri"	"Midday"	"897"	8	9	7	24
4789	2004-02-12	"Thu"	"Evening"	"358"	3	5	8	16
4788	2004-02-12	"Thu"	"Midday"	"910"	9	1	0	10
4787	2004-02-11	"Wed"	"Evening"	"779"	7	7	9	23
4786	2004-02-11	"Wed"	"Midday"	"246"	2	4	6	12
4785	2004-02-10	"Tue"	"Evening"	"461"	4	6	1	11
4784	2004-02-10	"Tue"	"Midday"	"981"	9	8	1	18
4783	2004-02-09	"Mon"	"Evening"	"444"	4	4	4	12
4782	2004-02-09	"Mon"	"Midday"	"458"	4	5	8	17
4781	2004-02-08	"Sun"	"Evening"	"145"	1	4	5	10
4780	2004-02-08	"Sun"	"Midday"	"884"	8	8	4	20
4779	2004-02-07	"Sat"	"Evening"	"194"	1	9	4	14
4778	2004-02-07	"Sat"	"Midday"	"409"	4	0	9	13
4777	2004-02-06	"Fri"	"Evening"	"846"	8	4	6	18
4776	2004-02-06	"Fri"	"Midday"	"687"	6	8	7	21
4775	2004-02-05	"Thu"	"Evening"	"902"	9	0	2	11
4774	2004-02-05	"Thu"	"Midday"	"255"	2	5	5	12
4773	2004-02-04	"Wed"	"Evening"	"879"	8	7	9	24
4772	2004-02-04	"Wed"	"Midday"	"847"	8	4	7	19
4771	2004-02-03	"Tue"	"Evening"	"299"	2	9	9	20
4770	2004-02-03	"Tue"	"Midday"	"980"	9	8	0	17
4769	2004-02-02	"Mon"	"Evening"	"365"	3	6	5	14
4768	2004-02-02	"Mon"	"Midday"	"826"	8	2	6	16
4767	2004-02-01	"Sun"	"Evening"	"451"	4	5	1	10
4766	2004-02-01	"Sun"	"Midday"	"310"	3	1	0	4
4765	2004-01-31	"Sat"	"Evening"	"873"	8	7	3	18
4764	2004-01-31	"Sat"	"Midday"	"898"	8	9	8	25
4763	2004-01-30	"Fri"	"Evening"	"956"	9	5	6	20
4762	2004-01-30	"Fri"	"Midday"	"692"	6	9	2	17
4761	2004-01-29	"Thu"	"Evening"	"307"	3	0	7	10
4760	2004-01-29	"Thu"	"Midday"	"860"	8	6	0	14
4759	2004-01-28	"Wed"	"Evening"	"751"	7	5	1	13
4758	2004-01-28	"Wed"	"Midday"	"950"	9	5	0	14
4757	2004-01-27	"Tue"	"Evening"	"591"	5	9	1	15
4756	2004-01-27	"Tue"	"Midday"	"420"	4	2	0	6
4755	2004-01-26	"Mon"	"Evening"	"602"	6	0	2	8
4754	2004-01-26	"Mon"	"Midday"	"339"	3	3	9	15
4753	2004-01-25	"Sun"	"Evening"	"411"	4	1	1	6
4752	2004-01-25	"Sun"	"Midday"	"232"	2	3	2	7
4751	2004-01-24	"Sat"	"Evening"	"298"	2	9	8	19
4750	2004-01-24	"Sat"	"Midday"	"137"	1	3	7	11
4749	2004-01-23	"Fri"	"Evening"	"775"	7	7	5	19
4748	2004-01-23	"Fri"	"Midday"	"947"	9	4	7	20
4747	2004-01-22	"Thu"	"Evening"	"053"	0	5	3	8
4746	2004-01-22	"Thu"	"Midday"	"522"	5	2	2	9
4745	2004-01-21	"Wed"	"Evening"	"301"	3	0	1	4
4744	2004-01-21	"Wed"	"Midday"	"527"	5	2	7	14
4743	2004-01-20	"Tue"	"Evening"	"390"	3	9	0	12
4742	2004-01-20	"Tue"	"Midday"	"474"	4	7	4	15
4741	2004-01-19	"Mon"	"Evening"	"711"	7	1	1	9
4740	2004-01-19	"Mon"	"Midday"	"689"	6	8	9	23
4739	2004-01-18	"Sun"	"Evening"	"482"	4	8	2	14
4738	2004-01-18	"Sun"	"Midday"	"116"	1	1	6	8
4737	2004-01-17	"Sat"	"Evening"	"613"	6	1	3	10
4736	2004-01-17	"Sat"	"Midday"	"978"	9	7	8	24
4735	2004-01-16	"Fri"	"Evening"	"967"	9	6	7	22
4734	2004-01-16	"Fri"	"Midday"	"462"	4	6	2	12
4733	2004-01-15	"Thu"	"Evening"	"219"	2	1	9	12
4732	2004-01-15	"Thu"	"Midday"	"575"	5	7	5	17
4731	2004-01-14	"Wed"	"Evening"	"447"	4	4	7	15
4730	2004-01-14	"Wed"	"Midday"	"518"	5	1	8	14
4729	2004-01-13	"Tue"	"Evening"	"425"	4	2	5	11
4728	2004-01-13	"Tue"	"Midday"	"917"	9	1	7	17
4727	2004-01-12	"Mon"	"Evening"	"535"	5	3	5	13
4726	2004-01-12	"Mon"	"Midday"	"452"	4	5	2	11
4725	2004-01-11	"Sun"	"Evening"	"390"	3	9	0	12
4724	2004-01-11	"Sun"	"Midday"	"373"	3	7	3	13
4723	2004-01-10	"Sat"	"Evening"	"128"	1	2	8	11
4722	2004-01-10	"Sat"	"Midday"	"883"	8	8	3	19
4721	2004-01-09	"Fri"	"Evening"	"338"	3	3	8	14
4720	2004-01-09	"Fri"	"Midday"	"094"	0	9	4	13
4719	2004-01-08	"Thu"	"Evening"	"036"	0	3	6	9
4718	2004-01-08	"Thu"	"Midday"	"421"	4	2	1	7
4717	2004-01-07	"Wed"	"Evening"	"263"	2	6	3	11
4716	2004-01-07	"Wed"	"Midday"	"933"	9	3	3	15
4715	2004-01-06	"Tue"	"Evening"	"928"	9	2	8	19
4714	2004-01-06	"Tue"	"Midday"	"989"	9	8	9	26
4713	2004-01-05	"Mon"	"Evening"	"721"	7	2	1	10
4712	2004-01-05	"Mon"	"Midday"	"847"	8	4	7	19
4711	2004-01-04	"Sun"	"Evening"	"482"	4	8	2	14
4710	2004-01-04	"Sun"	"Midday"	"371"	3	7	1	11
4709	2004-01-03	"Sat"	"Evening"	"634"	6	3	4	13
4708	2004-01-03	"Sat"	"Midday"	"452"	4	5	2	11
4707	2004-01-02	"Fri"	"Evening"	"477"	4	7	7	18
4706	2004-01-02	"Fri"	"Midday"	"944"	9	4	4	17
4705	2004-01-01	"Thu"	"Evening"	"888"	8	8	8	24
4704	2004-01-01	"Thu"	"Midday"	"994"	9	9	4	22
4703	2003-12-31	"Wed"	"Evening"	"521"	5	2	1	8
4702	2003-12-31	"Wed"	"Midday"	"773"	7	7	3	17
4701	2003-12-30	"Tue"	"Evening"	"630"	6	3	0	9
4700	2003-12-30	"Tue"	"Midday"	"161"	1	6	1	8
4699	2003-12-29	"Mon"	"Evening"	"076"	0	7	6	13
4698	2003-12-29	"Mon"	"Midday"	"929"	9	2	9	20
4697	2003-12-28	"Sun"	"Evening"	"028"	0	2	8	10
4696	2003-12-28	"Sun"	"Midday"	"316"	3	1	6	10
4695	2003-12-27	"Sat"	"Evening"	"344"	3	4	4	11
4694	2003-12-27	"Sat"	"Midday"	"456"	4	5	6	15
4693	2003-12-26	"Fri"	"Evening"	"797"	7	9	7	23
4692	2003-12-26	"Fri"	"Midday"	"885"	8	8	5	21
4691	2003-12-25	"Thu"	"Evening"	"494"	4	9	4	17
4690	2003-12-25	"Thu"	"Midday"	"210"	2	1	0	3
4689	2003-12-24	"Wed"	"Evening"	"745"	7	4	5	16
4688	2003-12-24	"Wed"	"Midday"	"729"	7	2	9	18
4687	2003-12-23	"Tue"	"Evening"	"192"	1	9	2	12
4686	2003-12-23	"Tue"	"Midday"	"180"	1	8	0	9
4685	2003-12-22	"Mon"	"Evening"	"939"	9	3	9	21
4684	2003-12-22	"Mon"	"Midday"	"355"	3	5	5	13
4683	2003-12-21	"Sun"	"Evening"	"411"	4	1	1	6
4682	2003-12-21	"Sun"	"Midday"	"691"	6	9	1	16
4681	2003-12-20	"Sat"	"Evening"	"246"	2	4	6	12
4680	2003-12-20	"Sat"	"Midday"	"239"	2	3	9	14
4679	2003-12-19	"Fri"	"Evening"	"860"	8	6	0	14
4678	2003-12-19	"Fri"	"Midday"	"901"	9	0	1	10
4677	2003-12-18	"Thu"	"Evening"	"332"	3	3	2	8
4676	2003-12-18	"Thu"	"Midday"	"346"	3	4	6	13
4675	2003-12-17	"Wed"	"Evening"	"397"	3	9	7	19
4674	2003-12-17	"Wed"	"Midday"	"086"	0	8	6	14
4673	2003-12-16	"Tue"	"Evening"	"815"	8	1	5	14
4672	2003-12-16	"Tue"	"Midday"	"962"	9	6	2	17
4671	2003-12-15	"Mon"	"Evening"	"071"	0	7	1	8
4670	2003-12-15	"Mon"	"Midday"	"471"	4	7	1	12
4669	2003-12-14	"Sun"	"Evening"	"854"	8	5	4	17
4668	2003-12-14	"Sun"	"Midday"	"983"	9	8	3	20
4667	2003-12-13	"Sat"	"Evening"	"040"	0	4	0	4
4666	2003-12-13	"Sat"	"Midday"	"836"	8	3	6	17
4665	2003-12-12	"Fri"	"Evening"	"629"	6	2	9	17
4664	2003-12-12	"Fri"	"Midday"	"049"	0	4	9	13
4663	2003-12-11	"Thu"	"Evening"	"653"	6	5	3	14
4662	2003-12-11	"Thu"	"Midday"	"992"	9	9	2	20
4661	2003-12-10	"Wed"	"Evening"	"724"	7	2	4	13
4660	2003-12-10	"Wed"	"Midday"	"780"	7	8	0	15
4659	2003-12-09	"Tue"	"Evening"	"787"	7	8	7	22
4658	2003-12-09	"Tue"	"Midday"	"548"	5	4	8	17
4657	2003-12-08	"Mon"	"Evening"	"335"	3	3	5	11
4656	2003-12-08	"Mon"	"Midday"	"536"	5	3	6	14
4655	2003-12-07	"Sun"	"Evening"	"358"	3	5	8	16
4654	2003-12-07	"Sun"	"Midday"	"877"	8	7	7	22
4653	2003-12-06	"Sat"	"Evening"	"039"	0	3	9	12
4652	2003-12-06	"Sat"	"Midday"	"100"	1	0	0	1
4651	2003-12-05	"Fri"	"Evening"	"756"	7	5	6	18
4650	2003-12-05	"Fri"	"Midday"	"748"	7	4	8	19
4649	2003-12-04	"Thu"	"Evening"	"815"	8	1	5	14
4648	2003-12-04	"Thu"	"Midday"	"946"	9	4	6	19
4647	2003-12-03	"Wed"	"Evening"	"574"	5	7	4	16
4646	2003-12-03	"Wed"	"Midday"	"120"	1	2	0	3
4645	2003-12-02	"Tue"	"Evening"	"747"	7	4	7	18
4644	2003-12-02	"Tue"	"Midday"	"117"	1	1	7	9
4643	2003-12-01	"Mon"	"Evening"	"722"	7	2	2	11
4642	2003-12-01	"Mon"	"Midday"	"271"	2	7	1	10
4641	2003-11-30	"Sun"	"Evening"	"882"	8	8	2	18
4640	2003-11-30	"Sun"	"Midday"	"216"	2	1	6	9
4639	2003-11-29	"Sat"	"Evening"	"902"	9	0	2	11
4638	2003-11-29	"Sat"	"Midday"	"929"	9	2	9	20
4637	2003-11-28	"Fri"	"Evening"	"065"	0	6	5	11
4636	2003-11-28	"Fri"	"Midday"	"375"	3	7	5	15
4635	2003-11-27	"Thu"	"Evening"	"246"	2	4	6	12
4634	2003-11-27	"Thu"	"Midday"	"413"	4	1	3	8
4633	2003-11-26	"Wed"	"Evening"	"421"	4	2	1	7
4632	2003-11-26	"Wed"	"Midday"	"684"	6	8	4	18
4631	2003-11-25	"Tue"	"Evening"	"817"	8	1	7	16
4630	2003-11-25	"Tue"	"Midday"	"672"	6	7	2	15
4629	2003-11-24	"Mon"	"Evening"	"389"	3	8	9	20
4628	2003-11-24	"Mon"	"Midday"	"010"	0	1	0	1
4627	2003-11-23	"Sun"	"Evening"	"274"	2	7	4	13
4626	2003-11-23	"Sun"	"Midday"	"979"	9	7	9	25
4625	2003-11-22	"Sat"	"Evening"	"412"	4	1	2	7
4624	2003-11-22	"Sat"	"Midday"	"604"	6	0	4	10
4623	2003-11-21	"Fri"	"Evening"	"863"	8	6	3	17
4622	2003-11-21	"Fri"	"Midday"	"108"	1	0	8	9
4621	2003-11-20	"Thu"	"Evening"	"064"	0	6	4	10
4620	2003-11-20	"Thu"	"Midday"	"888"	8	8	8	24
4619	2003-11-19	"Wed"	"Evening"	"587"	5	8	7	20
4618	2003-11-19	"Wed"	"Midday"	"027"	0	2	7	9
4617	2003-11-18	"Tue"	"Evening"	"970"	9	7	0	16
4616	2003-11-18	"Tue"	"Midday"	"601"	6	0	1	7
4615	2003-11-17	"Mon"	"Evening"	"943"	9	4	3	16
4614	2003-11-17	"Mon"	"Midday"	"627"	6	2	7	15
4613	2003-11-16	"Sun"	"Evening"	"895"	8	9	5	22
4612	2003-11-16	"Sun"	"Midday"	"388"	3	8	8	19
4611	2003-11-15	"Sat"	"Evening"	"732"	7	3	2	12
4610	2003-11-15	"Sat"	"Midday"	"428"	4	2	8	14
4609	2003-11-14	"Fri"	"Evening"	"984"	9	8	4	21
4608	2003-11-14	"Fri"	"Midday"	"524"	5	2	4	11
4607	2003-11-13	"Thu"	"Evening"	"609"	6	0	9	15
4606	2003-11-13	"Thu"	"Midday"	"909"	9	0	9	18
4605	2003-11-12	"Wed"	"Evening"	"543"	5	4	3	12
4604	2003-11-12	"Wed"	"Midday"	"075"	0	7	5	12
4603	2003-11-11	"Tue"	"Evening"	"514"	5	1	4	10
4602	2003-11-11	"Tue"	"Midday"	"086"	0	8	6	14
4601	2003-11-10	"Mon"	"Evening"	"673"	6	7	3	16
4600	2003-11-10	"Mon"	"Midday"	"916"	9	1	6	16
4599	2003-11-09	"Sun"	"Evening"	"242"	2	4	2	8
4598	2003-11-09	"Sun"	"Midday"	"672"	6	7	2	15
4597	2003-11-08	"Sat"	"Evening"	"717"	7	1	7	15
4596	2003-11-08	"Sat"	"Midday"	"469"	4	6	9	19
4595	2003-11-07	"Fri"	"Evening"	"131"	1	3	1	5
4594	2003-11-07	"Fri"	"Midday"	"630"	6	3	0	9
4593	2003-11-06	"Thu"	"Evening"	"667"	6	6	7	19
4592	2003-11-06	"Thu"	"Midday"	"355"	3	5	5	13
4591	2003-11-05	"Wed"	"Evening"	"910"	9	1	0	10
4590	2003-11-05	"Wed"	"Midday"	"966"	9	6	6	21
4589	2003-11-04	"Tue"	"Evening"	"589"	5	8	9	22
4588	2003-11-04	"Tue"	"Midday"	"767"	7	6	7	20
4587	2003-11-03	"Mon"	"Evening"	"890"	8	9	0	17
4586	2003-11-03	"Mon"	"Midday"	"724"	7	2	4	13
4585	2003-11-02	"Sun"	"Evening"	"390"	3	9	0	12
4584	2003-11-02	"Sun"	"Midday"	"064"	0	6	4	10
4583	2003-11-01	"Sat"	"Evening"	"951"	9	5	1	15
4582	2003-11-01	"Sat"	"Midday"	"154"	1	5	4	10
4581	2003-10-31	"Fri"	"Evening"	"445"	4	4	5	13
4580	2003-10-31	"Fri"	"Midday"	"741"	7	4	1	12
4579	2003-10-30	"Thu"	"Evening"	"897"	8	9	7	24
4578	2003-10-30	"Thu"	"Midday"	"109"	1	0	9	10
4577	2003-10-29	"Wed"	"Evening"	"305"	3	0	5	8
4576	2003-10-29	"Wed"	"Midday"	"567"	5	6	7	18
4575	2003-10-28	"Tue"	"Evening"	"859"	8	5	9	22
4574	2003-10-28	"Tue"	"Midday"	"922"	9	2	2	13
4573	2003-10-27	"Mon"	"Evening"	"100"	1	0	0	1
4572	2003-10-27	"Mon"	"Midday"	"337"	3	3	7	13
4571	2003-10-26	"Sun"	"Evening"	"367"	3	6	7	16
4570	2003-10-26	"Sun"	"Midday"	"367"	3	6	7	16
4569	2003-10-25	"Sat"	"Evening"	"078"	0	7	8	15
4568	2003-10-25	"Sat"	"Midday"	"213"	2	1	3	6
4567	2003-10-24	"Fri"	"Evening"	"120"	1	2	0	3
4566	2003-10-24	"Fri"	"Midday"	"996"	9	9	6	24
4565	2003-10-23	"Thu"	"Evening"	"302"	3	0	2	5
4564	2003-10-23	"Thu"	"Midday"	"068"	0	6	8	14
4563	2003-10-22	"Wed"	"Evening"	"198"	1	9	8	18
4562	2003-10-22	"Wed"	"Midday"	"691"	6	9	1	16
4561	2003-10-21	"Tue"	"Evening"	"339"	3	3	9	15
4560	2003-10-21	"Tue"	"Midday"	"444"	4	4	4	12
4559	2003-10-20	"Mon"	"Evening"	"840"	8	4	0	12
4558	2003-10-20	"Mon"	"Midday"	"654"	6	5	4	15
4557	2003-10-19	"Sun"	"Evening"	"769"	7	6	9	22
4556	2003-10-19	"Sun"	"Midday"	"516"	5	1	6	12
4555	2003-10-18	"Sat"	"Evening"	"071"	0	7	1	8
4554	2003-10-18	"Sat"	"Midday"	"791"	7	9	1	17
4553	2003-10-17	"Fri"	"Evening"	"851"	8	5	1	14
4552	2003-10-17	"Fri"	"Midday"	"250"	2	5	0	7
4551	2003-10-16	"Thu"	"Evening"	"745"	7	4	5	16
4550	2003-10-16	"Thu"	"Midday"	"986"	9	8	6	23
4549	2003-10-15	"Wed"	"Evening"	"229"	2	2	9	13
4548	2003-10-15	"Wed"	"Midday"	"380"	3	8	0	11
4547	2003-10-14	"Tue"	"Evening"	"196"	1	9	6	16
4546	2003-10-14	"Tue"	"Midday"	"287"	2	8	7	17
4545	2003-10-13	"Mon"	"Evening"	"564"	5	6	4	15
4544	2003-10-13	"Mon"	"Midday"	"136"	1	3	6	10
4543	2003-10-12	"Sun"	"Evening"	"531"	5	3	1	9
4542	2003-10-12	"Sun"	"Midday"	"258"	2	5	8	15
4541	2003-10-11	"Sat"	"Evening"	"102"	1	0	2	3
4540	2003-10-11	"Sat"	"Midday"	"281"	2	8	1	11
4539	2003-10-10	"Fri"	"Evening"	"864"	8	6	4	18
4538	2003-10-10	"Fri"	"Midday"	"397"	3	9	7	19
4537	2003-10-09	"Thu"	"Evening"	"130"	1	3	0	4
4536	2003-10-09	"Thu"	"Midday"	"902"	9	0	2	11
4535	2003-10-08	"Wed"	"Evening"	"475"	4	7	5	16
4534	2003-10-08	"Wed"	"Midday"	"957"	9	5	7	21
4533	2003-10-07	"Tue"	"Evening"	"880"	8	8	0	16
4532	2003-10-07	"Tue"	"Midday"	"198"	1	9	8	18
4531	2003-10-06	"Mon"	"Evening"	"847"	8	4	7	19
4530	2003-10-06	"Mon"	"Midday"	"466"	4	6	6	16
4529	2003-10-05	"Sun"	"Evening"	"962"	9	6	2	17
4528	2003-10-05	"Sun"	"Midday"	"331"	3	3	1	7
4527	2003-10-04	"Sat"	"Evening"	"964"	9	6	4	19
4526	2003-10-04	"Sat"	"Midday"	"191"	1	9	1	11
4525	2003-10-03	"Fri"	"Evening"	"668"	6	6	8	20
4524	2003-10-03	"Fri"	"Midday"	"060"	0	6	0	6
4523	2003-10-02	"Thu"	"Evening"	"950"	9	5	0	14
4522	2003-10-02	"Thu"	"Midday"	"861"	8	6	1	15
4521	2003-10-01	"Wed"	"Evening"	"925"	9	2	5	16
4520	2003-10-01	"Wed"	"Midday"	"000"	0	0	0	0
4519	2003-09-30	"Tue"	"Evening"	"765"	7	6	5	18
4518	2003-09-30	"Tue"	"Midday"	"484"	4	8	4	16
4517	2003-09-29	"Mon"	"Evening"	"805"	8	0	5	13
4516	2003-09-29	"Mon"	"Midday"	"588"	5	8	8	21
4515	2003-09-28	"Sun"	"Evening"	"334"	3	3	4	10
4514	2003-09-28	"Sun"	"Midday"	"759"	7	5	9	21
4513	2003-09-27	"Sat"	"Evening"	"712"	7	1	2	10
4512	2003-09-27	"Sat"	"Midday"	"508"	5	0	8	13
4511	2003-09-26	"Fri"	"Evening"	"954"	9	5	4	18
4510	2003-09-26	"Fri"	"Midday"	"439"	4	3	9	16
4509	2003-09-25	"Thu"	"Evening"	"589"	5	8	9	22
4508	2003-09-25	"Thu"	"Midday"	"355"	3	5	5	13
4507	2003-09-24	"Wed"	"Evening"	"384"	3	8	4	15
4506	2003-09-24	"Wed"	"Midday"	"176"	1	7	6	14
4505	2003-09-23	"Tue"	"Evening"	"608"	6	0	8	14
4504	2003-09-23	"Tue"	"Midday"	"234"	2	3	4	9
4503	2003-09-22	"Mon"	"Evening"	"697"	6	9	7	22
4502	2003-09-22	"Mon"	"Midday"	"644"	6	4	4	14
4501	2003-09-21	"Sun"	"Evening"	"075"	0	7	5	12
4500	2003-09-21	"Sun"	"Midday"	"241"	2	4	1	7
4499	2003-09-20	"Sat"	"Evening"	"503"	5	0	3	8
4498	2003-09-20	"Sat"	"Midday"	"794"	7	9	4	20
4497	2003-09-19	"Fri"	"Evening"	"324"	3	2	4	9
4496	2003-09-19	"Fri"	"Midday"	"354"	3	5	4	12
4495	2003-09-18	"Thu"	"Evening"	"513"	5	1	3	9
4494	2003-09-18	"Thu"	"Midday"	"729"	7	2	9	18
4493	2003-09-17	"Wed"	"Evening"	"489"	4	8	9	21
4492	2003-09-17	"Wed"	"Midday"	"344"	3	4	4	11
4491	2003-09-16	"Tue"	"Evening"	"419"	4	1	9	14
4490	2003-09-16	"Tue"	"Midday"	"070"	0	7	0	7
4489	2003-09-15	"Mon"	"Evening"	"939"	9	3	9	21
4488	2003-09-15	"Mon"	"Midday"	"324"	3	2	4	9
4487	2003-09-14	"Sun"	"Evening"	"003"	0	0	3	3
4486	2003-09-14	"Sun"	"Midday"	"413"	4	1	3	8
4485	2003-09-13	"Sat"	"Evening"	"432"	4	3	2	9
4484	2003-09-13	"Sat"	"Midday"	"740"	7	4	0	11
4483	2003-09-12	"Fri"	"Evening"	"522"	5	2	2	9
4482	2003-09-12	"Fri"	"Midday"	"010"	0	1	0	1
4481	2003-09-11	"Thu"	"Evening"	"792"	7	9	2	18
4480	2003-09-11	"Thu"	"Midday"	"727"	7	2	7	16
4479	2003-09-10	"Wed"	"Evening"	"046"	0	4	6	10
4478	2003-09-10	"Wed"	"Midday"	"118"	1	1	8	10
4477	2003-09-09	"Tue"	"Evening"	"337"	3	3	7	13
4476	2003-09-09	"Tue"	"Midday"	"549"	5	4	9	18
4475	2003-09-08	"Mon"	"Evening"	"479"	4	7	9	20
4474	2003-09-08	"Mon"	"Midday"	"942"	9	4	2	15
4473	2003-09-07	"Sun"	"Evening"	"800"	8	0	0	8
4472	2003-09-07	"Sun"	"Midday"	"444"	4	4	4	12
4471	2003-09-06	"Sat"	"Evening"	"357"	3	5	7	15
4470	2003-09-06	"Sat"	"Midday"	"497"	4	9	7	20
4469	2003-09-05	"Fri"	"Evening"	"374"	3	7	4	14
4468	2003-09-05	"Fri"	"Midday"	"283"	2	8	3	13
4467	2003-09-04	"Thu"	"Evening"	"872"	8	7	2	17
4466	2003-09-04	"Thu"	"Midday"	"702"	7	0	2	9
4465	2003-09-03	"Wed"	"Evening"	"644"	6	4	4	14
4464	2003-09-03	"Wed"	"Midday"	"641"	6	4	1	11
4463	2003-09-02	"Tue"	"Evening"	"948"	9	4	8	21
4462	2003-09-02	"Tue"	"Midday"	"949"	9	4	9	22
4461	2003-09-01	"Mon"	"Evening"	"279"	2	7	9	18
4460	2003-09-01	"Mon"	"Midday"	"078"	0	7	8	15
4459	2003-08-31	"Sun"	"Evening"	"904"	9	0	4	13
4458	2003-08-31	"Sun"	"Midday"	"019"	0	1	9	10
4457	2003-08-30	"Sat"	"Evening"	"447"	4	4	7	15
4456	2003-08-30	"Sat"	"Midday"	"191"	1	9	1	11
4455	2003-08-29	"Fri"	"Evening"	"562"	5	6	2	13
4454	2003-08-29	"Fri"	"Midday"	"193"	1	9	3	13
4453	2003-08-28	"Thu"	"Evening"	"860"	8	6	0	14
4452	2003-08-28	"Thu"	"Midday"	"033"	0	3	3	6
4451	2003-08-27	"Wed"	"Evening"	"818"	8	1	8	17
4450	2003-08-27	"Wed"	"Midday"	"448"	4	4	8	16
4449	2003-08-26	"Tue"	"Evening"	"670"	6	7	0	13
4448	2003-08-26	"Tue"	"Midday"	"724"	7	2	4	13
4447	2003-08-25	"Mon"	"Evening"	"895"	8	9	5	22
4446	2003-08-25	"Mon"	"Midday"	"646"	6	4	6	16
4445	2003-08-24	"Sun"	"Evening"	"097"	0	9	7	16
4444	2003-08-24	"Sun"	"Midday"	"335"	3	3	5	11
4443	2003-08-23	"Sat"	"Evening"	"091"	0	9	1	10
4442	2003-08-23	"Sat"	"Midday"	"150"	1	5	0	6
4441	2003-08-22	"Fri"	"Evening"	"187"	1	8	7	16
4440	2003-08-22	"Fri"	"Midday"	"982"	9	8	2	19
4439	2003-08-21	"Thu"	"Evening"	"996"	9	9	6	24
4438	2003-08-21	"Thu"	"Midday"	"127"	1	2	7	10
4437	2003-08-20	"Wed"	"Evening"	"376"	3	7	6	16
4436	2003-08-20	"Wed"	"Midday"	"403"	4	0	3	7
4435	2003-08-19	"Tue"	"Evening"	"028"	0	2	8	10
4434	2003-08-19	"Tue"	"Midday"	"721"	7	2	1	10
4433	2003-08-18	"Mon"	"Evening"	"979"	9	7	9	25
4432	2003-08-18	"Mon"	"Midday"	"836"	8	3	6	17
4431	2003-08-17	"Sun"	"Evening"	"500"	5	0	0	5
4430	2003-08-17	"Sun"	"Midday"	"978"	9	7	8	24
4429	2003-08-16	"Sat"	"Evening"	"209"	2	0	9	11
4428	2003-08-16	"Sat"	"Midday"	"607"	6	0	7	13
4427	2003-08-15	"Fri"	"Evening"	"269"	2	6	9	17
4426	2003-08-15	"Fri"	"Midday"	"014"	0	1	4	5
4425	2003-08-14	"Thu"	"Evening"	"583"	5	8	3	16
4424	2003-08-14	"Thu"	"Midday"	"133"	1	3	3	7
4423	2003-08-13	"Wed"	"Evening"	"229"	2	2	9	13
4422	2003-08-13	"Wed"	"Midday"	"777"	7	7	7	21
4421	2003-08-12	"Tue"	"Evening"	"763"	7	6	3	16
4420	2003-08-12	"Tue"	"Midday"	"453"	4	5	3	12
4419	2003-08-11	"Mon"	"Evening"	"031"	0	3	1	4
4418	2003-08-11	"Mon"	"Midday"	"327"	3	2	7	12
4417	2003-08-10	"Sun"	"Evening"	"388"	3	8	8	19
4416	2003-08-10	"Sun"	"Midday"	"707"	7	0	7	14
4415	2003-08-09	"Sat"	"Evening"	"086"	0	8	6	14
4414	2003-08-09	"Sat"	"Midday"	"127"	1	2	7	10
4413	2003-08-08	"Fri"	"Evening"	"576"	5	7	6	18
4412	2003-08-08	"Fri"	"Midday"	"924"	9	2	4	15
4411	2003-08-07	"Thu"	"Evening"	"487"	4	8	7	19
4410	2003-08-07	"Thu"	"Midday"	"325"	3	2	5	10
4409	2003-08-06	"Wed"	"Evening"	"600"	6	0	0	6
4408	2003-08-06	"Wed"	"Midday"	"687"	6	8	7	21
4407	2003-08-05	"Tue"	"Evening"	"226"	2	2	6	10
4406	2003-08-05	"Tue"	"Midday"	"987"	9	8	7	24
4405	2003-08-04	"Mon"	"Evening"	"562"	5	6	2	13
4404	2003-08-04	"Mon"	"Midday"	"203"	2	0	3	5
4403	2003-08-03	"Sun"	"Evening"	"300"	3	0	0	3
4402	2003-08-03	"Sun"	"Midday"	"466"	4	6	6	16
4401	2003-08-02	"Sat"	"Evening"	"012"	0	1	2	3
4400	2003-08-02	"Sat"	"Midday"	"988"	9	8	8	25
4399	2003-08-01	"Fri"	"Evening"	"058"	0	5	8	13
4398	2003-08-01	"Fri"	"Midday"	"605"	6	0	5	11
4397	2003-07-31	"Thu"	"Evening"	"079"	0	7	9	16
4396	2003-07-31	"Thu"	"Midday"	"138"	1	3	8	12
4395	2003-07-30	"Wed"	"Evening"	"437"	4	3	7	14
4394	2003-07-30	"Wed"	"Midday"	"968"	9	6	8	23
4393	2003-07-29	"Tue"	"Evening"	"390"	3	9	0	12
4392	2003-07-29	"Tue"	"Midday"	"554"	5	5	4	14
4391	2003-07-28	"Mon"	"Evening"	"984"	9	8	4	21
4390	2003-07-28	"Mon"	"Midday"	"097"	0	9	7	16
4389	2003-07-27	"Sun"	"Evening"	"380"	3	8	0	11
4388	2003-07-27	"Sun"	"Midday"	"618"	6	1	8	15
4387	2003-07-26	"Sat"	"Evening"	"443"	4	4	3	11
4386	2003-07-26	"Sat"	"Midday"	"891"	8	9	1	18
4385	2003-07-25	"Fri"	"Evening"	"481"	4	8	1	13
4384	2003-07-25	"Fri"	"Midday"	"043"	0	4	3	7
4383	2003-07-24	"Thu"	"Evening"	"025"	0	2	5	7
4381	2003-07-23	"Wed"	"Evening"	"748"	7	4	8	19
4380	2003-07-23	"Wed"	"Midday"	"162"	1	6	2	9
4379	2003-07-22	"Tue"	"Evening"	"188"	1	8	8	17
4378	2003-07-22	"Tue"	"Midday"	"703"	7	0	3	10
4377	2003-07-21	"Mon"	"Evening"	"281"	2	8	1	11
4376	2003-07-21	"Mon"	"Midday"	"965"	9	6	5	20
4375	2003-07-20	"Sun"	"Evening"	"932"	9	3	2	14
4374	2003-07-20	"Sun"	"Midday"	"219"	2	1	9	12
4373	2003-07-19	"Sat"	"Evening"	"100"	1	0	0	1
4372	2003-07-19	"Sat"	"Midday"	"147"	1	4	7	12
4371	2003-07-18	"Fri"	"Evening"	"547"	5	4	7	16
4370	2003-07-18	"Fri"	"Midday"	"085"	0	8	5	13
4369	2003-07-17	"Thu"	"Evening"	"878"	8	7	8	23
4368	2003-07-17	"Thu"	"Midday"	"306"	3	0	6	9
4367	2003-07-16	"Wed"	"Evening"	"798"	7	9	8	24
4366	2003-07-16	"Wed"	"Midday"	"080"	0	8	0	8
4365	2003-07-15	"Tue"	"Evening"	"200"	2	0	0	2
4364	2003-07-15	"Tue"	"Midday"	"327"	3	2	7	12
4363	2003-07-14	"Mon"	"Evening"	"655"	6	5	5	16
4362	2003-07-14	"Mon"	"Midday"	"092"	0	9	2	11
4361	2003-07-13	"Sun"	"Evening"	"409"	4	0	9	13
4360	2003-07-13	"Sun"	"Midday"	"792"	7	9	2	18
4359	2003-07-12	"Sat"	"Evening"	"687"	6	8	7	21
4358	2003-07-12	"Sat"	"Midday"	"607"	6	0	7	13
4357	2003-07-11	"Fri"	"Evening"	"372"	3	7	2	12
4356	2003-07-11	"Fri"	"Midday"	"648"	6	4	8	18
4355	2003-07-10	"Thu"	"Evening"	"873"	8	7	3	18
4354	2003-07-10	"Thu"	"Midday"	"901"	9	0	1	10
4353	2003-07-09	"Wed"	"Evening"	"614"	6	1	4	11
4352	2003-07-09	"Wed"	"Midday"	"753"	7	5	3	15
4351	2003-07-08	"Tue"	"Evening"	"524"	5	2	4	11
4350	2003-07-08	"Tue"	"Midday"	"479"	4	7	9	20
4349	2003-07-07	"Mon"	"Evening"	"780"	7	8	0	15
4348	2003-07-07	"Mon"	"Midday"	"576"	5	7	6	18
4347	2003-07-06	"Sun"	"Evening"	"477"	4	7	7	18
4346	2003-07-06	"Sun"	"Midday"	"078"	0	7	8	15
4345	2003-07-05	"Sat"	"Evening"	"142"	1	4	2	7
4344	2003-07-05	"Sat"	"Midday"	"328"	3	2	8	13
4343	2003-07-04	"Fri"	"Evening"	"317"	3	1	7	11
4342	2003-07-04	"Fri"	"Midday"	"654"	6	5	4	15
4341	2003-07-03	"Thu"	"Evening"	"050"	0	5	0	5
4340	2003-07-03	"Thu"	"Midday"	"629"	6	2	9	17
4339	2003-07-02	"Wed"	"Evening"	"447"	4	4	7	15
4338	2003-07-02	"Wed"	"Midday"	"339"	3	3	9	15
4337	2003-07-01	"Tue"	"Evening"	"015"	0	1	5	6
4336	2003-07-01	"Tue"	"Midday"	"417"	4	1	7	12
4335	2003-06-30	"Mon"	"Evening"	"328"	3	2	8	13
4334	2003-06-30	"Mon"	"Midday"	"798"	7	9	8	24
4333	2003-06-29	"Sun"	"Evening"	"606"	6	0	6	12
4332	2003-06-29	"Sun"	"Midday"	"931"	9	3	1	13
4331	2003-06-28	"Sat"	"Evening"	"422"	4	2	2	8
4330	2003-06-28	"Sat"	"Midday"	"148"	1	4	8	13
4329	2003-06-27	"Fri"	"Evening"	"248"	2	4	8	14
4328	2003-06-27	"Fri"	"Midday"	"682"	6	8	2	16
4327	2003-06-26	"Thu"	"Evening"	"458"	4	5	8	17
4326	2003-06-26	"Thu"	"Midday"	"821"	8	2	1	11
4325	2003-06-25	"Wed"	"Evening"	"034"	0	3	4	7
4324	2003-06-25	"Wed"	"Midday"	"428"	4	2	8	14
4323	2003-06-24	"Tue"	"Evening"	"601"	6	0	1	7
4322	2003-06-24	"Tue"	"Midday"	"827"	8	2	7	17
4321	2003-06-23	"Mon"	"Evening"	"315"	3	1	5	9
4320	2003-06-23	"Mon"	"Midday"	"432"	4	3	2	9
4319	2003-06-22	"Sun"	"Evening"	"246"	2	4	6	12
4318	2003-06-22	"Sun"	"Midday"	"392"	3	9	2	14
4317	2003-06-21	"Sat"	"Evening"	"144"	1	4	4	9
4316	2003-06-21	"Sat"	"Midday"	"548"	5	4	8	17
4315	2003-06-20	"Fri"	"Evening"	"107"	1	0	7	8
4314	2003-06-20	"Fri"	"Midday"	"487"	4	8	7	19
4313	2003-06-19	"Thu"	"Evening"	"901"	9	0	1	10
4312	2003-06-19	"Thu"	"Midday"	"658"	6	5	8	19
4311	2003-06-18	"Wed"	"Evening"	"167"	1	6	7	14
4310	2003-06-18	"Wed"	"Midday"	"580"	5	8	0	13
4309	2003-06-17	"Tue"	"Evening"	"348"	3	4	8	15
4308	2003-06-17	"Tue"	"Midday"	"325"	3	2	5	10
4307	2003-06-16	"Mon"	"Evening"	"333"	3	3	3	9
4306	2003-06-16	"Mon"	"Midday"	"857"	8	5	7	20
4305	2003-06-15	"Sun"	"Evening"	"317"	3	1	7	11
4304	2003-06-15	"Sun"	"Midday"	"580"	5	8	0	13
4303	2003-06-14	"Sat"	"Evening"	"372"	3	7	2	12
4302	2003-06-14	"Sat"	"Midday"	"270"	2	7	0	9
4301	2003-06-13	"Fri"	"Evening"	"930"	9	3	0	12
4300	2003-06-13	"Fri"	"Midday"	"493"	4	9	3	16
4299	2003-06-12	"Thu"	"Evening"	"952"	9	5	2	16
4298	2003-06-12	"Thu"	"Midday"	"670"	6	7	0	13
4297	2003-06-11	"Wed"	"Evening"	"959"	9	5	9	23
4296	2003-06-11	"Wed"	"Midday"	"197"	1	9	7	17
4295	2003-06-10	"Tue"	"Evening"	"312"	3	1	2	6
4294	2003-06-10	"Tue"	"Midday"	"941"	9	4	1	14
4293	2003-06-09	"Mon"	"Evening"	"462"	4	6	2	12
4292	2003-06-09	"Mon"	"Midday"	"935"	9	3	5	17
4291	2003-06-08	"Sun"	"Evening"	"456"	4	5	6	15
4290	2003-06-08	"Sun"	"Midday"	"086"	0	8	6	14
4289	2003-06-07	"Sat"	"Evening"	"156"	1	5	6	12
4288	2003-06-07	"Sat"	"Midday"	"477"	4	7	7	18
4287	2003-06-06	"Fri"	"Evening"	"763"	7	6	3	16
4286	2003-06-06	"Fri"	"Midday"	"140"	1	4	0	5
4285	2003-06-05	"Thu"	"Evening"	"034"	0	3	4	7
4284	2003-06-05	"Thu"	"Midday"	"927"	9	2	7	18
4283	2003-06-04	"Wed"	"Evening"	"060"	0	6	0	6
4282	2003-06-04	"Wed"	"Midday"	"285"	2	8	5	15
4281	2003-06-03	"Tue"	"Evening"	"436"	4	3	6	13
4280	2003-06-03	"Tue"	"Midday"	"212"	2	1	2	5
4279	2003-06-02	"Mon"	"Evening"	"817"	8	1	7	16
4278	2003-06-02	"Mon"	"Midday"	"816"	8	1	6	15
4277	2003-06-01	"Sun"	"Evening"	"144"	1	4	4	9
4276	2003-06-01	"Sun"	"Midday"	"358"	3	5	8	16
4275	2003-05-31	"Sat"	"Evening"	"673"	6	7	3	16
4274	2003-05-31	"Sat"	"Midday"	"951"	9	5	1	15
4273	2003-05-30	"Fri"	"Evening"	"234"	2	3	4	9
4272	2003-05-30	"Fri"	"Midday"	"485"	4	8	5	17
4271	2003-05-29	"Thu"	"Evening"	"142"	1	4	2	7
4270	2003-05-29	"Thu"	"Midday"	"559"	5	5	9	19
4269	2003-05-28	"Wed"	"Evening"	"944"	9	4	4	17
4268	2003-05-28	"Wed"	"Midday"	"334"	3	3	4	10
4267	2003-05-27	"Tue"	"Evening"	"335"	3	3	5	11
4266	2003-05-27	"Tue"	"Midday"	"688"	6	8	8	22
4265	2003-05-26	"Mon"	"Evening"	"135"	1	3	5	9
4264	2003-05-26	"Mon"	"Midday"	"640"	6	4	0	10
4263	2003-05-25	"Sun"	"Evening"	"894"	8	9	4	21
4262	2003-05-25	"Sun"	"Midday"	"070"	0	7	0	7
4261	2003-05-24	"Sat"	"Evening"	"350"	3	5	0	8
4260	2003-05-24	"Sat"	"Midday"	"201"	2	0	1	3
4259	2003-05-23	"Fri"	"Evening"	"097"	0	9	7	16
4258	2003-05-23	"Fri"	"Midday"	"499"	4	9	9	22
4257	2003-05-22	"Thu"	"Evening"	"046"	0	4	6	10
4256	2003-05-22	"Thu"	"Midday"	"789"	7	8	9	24
4255	2003-05-21	"Wed"	"Evening"	"387"	3	8	7	18
4254	2003-05-21	"Wed"	"Midday"	"640"	6	4	0	10
4253	2003-05-20	"Tue"	"Evening"	"968"	9	6	8	23
4252	2003-05-20	"Tue"	"Midday"	"212"	2	1	2	5
4251	2003-05-19	"Mon"	"Evening"	"469"	4	6	9	19
4250	2003-05-19	"Mon"	"Midday"	"402"	4	0	2	6
4249	2003-05-18	"Sun"	"Evening"	"268"	2	6	8	16
4248	2003-05-18	"Sun"	"Midday"	"186"	1	8	6	15
4247	2003-05-17	"Sat"	"Evening"	"085"	0	8	5	13
4246	2003-05-17	"Sat"	"Midday"	"555"	5	5	5	15
4245	2003-05-16	"Fri"	"Evening"	"061"	0	6	1	7
4244	2003-05-16	"Fri"	"Midday"	"342"	3	4	2	9
4243	2003-05-15	"Thu"	"Evening"	"367"	3	6	7	16
4242	2003-05-15	"Thu"	"Midday"	"263"	2	6	3	11
4241	2003-05-14	"Wed"	"Evening"	"614"	6	1	4	11
4240	2003-05-14	"Wed"	"Midday"	"804"	8	0	4	12
4239	2003-05-13	"Tue"	"Evening"	"202"	2	0	2	4
4238	2003-05-13	"Tue"	"Midday"	"108"	1	0	8	9
4237	2003-05-12	"Mon"	"Evening"	"113"	1	1	3	5
4236	2003-05-12	"Mon"	"Midday"	"103"	1	0	3	4
4235	2003-05-11	"Sun"	"Evening"	"588"	5	8	8	21
4234	2003-05-11	"Sun"	"Midday"	"529"	5	2	9	16
4233	2003-05-10	"Sat"	"Evening"	"607"	6	0	7	13
4232	2003-05-10	"Sat"	"Midday"	"950"	9	5	0	14
4231	2003-05-09	"Fri"	"Evening"	"106"	1	0	6	7
4230	2003-05-09	"Fri"	"Midday"	"489"	4	8	9	21
4229	2003-05-08	"Thu"	"Evening"	"780"	7	8	0	15
4228	2003-05-08	"Thu"	"Midday"	"340"	3	4	0	7
4227	2003-05-07	"Wed"	"Evening"	"466"	4	6	6	16
4226	2003-05-07	"Wed"	"Midday"	"764"	7	6	4	17
4225	2003-05-06	"Tue"	"Evening"	"279"	2	7	9	18
4224	2003-05-06	"Tue"	"Midday"	"423"	4	2	3	9
4223	2003-05-05	"Mon"	"Evening"	"046"	0	4	6	10
4222	2003-05-05	"Mon"	"Midday"	"298"	2	9	8	19
4221	2003-05-04	"Sun"	"Evening"	"487"	4	8	7	19
4220	2003-05-04	"Sun"	"Midday"	"720"	7	2	0	9
4219	2003-05-03	"Sat"	"Evening"	"360"	3	6	0	9
4218	2003-05-03	"Sat"	"Midday"	"360"	3	6	0	9
4217	2003-05-02	"Fri"	"Evening"	"570"	5	7	0	12
4216	2003-05-02	"Fri"	"Midday"	"070"	0	7	0	7
4215	2003-05-01	"Thu"	"Evening"	"648"	6	4	8	18
4214	2003-05-01	"Thu"	"Midday"	"820"	8	2	0	10
4213	2003-04-30	"Wed"	"Evening"	"189"	1	8	9	18
4212	2003-04-30	"Wed"	"Midday"	"071"	0	7	1	8
4211	2003-04-29	"Tue"	"Evening"	"901"	9	0	1	10
4210	2003-04-29	"Tue"	"Midday"	"749"	7	4	9	20
4209	2003-04-28	"Mon"	"Evening"	"122"	1	2	2	5
4208	2003-04-28	"Mon"	"Midday"	"760"	7	6	0	13
4207	2003-04-27	"Sun"	"Evening"	"597"	5	9	7	21
4206	2003-04-27	"Sun"	"Midday"	"439"	4	3	9	16
4205	2003-04-26	"Sat"	"Evening"	"947"	9	4	7	20
4204	2003-04-26	"Sat"	"Midday"	"802"	8	0	2	10
4203	2003-04-25	"Fri"	"Evening"	"655"	6	5	5	16
4202	2003-04-25	"Fri"	"Midday"	"615"	6	1	5	12
4201	2003-04-24	"Thu"	"Evening"	"791"	7	9	1	17
4200	2003-04-24	"Thu"	"Midday"	"788"	7	8	8	23
4199	2003-04-23	"Wed"	"Evening"	"732"	7	3	2	12
4198	2003-04-23	"Wed"	"Midday"	"190"	1	9	0	10
4197	2003-04-22	"Tue"	"Evening"	"135"	1	3	5	9
4196	2003-04-22	"Tue"	"Midday"	"035"	0	3	5	8
4195	2003-04-21	"Mon"	"Evening"	"745"	7	4	5	16
4194	2003-04-21	"Mon"	"Midday"	"342"	3	4	2	9
4193	2003-04-20	"Sun"	"Evening"	"109"	1	0	9	10
4192	2003-04-20	"Sun"	"Midday"	"188"	1	8	8	17
4191	2003-04-19	"Sat"	"Evening"	"368"	3	6	8	17
4190	2003-04-19	"Sat"	"Midday"	"697"	6	9	7	22
4189	2003-04-18	"Fri"	"Evening"	"024"	0	2	4	6
4188	2003-04-18	"Fri"	"Midday"	"670"	6	7	0	13
4187	2003-04-17	"Thu"	"Evening"	"436"	4	3	6	13
4186	2003-04-17	"Thu"	"Midday"	"834"	8	3	4	15
4185	2003-04-16	"Wed"	"Evening"	"018"	0	1	8	9
4184	2003-04-16	"Wed"	"Midday"	"244"	2	4	4	10
4183	2003-04-15	"Tue"	"Evening"	"266"	2	6	6	14
4182	2003-04-15	"Tue"	"Midday"	"522"	5	2	2	9
4181	2003-04-14	"Mon"	"Evening"	"389"	3	8	9	20
4180	2003-04-14	"Mon"	"Midday"	"761"	7	6	1	14
4179	2003-04-13	"Sun"	"Evening"	"917"	9	1	7	17
4178	2003-04-13	"Sun"	"Midday"	"300"	3	0	0	3
4177	2003-04-12	"Sat"	"Evening"	"131"	1	3	1	5
4176	2003-04-12	"Sat"	"Midday"	"537"	5	3	7	15
4175	2003-04-11	"Fri"	"Evening"	"861"	8	6	1	15
4174	2003-04-11	"Fri"	"Midday"	"992"	9	9	2	20
4173	2003-04-10	"Thu"	"Evening"	"541"	5	4	1	10
4172	2003-04-10	"Thu"	"Midday"	"292"	2	9	2	13
4171	2003-04-09	"Wed"	"Evening"	"624"	6	2	4	12
4170	2003-04-09	"Wed"	"Midday"	"847"	8	4	7	19
4169	2003-04-08	"Tue"	"Evening"	"225"	2	2	5	9
4168	2003-04-08	"Tue"	"Midday"	"960"	9	6	0	15
4167	2003-04-07	"Mon"	"Evening"	"285"	2	8	5	15
4166	2003-04-07	"Mon"	"Midday"	"831"	8	3	1	12
4165	2003-04-06	"Sun"	"Evening"	"279"	2	7	9	18
4164	2003-04-06	"Sun"	"Midday"	"287"	2	8	7	17
4163	2003-04-05	"Sat"	"Evening"	"673"	6	7	3	16
4162	2003-04-05	"Sat"	"Midday"	"245"	2	4	5	11
4161	2003-04-04	"Fri"	"Evening"	"436"	4	3	6	13
4160	2003-04-04	"Fri"	"Midday"	"169"	1	6	9	16
4159	2003-04-03	"Thu"	"Evening"	"291"	2	9	1	12
4158	2003-04-03	"Thu"	"Midday"	"929"	9	2	9	20
4157	2003-04-02	"Wed"	"Evening"	"475"	4	7	5	16
4156	2003-04-02	"Wed"	"Midday"	"631"	6	3	1	10
4155	2003-04-01	"Tue"	"Evening"	"073"	0	7	3	10
4154	2003-04-01	"Tue"	"Midday"	"698"	6	9	8	23
4153	2003-03-31	"Mon"	"Evening"	"605"	6	0	5	11
4152	2003-03-31	"Mon"	"Midday"	"931"	9	3	1	13
4151	2003-03-30	"Sun"	"Evening"	"776"	7	7	6	20
4150	2003-03-30	"Sun"	"Midday"	"680"	6	8	0	14
4149	2003-03-29	"Sat"	"Evening"	"693"	6	9	3	18
4148	2003-03-29	"Sat"	"Midday"	"787"	7	8	7	22
4147	2003-03-28	"Fri"	"Evening"	"023"	0	2	3	5
4146	2003-03-28	"Fri"	"Midday"	"856"	8	5	6	19
4145	2003-03-27	"Thu"	"Evening"	"259"	2	5	9	16
4144	2003-03-27	"Thu"	"Midday"	"079"	0	7	9	16
4143	2003-03-26	"Wed"	"Evening"	"864"	8	6	4	18
4142	2003-03-26	"Wed"	"Midday"	"417"	4	1	7	12
4141	2003-03-25	"Tue"	"Evening"	"139"	1	3	9	13
4140	2003-03-25	"Tue"	"Midday"	"911"	9	1	1	11
4139	2003-03-24	"Mon"	"Evening"	"923"	9	2	3	14
4138	2003-03-24	"Mon"	"Midday"	"428"	4	2	8	14
4137	2003-03-23	"Sun"	"Evening"	"674"	6	7	4	17
4136	2003-03-23	"Sun"	"Midday"	"027"	0	2	7	9
4135	2003-03-22	"Sat"	"Evening"	"420"	4	2	0	6
4134	2003-03-22	"Sat"	"Midday"	"426"	4	2	6	12
4133	2003-03-21	"Fri"	"Evening"	"986"	9	8	6	23
4132	2003-03-21	"Fri"	"Midday"	"131"	1	3	1	5
4131	2003-03-20	"Thu"	"Evening"	"702"	7	0	2	9
4130	2003-03-20	"Thu"	"Midday"	"359"	3	5	9	17
4129	2003-03-19	"Wed"	"Evening"	"742"	7	4	2	13
4128	2003-03-19	"Wed"	"Midday"	"813"	8	1	3	12
4127	2003-03-18	"Tue"	"Evening"	"863"	8	6	3	17
4126	2003-03-18	"Tue"	"Midday"	"313"	3	1	3	7
4125	2003-03-17	"Mon"	"Evening"	"297"	2	9	7	18
4124	2003-03-17	"Mon"	"Midday"	"070"	0	7	0	7
4123	2003-03-16	"Sun"	"Evening"	"993"	9	9	3	21
4122	2003-03-16	"Sun"	"Midday"	"470"	4	7	0	11
4121	2003-03-15	"Sat"	"Evening"	"323"	3	2	3	8
4120	2003-03-15	"Sat"	"Midday"	"084"	0	8	4	12
4119	2003-03-14	"Fri"	"Evening"	"748"	7	4	8	19
4118	2003-03-14	"Fri"	"Midday"	"600"	6	0	0	6
4117	2003-03-13	"Thu"	"Evening"	"568"	5	6	8	19
4116	2003-03-13	"Thu"	"Midday"	"557"	5	5	7	17
4115	2003-03-12	"Wed"	"Evening"	"295"	2	9	5	16
4114	2003-03-12	"Wed"	"Midday"	"304"	3	0	4	7
4113	2003-03-11	"Tue"	"Evening"	"070"	0	7	0	7
4112	2003-03-11	"Tue"	"Midday"	"269"	2	6	9	17
4111	2003-03-10	"Mon"	"Evening"	"928"	9	2	8	19
4110	2003-03-10	"Mon"	"Midday"	"004"	0	0	4	4
4109	2003-03-09	"Sun"	"Evening"	"844"	8	4	4	16
4108	2003-03-09	"Sun"	"Midday"	"034"	0	3	4	7
4107	2003-03-08	"Sat"	"Evening"	"365"	3	6	5	14
4106	2003-03-08	"Sat"	"Midday"	"232"	2	3	2	7
4105	2003-03-07	"Fri"	"Evening"	"113"	1	1	3	5
4104	2003-03-07	"Fri"	"Midday"	"532"	5	3	2	10
4103	2003-03-06	"Thu"	"Evening"	"852"	8	5	2	15
4102	2003-03-06	"Thu"	"Midday"	"362"	3	6	2	11
4101	2003-03-05	"Wed"	"Evening"	"732"	7	3	2	12
4100	2003-03-05	"Wed"	"Midday"	"248"	2	4	8	14
4099	2003-03-04	"Tue"	"Evening"	"875"	8	7	5	20
4098	2003-03-04	"Tue"	"Midday"	"810"	8	1	0	9
4097	2003-03-03	"Mon"	"Evening"	"215"	2	1	5	8
4096	2003-03-03	"Mon"	"Midday"	"950"	9	5	0	14
4095	2003-03-02	"Sun"	"Evening"	"551"	5	5	1	11
4094	2003-03-02	"Sun"	"Midday"	"982"	9	8	2	19
4093	2003-03-01	"Sat"	"Evening"	"378"	3	7	8	18
4092	2003-03-01	"Sat"	"Midday"	"362"	3	6	2	11
4091	2003-02-28	"Fri"	"Evening"	"591"	5	9	1	15
4090	2003-02-28	"Fri"	"Midday"	"575"	5	7	5	17
4089	2003-02-27	"Thu"	"Evening"	"575"	5	7	5	17
4088	2003-02-27	"Thu"	"Midday"	"088"	0	8	8	16
4087	2003-02-26	"Wed"	"Evening"	"264"	2	6	4	12
4086	2003-02-26	"Wed"	"Midday"	"488"	4	8	8	20
4085	2003-02-25	"Tue"	"Evening"	"093"	0	9	3	12
4084	2003-02-25	"Tue"	"Midday"	"220"	2	2	0	4
4083	2003-02-24	"Mon"	"Evening"	"080"	0	8	0	8
4082	2003-02-24	"Mon"	"Midday"	"742"	7	4	2	13
4081	2003-02-23	"Sun"	"Evening"	"041"	0	4	1	5
4080	2003-02-23	"Sun"	"Midday"	"862"	8	6	2	16
4079	2003-02-22	"Sat"	"Evening"	"784"	7	8	4	19
4078	2003-02-22	"Sat"	"Midday"	"611"	6	1	1	8
4077	2003-02-21	"Fri"	"Evening"	"112"	1	1	2	4
4076	2003-02-21	"Fri"	"Midday"	"305"	3	0	5	8
4075	2003-02-20	"Thu"	"Evening"	"186"	1	8	6	15
4074	2003-02-20	"Thu"	"Midday"	"578"	5	7	8	20
4073	2003-02-19	"Wed"	"Evening"	"678"	6	7	8	21
4072	2003-02-19	"Wed"	"Midday"	"637"	6	3	7	16
4071	2003-02-18	"Tue"	"Evening"	"770"	7	7	0	14
4070	2003-02-18	"Tue"	"Midday"	"790"	7	9	0	16
4069	2003-02-17	"Mon"	"Evening"	"346"	3	4	6	13
4068	2003-02-17	"Mon"	"Midday"	"400"	4	0	0	4
4067	2003-02-16	"Sun"	"Evening"	"723"	7	2	3	12
4066	2003-02-16	"Sun"	"Midday"	"440"	4	4	0	8
4065	2003-02-15	"Sat"	"Evening"	"011"	0	1	1	2
4064	2003-02-15	"Sat"	"Midday"	"880"	8	8	0	16
4063	2003-02-14	"Fri"	"Evening"	"319"	3	1	9	13
4062	2003-02-14	"Fri"	"Midday"	"618"	6	1	8	15
4061	2003-02-13	"Thu"	"Evening"	"613"	6	1	3	10
4060	2003-02-13	"Thu"	"Midday"	"312"	3	1	2	6
4059	2003-02-12	"Wed"	"Evening"	"014"	0	1	4	5
4058	2003-02-12	"Wed"	"Midday"	"315"	3	1	5	9
4057	2003-02-11	"Tue"	"Evening"	"027"	0	2	7	9
4056	2003-02-11	"Tue"	"Midday"	"715"	7	1	5	13
4055	2003-02-10	"Mon"	"Evening"	"727"	7	2	7	16
4054	2003-02-10	"Mon"	"Midday"	"249"	2	4	9	15
4053	2003-02-09	"Sun"	"Evening"	"470"	4	7	0	11
4052	2003-02-09	"Sun"	"Midday"	"059"	0	5	9	14
4051	2003-02-08	"Sat"	"Evening"	"505"	5	0	5	10
4050	2003-02-08	"Sat"	"Midday"	"038"	0	3	8	11
4049	2003-02-07	"Fri"	"Evening"	"135"	1	3	5	9
4048	2003-02-07	"Fri"	"Midday"	"379"	3	7	9	19
4047	2003-02-06	"Thu"	"Evening"	"985"	9	8	5	22
4046	2003-02-06	"Thu"	"Midday"	"295"	2	9	5	16
4045	2003-02-05	"Wed"	"Evening"	"249"	2	4	9	15
4044	2003-02-05	"Wed"	"Midday"	"409"	4	0	9	13
4043	2003-02-04	"Tue"	"Evening"	"968"	9	6	8	23
4042	2003-02-04	"Tue"	"Midday"	"511"	5	1	1	7
4041	2003-02-03	"Mon"	"Evening"	"357"	3	5	7	15
4040	2003-02-03	"Mon"	"Midday"	"397"	3	9	7	19
4039	2003-02-02	"Sun"	"Evening"	"279"	2	7	9	18
4038	2003-02-02	"Sun"	"Midday"	"405"	4	0	5	9
4037	2003-02-01	"Sat"	"Evening"	"523"	5	2	3	10
4036	2003-02-01	"Sat"	"Midday"	"042"	0	4	2	6
4035	2003-01-31	"Fri"	"Evening"	"688"	6	8	8	22
4034	2003-01-31	"Fri"	"Midday"	"578"	5	7	8	20
4033	2003-01-30	"Thu"	"Evening"	"860"	8	6	0	14
4032	2003-01-30	"Thu"	"Midday"	"859"	8	5	9	22
4031	2003-01-29	"Wed"	"Evening"	"431"	4	3	1	8
4030	2003-01-29	"Wed"	"Midday"	"154"	1	5	4	10
4029	2003-01-28	"Tue"	"Evening"	"174"	1	7	4	12
4028	2003-01-28	"Tue"	"Midday"	"693"	6	9	3	18
4027	2003-01-27	"Mon"	"Evening"	"913"	9	1	3	13
4026	2003-01-27	"Mon"	"Midday"	"008"	0	0	8	8
4025	2003-01-26	"Sun"	"Evening"	"086"	0	8	6	14
4024	2003-01-26	"Sun"	"Midday"	"621"	6	2	1	9
4023	2003-01-25	"Sat"	"Evening"	"040"	0	4	0	4
4022	2003-01-25	"Sat"	"Midday"	"734"	7	3	4	14
4021	2003-01-24	"Fri"	"Evening"	"500"	5	0	0	5
4020	2003-01-24	"Fri"	"Midday"	"069"	0	6	9	15
4019	2003-01-23	"Thu"	"Evening"	"820"	8	2	0	10
4018	2003-01-23	"Thu"	"Midday"	"037"	0	3	7	10
4017	2003-01-22	"Wed"	"Evening"	"412"	4	1	2	7
4016	2003-01-22	"Wed"	"Midday"	"414"	4	1	4	9
4015	2003-01-21	"Tue"	"Evening"	"384"	3	8	4	15
4014	2003-01-21	"Tue"	"Midday"	"810"	8	1	0	9
4013	2003-01-20	"Mon"	"Evening"	"101"	1	0	1	2
4012	2003-01-20	"Mon"	"Midday"	"769"	7	6	9	22
4011	2003-01-19	"Sun"	"Evening"	"816"	8	1	6	15
4010	2003-01-19	"Sun"	"Midday"	"679"	6	7	9	22
4009	2003-01-18	"Sat"	"Evening"	"647"	6	4	7	17
4008	2003-01-18	"Sat"	"Midday"	"606"	6	0	6	12
4007	2003-01-17	"Fri"	"Evening"	"830"	8	3	0	11
4006	2003-01-17	"Fri"	"Midday"	"505"	5	0	5	10
4005	2003-01-16	"Thu"	"Evening"	"811"	8	1	1	10
4004	2003-01-16	"Thu"	"Midday"	"899"	8	9	9	26
4003	2003-01-15	"Wed"	"Evening"	"399"	3	9	9	21
4002	2003-01-15	"Wed"	"Midday"	"948"	9	4	8	21
4001	2003-01-14	"Tue"	"Evening"	"073"	0	7	3	10
4000	2003-01-14	"Tue"	"Midday"	"305"	3	0	5	8
3999	2003-01-13	"Mon"	"Evening"	"356"	3	5	6	14
3998	2003-01-13	"Mon"	"Midday"	"258"	2	5	8	15
3997	2003-01-12	"Sun"	"Evening"	"682"	6	8	2	16
3996	2003-01-12	"Sun"	"Midday"	"233"	2	3	3	8
3995	2003-01-11	"Sat"	"Evening"	"545"	5	4	5	14
3994	2003-01-11	"Sat"	"Midday"	"418"	4	1	8	13
3993	2003-01-10	"Fri"	"Evening"	"109"	1	0	9	10
3992	2003-01-10	"Fri"	"Midday"	"157"	1	5	7	13
3991	2003-01-09	"Thu"	"Evening"	"684"	6	8	4	18
3990	2003-01-09	"Thu"	"Midday"	"361"	3	6	1	10
3989	2003-01-08	"Wed"	"Evening"	"535"	5	3	5	13
3988	2003-01-08	"Wed"	"Midday"	"229"	2	2	9	13
3987	2003-01-07	"Tue"	"Evening"	"295"	2	9	5	16
3986	2003-01-07	"Tue"	"Midday"	"036"	0	3	6	9
3985	2003-01-06	"Mon"	"Evening"	"624"	6	2	4	12
3984	2003-01-06	"Mon"	"Midday"	"511"	5	1	1	7
3983	2003-01-05	"Sun"	"Evening"	"097"	0	9	7	16
3982	2003-01-05	"Sun"	"Midday"	"521"	5	2	1	8
3981	2003-01-04	"Sat"	"Evening"	"228"	2	2	8	12
3980	2003-01-04	"Sat"	"Midday"	"086"	0	8	6	14
3979	2003-01-03	"Fri"	"Evening"	"709"	7	0	9	16
3978	2003-01-03	"Fri"	"Midday"	"074"	0	7	4	11
3977	2003-01-02	"Thu"	"Evening"	"301"	3	0	1	4
3976	2003-01-02	"Thu"	"Midday"	"334"	3	3	4	10
3975	2003-01-01	"Wed"	"Evening"	"559"	5	5	9	19
3974	2003-01-01	"Wed"	"Midday"	"741"	7	4	1	12
3973	2002-12-31	"Tue"	"Evening"	"897"	8	9	7	24
3972	2002-12-31	"Tue"	"Midday"	"793"	7	9	3	19
3971	2002-12-30	"Mon"	"Evening"	"955"	9	5	5	19
3970	2002-12-30	"Mon"	"Midday"	"028"	0	2	8	10
3969	2002-12-29	"Sun"	"Evening"	"282"	2	8	2	12
3968	2002-12-29	"Sun"	"Midday"	"132"	1	3	2	6
3967	2002-12-28	"Sat"	"Evening"	"266"	2	6	6	14
3966	2002-12-28	"Sat"	"Midday"	"912"	9	1	2	12
3965	2002-12-27	"Fri"	"Evening"	"852"	8	5	2	15
3964	2002-12-27	"Fri"	"Midday"	"329"	3	2	9	14
3963	2002-12-26	"Thu"	"Evening"	"919"	9	1	9	19
3962	2002-12-26	"Thu"	"Midday"	"872"	8	7	2	17
3961	2002-12-25	"Wed"	"Evening"	"245"	2	4	5	11
3960	2002-12-25	"Wed"	"Midday"	"376"	3	7	6	16
3959	2002-12-24	"Tue"	"Evening"	"787"	7	8	7	22
3958	2002-12-24	"Tue"	"Midday"	"651"	6	5	1	12
3957	2002-12-23	"Mon"	"Evening"	"573"	5	7	3	15
3956	2002-12-23	"Mon"	"Midday"	"484"	4	8	4	16
3955	2002-12-22	"Sun"	"Evening"	"916"	9	1	6	16
3954	2002-12-22	"Sun"	"Midday"	"754"	7	5	4	16
3953	2002-12-21	"Sat"	"Evening"	"059"	0	5	9	14
3952	2002-12-21	"Sat"	"Midday"	"439"	4	3	9	16
3951	2002-12-20	"Fri"	"Evening"	"461"	4	6	1	11
3950	2002-12-20	"Fri"	"Midday"	"972"	9	7	2	18
3949	2002-12-19	"Thu"	"Evening"	"103"	1	0	3	4
3948	2002-12-19	"Thu"	"Midday"	"009"	0	0	9	9
3947	2002-12-18	"Wed"	"Evening"	"994"	9	9	4	22
3946	2002-12-18	"Wed"	"Midday"	"529"	5	2	9	16
3945	2002-12-17	"Tue"	"Evening"	"694"	6	9	4	19
3944	2002-12-17	"Tue"	"Midday"	"951"	9	5	1	15
3943	2002-12-16	"Mon"	"Evening"	"862"	8	6	2	16
3942	2002-12-16	"Mon"	"Midday"	"995"	9	9	5	23
3941	2002-12-15	"Sun"	"Evening"	"221"	2	2	1	5
3940	2002-12-15	"Sun"	"Midday"	"959"	9	5	9	23
3939	2002-12-14	"Sat"	"Evening"	"936"	9	3	6	18
3938	2002-12-14	"Sat"	"Midday"	"851"	8	5	1	14
3937	2002-12-13	"Fri"	"Evening"	"882"	8	8	2	18
3936	2002-12-13	"Fri"	"Midday"	"198"	1	9	8	18
3935	2002-12-12	"Thu"	"Evening"	"266"	2	6	6	14
3934	2002-12-12	"Thu"	"Midday"	"028"	0	2	8	10
3933	2002-12-11	"Wed"	"Evening"	"400"	4	0	0	4
3932	2002-12-11	"Wed"	"Midday"	"071"	0	7	1	8
3931	2002-12-10	"Tue"	"Evening"	"667"	6	6	7	19
3930	2002-12-10	"Tue"	"Midday"	"307"	3	0	7	10
3929	2002-12-09	"Mon"	"Evening"	"992"	9	9	2	20
3928	2002-12-09	"Mon"	"Midday"	"335"	3	3	5	11
3927	2002-12-08	"Sun"	"Evening"	"252"	2	5	2	9
3926	2002-12-08	"Sun"	"Midday"	"142"	1	4	2	7
3925	2002-12-07	"Sat"	"Evening"	"974"	9	7	4	20
3924	2002-12-07	"Sat"	"Midday"	"505"	5	0	5	10
3923	2002-12-06	"Fri"	"Evening"	"225"	2	2	5	9
3922	2002-12-06	"Fri"	"Midday"	"221"	2	2	1	5
3921	2002-12-05	"Thu"	"Evening"	"762"	7	6	2	15
3920	2002-12-05	"Thu"	"Midday"	"330"	3	3	0	6
3919	2002-12-04	"Wed"	"Evening"	"476"	4	7	6	17
3918	2002-12-04	"Wed"	"Midday"	"383"	3	8	3	14
3917	2002-12-03	"Tue"	"Evening"	"695"	6	9	5	20
3916	2002-12-03	"Tue"	"Midday"	"670"	6	7	0	13
3915	2002-12-02	"Mon"	"Evening"	"623"	6	2	3	11
3914	2002-12-02	"Mon"	"Midday"	"504"	5	0	4	9
3913	2002-12-01	"Sun"	"Evening"	"508"	5	0	8	13
3912	2002-12-01	"Sun"	"Midday"	"707"	7	0	7	14
3911	2002-11-30	"Sat"	"Evening"	"018"	0	1	8	9
3910	2002-11-30	"Sat"	"Midday"	"437"	4	3	7	14
3909	2002-11-29	"Fri"	"Evening"	"882"	8	8	2	18
3908	2002-11-29	"Fri"	"Midday"	"413"	4	1	3	8
3907	2002-11-28	"Thu"	"Evening"	"560"	5	6	0	11
3906	2002-11-28	"Thu"	"Midday"	"922"	9	2	2	13
3905	2002-11-27	"Wed"	"Evening"	"026"	0	2	6	8
3904	2002-11-27	"Wed"	"Midday"	"963"	9	6	3	18
3903	2002-11-26	"Tue"	"Evening"	"911"	9	1	1	11
3902	2002-11-26	"Tue"	"Midday"	"650"	6	5	0	11
3901	2002-11-25	"Mon"	"Evening"	"092"	0	9	2	11
3900	2002-11-25	"Mon"	"Midday"	"432"	4	3	2	9
3899	2002-11-24	"Sun"	"Evening"	"789"	7	8	9	24
3898	2002-11-24	"Sun"	"Midday"	"167"	1	6	7	14
3897	2002-11-23	"Sat"	"Evening"	"748"	7	4	8	19
3896	2002-11-23	"Sat"	"Midday"	"199"	1	9	9	19
3895	2002-11-22	"Fri"	"Evening"	"427"	4	2	7	13
3894	2002-11-22	"Fri"	"Midday"	"533"	5	3	3	11
3893	2002-11-21	"Thu"	"Evening"	"252"	2	5	2	9
3892	2002-11-21	"Thu"	"Midday"	"925"	9	2	5	16
3891	2002-11-20	"Wed"	"Evening"	"452"	4	5	2	11
3890	2002-11-20	"Wed"	"Midday"	"095"	0	9	5	14
3889	2002-11-19	"Tue"	"Evening"	"108"	1	0	8	9
3888	2002-11-19	"Tue"	"Midday"	"889"	8	8	9	25
3887	2002-11-18	"Mon"	"Evening"	"634"	6	3	4	13
3886	2002-11-18	"Mon"	"Midday"	"498"	4	9	8	21
3885	2002-11-17	"Sun"	"Evening"	"092"	0	9	2	11
3884	2002-11-17	"Sun"	"Midday"	"342"	3	4	2	9
3883	2002-11-16	"Sat"	"Evening"	"684"	6	8	4	18
3882	2002-11-16	"Sat"	"Midday"	"545"	5	4	5	14
3881	2002-11-15	"Fri"	"Evening"	"026"	0	2	6	8
3880	2002-11-15	"Fri"	"Midday"	"459"	4	5	9	18
3879	2002-11-14	"Thu"	"Evening"	"182"	1	8	2	11
3878	2002-11-14	"Thu"	"Midday"	"103"	1	0	3	4
3877	2002-11-13	"Wed"	"Evening"	"307"	3	0	7	10
3876	2002-11-13	"Wed"	"Midday"	"172"	1	7	2	10
3875	2002-11-12	"Tue"	"Evening"	"494"	4	9	4	17
3874	2002-11-12	"Tue"	"Midday"	"344"	3	4	4	11
3873	2002-11-11	"Mon"	"Evening"	"404"	4	0	4	8
3872	2002-11-11	"Mon"	"Midday"	"754"	7	5	4	16
3871	2002-11-10	"Sun"	"Evening"	"671"	6	7	1	14
3870	2002-11-10	"Sun"	"Midday"	"508"	5	0	8	13
3869	2002-11-09	"Sat"	"Evening"	"295"	2	9	5	16
3868	2002-11-09	"Sat"	"Midday"	"831"	8	3	1	12
3867	2002-11-08	"Fri"	"Evening"	"269"	2	6	9	17
3866	2002-11-08	"Fri"	"Midday"	"175"	1	7	5	13
3865	2002-11-07	"Thu"	"Evening"	"853"	8	5	3	16
3864	2002-11-07	"Thu"	"Midday"	"331"	3	3	1	7
3863	2002-11-06	"Wed"	"Evening"	"579"	5	7	9	21
3862	2002-11-06	"Wed"	"Midday"	"700"	7	0	0	7
3861	2002-11-05	"Tue"	"Evening"	"943"	9	4	3	16
3860	2002-11-05	"Tue"	"Midday"	"754"	7	5	4	16
3859	2002-11-04	"Mon"	"Evening"	"300"	3	0	0	3
3858	2002-11-04	"Mon"	"Midday"	"884"	8	8	4	20
3857	2002-11-03	"Sun"	"Evening"	"261"	2	6	1	9
3856	2002-11-02	"Sat"	"Midday"	"637"	6	3	7	16
3855	2002-11-01	"Fri"	"Evening"	"083"	0	8	3	11
3854	2002-10-31	"Thu"	"Midday"	"879"	8	7	9	24
3853	2002-10-30	"Wed"	"Evening"	"407"	4	0	7	11
3852	2002-10-29	"Tue"	"Midday"	"877"	8	7	7	22
3851	2002-10-28	"Mon"	"Evening"	"572"	5	7	2	14
3850	2002-10-27	"Sun"	"Midday"	"954"	9	5	4	18
3849	2002-10-26	"Sat"	"Evening"	"877"	8	7	7	22
3848	2002-10-25	"Fri"	"Midday"	"228"	2	2	8	12
3847	2002-10-24	"Thu"	"Evening"	"826"	8	2	6	16
3846	2002-10-23	"Wed"	"Midday"	"922"	9	2	2	13
3845	2002-10-22	"Tue"	"Evening"	"318"	3	1	8	12
3844	2002-10-21	"Mon"	"Midday"	"972"	9	7	2	18
3843	2002-10-20	"Sun"	"Evening"	"830"	8	3	0	11
3842	2002-10-19	"Sat"	"Midday"	"988"	9	8	8	25
3841	2002-10-18	"Fri"	"Evening"	"658"	6	5	8	19
3840	2002-10-17	"Thu"	"Midday"	"701"	7	0	1	8
3839	2002-10-16	"Wed"	"Evening"	"871"	8	7	1	16
3838	2002-10-15	"Tue"	"Midday"	"700"	7	0	0	7
3837	2002-10-14	"Mon"	"Evening"	"423"	4	2	3	9
3836	2002-10-13	"Sun"	"Midday"	"462"	4	6	2	12
3835	2002-10-12	"Sat"	"Evening"	"257"	2	5	7	14
3834	2002-10-11	"Fri"	"Midday"	"928"	9	2	8	19
3833	2002-10-10	"Thu"	"Evening"	"205"	2	0	5	7
3832	2002-10-09	"Wed"	"Midday"	"160"	1	6	0	7
3831	2002-10-08	"Tue"	"Evening"	"421"	4	2	1	7
3830	2002-10-07	"Mon"	"Midday"	"151"	1	5	1	7
3829	2002-10-06	"Sun"	"Evening"	"711"	7	1	1	9
3828	2002-10-05	"Sat"	"Midday"	"145"	1	4	5	10
3827	2002-10-04	"Fri"	"Evening"	"653"	6	5	3	14
3826	2002-10-03	"Thu"	"Midday"	"017"	0	1	7	8
3825	2002-10-02	"Wed"	"Evening"	"192"	1	9	2	12
3824	2002-10-01	"Tue"	"Midday"	"226"	2	2	6	10
3823	2002-09-30	"Mon"	"Evening"	"620"	6	2	0	8
3822	2002-09-29	"Sun"	"Midday"	"082"	0	8	2	10
3821	2002-09-28	"Sat"	"Evening"	"859"	8	5	9	22
3820	2002-09-27	"Fri"	"Midday"	"929"	9	2	9	20
3819	2002-09-26	"Thu"	"Evening"	"303"	3	0	3	6
3818	2002-09-25	"Wed"	"Midday"	"671"	6	7	1	14
3817	2002-09-24	"Tue"	"Evening"	"980"	9	8	0	17
3816	2002-09-23	"Mon"	"Midday"	"822"	8	2	2	12
3815	2002-09-22	"Sun"	"Evening"	"461"	4	6	1	11
3814	2002-09-21	"Sat"	"Midday"	"791"	7	9	1	17
3813	2002-09-20	"Fri"	"Evening"	"650"	6	5	0	11
3812	2002-09-19	"Thu"	"Midday"	"366"	3	6	6	15
3811	2002-09-18	"Wed"	"Evening"	"028"	0	2	8	10
3810	2002-09-17	"Tue"	"Midday"	"480"	4	8	0	12
3809	2002-09-16	"Mon"	"Evening"	"301"	3	0	1	4
3808	2002-09-15	"Sun"	"Midday"	"279"	2	7	9	18
3807	2002-09-14	"Sat"	"Evening"	"872"	8	7	2	17
3806	2002-09-13	"Fri"	"Midday"	"758"	7	5	8	20
3805	2002-09-12	"Thu"	"Evening"	"684"	6	8	4	18
3804	2002-09-11	"Wed"	"Midday"	"642"	6	4	2	12
3803	2002-09-10	"Tue"	"Evening"	"961"	9	6	1	16
3802	2002-09-09	"Mon"	"Midday"	"753"	7	5	3	15
3801	2002-09-08	"Sun"	"Evening"	"777"	7	7	7	21
3800	2002-09-07	"Sat"	"Midday"	"195"	1	9	5	15
3799	2002-09-06	"Fri"	"Evening"	"326"	3	2	6	11
3798	2002-09-05	"Thu"	"Midday"	"088"	0	8	8	16
3797	2002-09-04	"Wed"	"Evening"	"665"	6	6	5	17
3796	2002-09-03	"Tue"	"Midday"	"243"	2	4	3	9
3795	2002-09-02	"Mon"	"Evening"	"901"	9	0	1	10
3794	2002-09-01	"Sun"	"Midday"	"484"	4	8	4	16
3793	2002-08-31	"Sat"	"Evening"	"739"	7	3	9	19
3792	2002-08-30	"Fri"	"Midday"	"400"	4	0	0	4
3791	2002-08-29	"Thu"	"Evening"	"849"	8	4	9	21
3790	2002-08-28	"Wed"	"Midday"	"259"	2	5	9	16
3789	2002-08-27	"Tue"	"Evening"	"187"	1	8	7	16
3788	2002-08-26	"Mon"	"Midday"	"525"	5	2	5	12
3787	2002-08-25	"Sun"	"Evening"	"699"	6	9	9	24
3786	2002-08-24	"Sat"	"Midday"	"473"	4	7	3	14
3785	2002-08-23	"Fri"	"Evening"	"673"	6	7	3	16
3784	2002-08-22	"Thu"	"Midday"	"697"	6	9	7	22
3783	2002-08-21	"Wed"	"Evening"	"078"	0	7	8	15
3782	2002-08-20	"Tue"	"Midday"	"662"	6	6	2	14
3781	2002-08-19	"Mon"	"Evening"	"836"	8	3	6	17
3780	2002-08-18	"Sun"	"Midday"	"407"	4	0	7	11
3779	2002-08-17	"Sat"	"Evening"	"049"	0	4	9	13
3778	2002-08-16	"Fri"	"Midday"	"181"	1	8	1	10
3777	2002-08-15	"Thu"	"Evening"	"687"	6	8	7	21
3776	2002-08-14	"Wed"	"Midday"	"514"	5	1	4	10
3775	2002-08-13	"Tue"	"Evening"	"158"	1	5	8	14
3774	2002-08-12	"Mon"	"Midday"	"984"	9	8	4	21
3773	2002-08-11	"Sun"	"Evening"	"908"	9	0	8	17
3772	2002-08-10	"Sat"	"Midday"	"096"	0	9	6	15
3771	2002-08-09	"Fri"	"Evening"	"763"	7	6	3	16
3770	2002-08-08	"Thu"	"Midday"	"158"	1	5	8	14
3769	2002-08-07	"Wed"	"Evening"	"437"	4	3	7	14
3768	2002-08-06	"Tue"	"Midday"	"989"	9	8	9	26
3767	2002-08-05	"Mon"	"Evening"	"910"	9	1	0	10
3766	2002-08-04	"Sun"	"Midday"	"452"	4	5	2	11
3765	2002-08-03	"Sat"	"Evening"	"488"	4	8	8	20
3764	2002-08-02	"Fri"	"Midday"	"083"	0	8	3	11
3763	2002-08-01	"Thu"	"Evening"	"053"	0	5	3	8
3762	2002-07-31	"Wed"	"Midday"	"728"	7	2	8	17
3761	2002-07-30	"Tue"	"Evening"	"109"	1	0	9	10
3760	2002-07-29	"Mon"	"Midday"	"410"	4	1	0	5
3759	2002-07-28	"Sun"	"Evening"	"221"	2	2	1	5
3758	2002-07-27	"Sat"	"Midday"	"025"	0	2	5	7
3757	2002-07-26	"Fri"	"Evening"	"714"	7	1	4	12
3756	2002-07-25	"Thu"	"Midday"	"012"	0	1	2	3
3755	2002-07-24	"Wed"	"Evening"	"853"	8	5	3	16
3754	2002-07-23	"Tue"	"Midday"	"691"	6	9	1	16
3753	2002-07-22	"Mon"	"Evening"	"909"	9	0	9	18
3752	2002-07-21	"Sun"	"Midday"	"897"	8	9	7	24
3751	2002-07-20	"Sat"	"Evening"	"308"	3	0	8	11
3750	2002-07-19	"Fri"	"Midday"	"588"	5	8	8	21
3749	2002-07-18	"Thu"	"Evening"	"263"	2	6	3	11
3748	2002-07-17	"Wed"	"Midday"	"646"	6	4	6	16
3747	2002-07-16	"Tue"	"Evening"	"509"	5	0	9	14
3746	2002-07-15	"Mon"	"Midday"	"243"	2	4	3	9
3745	2002-07-14	"Sun"	"Evening"	"157"	1	5	7	13
3744	2002-07-13	"Sat"	"Midday"	"353"	3	5	3	11
3743	2002-07-12	"Fri"	"Evening"	"111"	1	1	1	3
3742	2002-07-11	"Thu"	"Midday"	"753"	7	5	3	15
3741	2002-07-10	"Wed"	"Evening"	"730"	7	3	0	10
3740	2002-07-09	"Tue"	"Midday"	"494"	4	9	4	17
3739	2002-07-08	"Mon"	"Evening"	"303"	3	0	3	6
3738	2002-07-07	"Sun"	"Midday"	"507"	5	0	7	12
3737	2002-07-06	"Sat"	"Evening"	"970"	9	7	0	16
3736	2002-07-05	"Fri"	"Midday"	"716"	7	1	6	14
3735	2002-07-04	"Thu"	"Evening"	"884"	8	8	4	20
3734	2002-07-03	"Wed"	"Midday"	"206"	2	0	6	8
3733	2002-07-02	"Tue"	"Evening"	"774"	7	7	4	18
3732	2002-07-01	"Mon"	"Midday"	"471"	4	7	1	12
3731	2002-06-30	"Sun"	"Evening"	"619"	6	1	9	16
3730	2002-06-29	"Sat"	"Midday"	"583"	5	8	3	16
3729	2002-06-28	"Fri"	"Evening"	"805"	8	0	5	13
3728	2002-06-27	"Thu"	"Midday"	"948"	9	4	8	21
3727	2002-06-26	"Wed"	"Evening"	"995"	9	9	5	23
3726	2002-06-25	"Tue"	"Midday"	"279"	2	7	9	18
3725	2002-06-24	"Mon"	"Evening"	"143"	1	4	3	8
3724	2002-06-23	"Sun"	"Midday"	"408"	4	0	8	12
3723	2002-06-22	"Sat"	"Evening"	"577"	5	7	7	19
3722	2002-06-21	"Fri"	"Midday"	"942"	9	4	2	15
3721	2002-06-20	"Thu"	"Evening"	"667"	6	6	7	19
3720	2002-06-19	"Wed"	"Midday"	"318"	3	1	8	12
3719	2002-06-18	"Tue"	"Evening"	"583"	5	8	3	16
3718	2002-06-17	"Mon"	"Midday"	"991"	9	9	1	19
3717	2002-06-16	"Sun"	"Evening"	"734"	7	3	4	14
3716	2002-06-15	"Sat"	"Midday"	"109"	1	0	9	10
3715	2002-06-14	"Fri"	"Evening"	"875"	8	7	5	20
3714	2002-06-13	"Thu"	"Midday"	"338"	3	3	8	14
3713	2002-06-12	"Wed"	"Evening"	"867"	8	6	7	21
3712	2002-06-11	"Tue"	"Midday"	"062"	0	6	2	8
3711	2002-06-10	"Mon"	"Evening"	"819"	8	1	9	18
3710	2002-06-09	"Sun"	"Midday"	"107"	1	0	7	8
3709	2002-06-08	"Sat"	"Evening"	"689"	6	8	9	23
3708	2002-06-07	"Fri"	"Midday"	"876"	8	7	6	21
3707	2002-06-06	"Thu"	"Evening"	"323"	3	2	3	8
3706	2002-06-05	"Wed"	"Midday"	"028"	0	2	8	10
3705	2002-06-04	"Tue"	"Evening"	"551"	5	5	1	11
3704	2002-06-03	"Mon"	"Midday"	"917"	9	1	7	17
3703	2002-06-02	"Sun"	"Evening"	"670"	6	7	0	13
3702	2002-06-01	"Sat"	"Midday"	"582"	5	8	2	15
3701	2002-05-31	"Fri"	"Evening"	"490"	4	9	0	13
3700	2002-05-30	"Thu"	"Midday"	"427"	4	2	7	13
3699	2002-05-29	"Wed"	"Evening"	"647"	6	4	7	17
3698	2002-05-28	"Tue"	"Midday"	"572"	5	7	2	14
3697	2002-05-27	"Mon"	"Evening"	"177"	1	7	7	15
3696	2002-05-26	"Sun"	"Midday"	"841"	8	4	1	13
3695	2002-05-25	"Sat"	"Evening"	"935"	9	3	5	17
3694	2002-05-24	"Fri"	"Midday"	"582"	5	8	2	15
3693	2002-05-23	"Thu"	"Evening"	"841"	8	4	1	13
3692	2002-05-22	"Wed"	"Midday"	"509"	5	0	9	14
3691	2002-05-21	"Tue"	"Evening"	"394"	3	9	4	16
3690	2002-05-20	"Mon"	"Midday"	"543"	5	4	3	12
3689	2002-05-19	"Sun"	"Evening"	"948"	9	4	8	21
3688	2002-05-18	"Sat"	"Midday"	"143"	1	4	3	8
3687	2002-05-17	"Fri"	"Evening"	"283"	2	8	3	13
3686	2002-05-16	"Thu"	"Midday"	"610"	6	1	0	7
3685	2002-05-15	"Wed"	"Evening"	"275"	2	7	5	14
3684	2002-05-14	"Tue"	"Midday"	"433"	4	3	3	10
3683	2002-05-13	"Mon"	"Evening"	"608"	6	0	8	14
3682	2002-05-12	"Sun"	"Midday"	"572"	5	7	2	14
3681	2002-05-11	"Sat"	"Evening"	"814"	8	1	4	13
3680	2002-05-10	"Fri"	"Midday"	"150"	1	5	0	6
3679	2002-05-09	"Thu"	"Evening"	"084"	0	8	4	12
3678	2002-05-08	"Wed"	"Midday"	"128"	1	2	8	11
3677	2002-05-07	"Tue"	"Evening"	"293"	2	9	3	14
3676	2002-05-06	"Mon"	"Midday"	"637"	6	3	7	16
3675	2002-05-05	"Sun"	"Evening"	"981"	9	8	1	18
3674	2002-05-04	"Sat"	"Midday"	"456"	4	5	6	15
3673	2002-05-03	"Fri"	"Evening"	"931"	9	3	1	13
3672	2002-05-02	"Thu"	"Midday"	"774"	7	7	4	18
3671	2002-05-01	"Wed"	"Evening"	"559"	5	5	9	19
3670	2002-04-30	"Tue"	"Midday"	"316"	3	1	6	10
3669	2002-04-29	"Mon"	"Evening"	"197"	1	9	7	17
3668	2002-04-28	"Sun"	"Midday"	"406"	4	0	6	10
3667	2002-04-27	"Sat"	"Evening"	"658"	6	5	8	19
3666	2002-04-26	"Fri"	"Midday"	"351"	3	5	1	9
3665	2002-04-25	"Thu"	"Evening"	"553"	5	5	3	13
3664	2002-04-24	"Wed"	"Midday"	"092"	0	9	2	11
3663	2002-04-23	"Tue"	"Evening"	"064"	0	6	4	10
3662	2002-04-22	"Mon"	"Midday"	"234"	2	3	4	9
3661	2002-04-21	"Sun"	"Evening"	"873"	8	7	3	18
3660	2002-04-20	"Sat"	"Midday"	"171"	1	7	1	9
3659	2002-04-19	"Fri"	"Evening"	"501"	5	0	1	6
3658	2002-04-18	"Thu"	"Midday"	"436"	4	3	6	13
3657	2002-04-17	"Wed"	"Evening"	"032"	0	3	2	5
3656	2002-04-16	"Tue"	"Midday"	"112"	1	1	2	4
3655	2002-04-15	"Mon"	"Evening"	"622"	6	2	2	10
3654	2002-04-14	"Sun"	"Midday"	"785"	7	8	5	20
3653	2002-04-13	"Sat"	"Evening"	"717"	7	1	7	15
3652	2002-04-12	"Fri"	"Midday"	"804"	8	0	4	12
3651	2002-04-11	"Thu"	"Evening"	"558"	5	5	8	18
3650	2002-04-10	"Wed"	"Midday"	"049"	0	4	9	13
3649	2002-04-09	"Tue"	"Evening"	"950"	9	5	0	14
3648	2002-04-08	"Mon"	"Midday"	"225"	2	2	5	9
3647	2002-04-07	"Sun"	"Evening"	"755"	7	5	5	17
3646	2002-04-06	"Sat"	"Midday"	"469"	4	6	9	19
3645	2002-04-05	"Fri"	"Evening"	"863"	8	6	3	17
3644	2002-04-04	"Thu"	"Midday"	"172"	1	7	2	10
3643	2002-04-03	"Wed"	"Evening"	"353"	3	5	3	11
3642	2002-04-02	"Tue"	"Midday"	"313"	3	1	3	7
3641	2002-04-01	"Mon"	"Evening"	"533"	5	3	3	11
3640	2002-03-31	"Sun"	"Midday"	"615"	6	1	5	12
3639	2002-03-30	"Sat"	"Evening"	"013"	0	1	3	4
3638	2002-03-29	"Fri"	"Midday"	"363"	3	6	3	12
3637	2002-03-28	"Thu"	"Evening"	"288"	2	8	8	18
3636	2002-03-27	"Wed"	"Midday"	"809"	8	0	9	17
3635	2002-03-26	"Tue"	"Evening"	"311"	3	1	1	5
3634	2002-03-25	"Mon"	"Midday"	"482"	4	8	2	14
3633	2002-03-24	"Sun"	"Evening"	"496"	4	9	6	19
3632	2002-03-23	"Sat"	"Midday"	"128"	1	2	8	11
3631	2002-03-22	"Fri"	"Evening"	"871"	8	7	1	16
3630	2002-03-21	"Thu"	"Midday"	"789"	7	8	9	24
3629	2002-03-20	"Wed"	"Evening"	"888"	8	8	8	24
3628	2002-03-19	"Tue"	"Midday"	"429"	4	2	9	15
3627	2002-03-18	"Mon"	"Evening"	"844"	8	4	4	16
3626	2002-03-17	"Sun"	"Midday"	"342"	3	4	2	9
3625	2002-03-16	"Sat"	"Evening"	"222"	2	2	2	6
3624	2002-03-15	"Fri"	"Midday"	"271"	2	7	1	10
3623	2002-03-14	"Thu"	"Evening"	"819"	8	1	9	18
3622	2002-03-13	"Wed"	"Midday"	"014"	0	1	4	5
3621	2002-03-12	"Tue"	"Evening"	"158"	1	5	8	14
3620	2002-03-11	"Mon"	"Midday"	"305"	3	0	5	8
3619	2002-03-10	"Sun"	"Evening"	"529"	5	2	9	16
3618	2002-03-09	"Sat"	"Midday"	"800"	8	0	0	8
3617	2002-03-08	"Fri"	"Evening"	"925"	9	2	5	16
3616	2002-03-07	"Thu"	"Midday"	"490"	4	9	0	13
3615	2002-03-06	"Wed"	"Evening"	"590"	5	9	0	14
3614	2002-03-05	"Tue"	"Midday"	"553"	5	5	3	13
3613	2002-03-04	"Mon"	"Evening"	"746"	7	4	6	17
3612	2002-03-03	"Sun"	"Midday"	"654"	6	5	4	15
3611	2002-03-02	"Sat"	"Evening"	"377"	3	7	7	17
3610	2002-03-01	"Fri"	"Midday"	"142"	1	4	2	7
3609	2002-02-28	"Thu"	"Evening"	"545"	5	4	5	14
3608	2002-02-27	"Wed"	"Midday"	"649"	6	4	9	19
3607	2002-02-26	"Tue"	"Evening"	"912"	9	1	2	12
3606	2002-02-25	"Mon"	"Midday"	"926"	9	2	6	17
3605	2002-02-24	"Sun"	"Evening"	"689"	6	8	9	23
3604	2002-02-23	"Sat"	"Midday"	"365"	3	6	5	14
3603	2002-02-22	"Fri"	"Evening"	"834"	8	3	4	15
3602	2002-02-21	"Thu"	"Midday"	"089"	0	8	9	17
3601	2002-02-20	"Wed"	"Evening"	"440"	4	4	0	8
3600	2002-02-19	"Tue"	"Midday"	"359"	3	5	9	17
3599	2002-02-18	"Mon"	"Evening"	"484"	4	8	4	16
3598	2002-02-17	"Sun"	"Midday"	"356"	3	5	6	14
3597	2002-02-16	"Sat"	"Evening"	"620"	6	2	0	8
3596	2002-02-15	"Fri"	"Midday"	"169"	1	6	9	16
3595	2002-02-14	"Thu"	"Evening"	"810"	8	1	0	9
3594	2002-02-13	"Wed"	"Midday"	"964"	9	6	4	19
3593	2002-02-12	"Tue"	"Evening"	"433"	4	3	3	10
3592	2002-02-11	"Mon"	"Midday"	"687"	6	8	7	21
3591	2002-02-10	"Sun"	"Evening"	"149"	1	4	9	14
3590	2002-02-09	"Sat"	"Midday"	"752"	7	5	2	14
3589	2002-02-08	"Fri"	"Evening"	"988"	9	8	8	25
3588	2002-02-07	"Thu"	"Midday"	"733"	7	3	3	13
3587	2002-02-06	"Wed"	"Evening"	"702"	7	0	2	9
3586	2002-02-05	"Tue"	"Midday"	"841"	8	4	1	13
3585	2002-02-04	"Mon"	"Evening"	"442"	4	4	2	10
3584	2002-02-03	"Sun"	"Midday"	"313"	3	1	3	7
3583	2002-02-02	"Sat"	"Evening"	"092"	0	9	2	11
3582	2002-02-01	"Fri"	"Midday"	"845"	8	4	5	17
3581	2002-01-31	"Thu"	"Evening"	"073"	0	7	3	10
3580	2002-01-30	"Wed"	"Midday"	"420"	4	2	0	6
3579	2002-01-29	"Tue"	"Evening"	"297"	2	9	7	18
3578	2002-01-28	"Mon"	"Midday"	"745"	7	4	5	16
3577	2002-01-27	"Sun"	"Evening"	"217"	2	1	7	10
3576	2002-01-26	"Sat"	"Midday"	"341"	3	4	1	8
3575	2002-01-25	"Fri"	"Evening"	"163"	1	6	3	10
3574	2002-01-24	"Thu"	"Midday"	"985"	9	8	5	22
3573	2002-01-23	"Wed"	"Evening"	"281"	2	8	1	11
3572	2002-01-22	"Tue"	"Midday"	"319"	3	1	9	13
3571	2002-01-21	"Mon"	"Evening"	"899"	8	9	9	26
3570	2002-01-20	"Sun"	"Midday"	"298"	2	9	8	19
3569	2002-01-19	"Sat"	"Evening"	"364"	3	6	4	13
3568	2002-01-18	"Fri"	"Midday"	"807"	8	0	7	15
3567	2002-01-17	"Thu"	"Evening"	"286"	2	8	6	16
3566	2002-01-16	"Wed"	"Midday"	"796"	7	9	6	22
3565	2002-01-15	"Tue"	"Evening"	"078"	0	7	8	15
3564	2002-01-14	"Mon"	"Midday"	"248"	2	4	8	14
3563	2002-01-13	"Sun"	"Evening"	"876"	8	7	6	21
3562	2002-01-12	"Sat"	"Midday"	"831"	8	3	1	12
3561	2002-01-11	"Fri"	"Evening"	"167"	1	6	7	14
3560	2002-01-10	"Thu"	"Midday"	"464"	4	6	4	14
3559	2002-01-09	"Wed"	"Evening"	"106"	1	0	6	7
3558	2002-01-08	"Tue"	"Midday"	"385"	3	8	5	16
3557	2002-01-07	"Mon"	"Evening"	"331"	3	3	1	7
3556	2002-01-06	"Sun"	"Midday"	"263"	2	6	3	11
3555	2002-01-05	"Sat"	"Evening"	"787"	7	8	7	22
3554	2002-01-04	"Fri"	"Midday"	"945"	9	4	5	18
3553	2002-01-03	"Thu"	"Evening"	"452"	4	5	2	11
3552	2002-01-02	"Wed"	"Midday"	"227"	2	2	7	11
3551	2002-01-01	"Tue"	"Evening"	"695"	6	9	5	20
3550	2001-12-31	"Mon"	"Midday"	"371"	3	7	1	11
3549	2001-12-30	"Sun"	"Evening"	"207"	2	0	7	9
3548	2001-12-29	"Sat"	"Midday"	"275"	2	7	5	14
3547	2001-12-28	"Fri"	"Evening"	"296"	2	9	6	17
3546	2001-12-27	"Thu"	"Midday"	"715"	7	1	5	13
3545	2001-12-26	"Wed"	"Evening"	"179"	1	7	9	17
3544	2001-12-25	"Tue"	"Midday"	"379"	3	7	9	19
3543	2001-12-24	"Mon"	"Evening"	"926"	9	2	6	17
3542	2001-12-23	"Sun"	"Midday"	"488"	4	8	8	20
3541	2001-12-22	"Sat"	"Evening"	"233"	2	3	3	8
3540	2001-12-21	"Fri"	"Midday"	"617"	6	1	7	14
3539	2001-12-20	"Thu"	"Evening"	"695"	6	9	5	20
3538	2001-12-19	"Wed"	"Midday"	"790"	7	9	0	16
3537	2001-12-18	"Tue"	"Evening"	"936"	9	3	6	18
3536	2001-12-17	"Mon"	"Midday"	"618"	6	1	8	15
3535	2001-12-16	"Sun"	"Evening"	"857"	8	5	7	20
3534	2001-12-15	"Sat"	"Midday"	"641"	6	4	1	11
3533	2001-12-14	"Fri"	"Evening"	"742"	7	4	2	13
3532	2001-12-13	"Thu"	"Midday"	"279"	2	7	9	18
3531	2001-12-12	"Wed"	"Evening"	"656"	6	5	6	17
3530	2001-12-11	"Tue"	"Midday"	"997"	9	9	7	25
3529	2001-12-10	"Mon"	"Evening"	"440"	4	4	0	8
3528	2001-12-09	"Sun"	"Midday"	"290"	2	9	0	11
3527	2001-12-08	"Sat"	"Evening"	"623"	6	2	3	11
3526	2001-12-07	"Fri"	"Midday"	"739"	7	3	9	19
3525	2001-12-06	"Thu"	"Evening"	"084"	0	8	4	12
3524	2001-12-05	"Wed"	"Midday"	"732"	7	3	2	12
3523	2001-12-04	"Tue"	"Evening"	"901"	9	0	1	10
3522	2001-12-03	"Mon"	"Midday"	"930"	9	3	0	12
3521	2001-12-02	"Sun"	"Evening"	"884"	8	8	4	20
3520	2001-12-01	"Sat"	"Midday"	"023"	0	2	3	5
3519	2001-11-30	"Fri"	"Evening"	"006"	0	0	6	6
3518	2001-11-29	"Thu"	"Midday"	"877"	8	7	7	22
3517	2001-11-28	"Wed"	"Evening"	"500"	5	0	0	5
3516	2001-11-27	"Tue"	"Midday"	"310"	3	1	0	4
3515	2001-11-26	"Mon"	"Evening"	"284"	2	8	4	14
3514	2001-11-25	"Sun"	"Midday"	"991"	9	9	1	19
3513	2001-11-24	"Sat"	"Evening"	"761"	7	6	1	14
3512	2001-11-23	"Fri"	"Midday"	"982"	9	8	2	19
3511	2001-11-22	"Thu"	"Evening"	"074"	0	7	4	11
3510	2001-11-21	"Wed"	"Midday"	"772"	7	7	2	16
3509	2001-11-20	"Tue"	"Evening"	"802"	8	0	2	10
3508	2001-11-19	"Mon"	"Midday"	"186"	1	8	6	15
3507	2001-11-18	"Sun"	"Evening"	"853"	8	5	3	16
3506	2001-11-17	"Sat"	"Midday"	"757"	7	5	7	19
3505	2001-11-16	"Fri"	"Evening"	"610"	6	1	0	7
3504	2001-11-15	"Thu"	"Midday"	"997"	9	9	7	25
3503	2001-11-14	"Wed"	"Evening"	"108"	1	0	8	9
3502	2001-11-13	"Tue"	"Midday"	"395"	3	9	5	17
3501	2001-11-12	"Mon"	"Evening"	"746"	7	4	6	17
3500	2001-11-11	"Sun"	"Midday"	"522"	5	2	2	9
3499	2001-11-10	"Sat"	"Evening"	"767"	7	6	7	20
3498	2001-11-09	"Fri"	"Midday"	"595"	5	9	5	19
3497	2001-11-08	"Thu"	"Evening"	"092"	0	9	2	11
3496	2001-11-07	"Wed"	"Midday"	"573"	5	7	3	15
3495	2001-11-06	"Tue"	"Evening"	"798"	7	9	8	24
3494	2001-11-05	"Mon"	"Midday"	"165"	1	6	5	12
3493	2001-11-04	"Sun"	"Evening"	"530"	5	3	0	8
3492	2001-11-03	"Sat"	"Midday"	"375"	3	7	5	15
3491	2001-11-02	"Fri"	"Evening"	"488"	4	8	8	20
3490	2001-11-01	"Thu"	"Midday"	"044"	0	4	4	8
3489	2001-10-31	"Wed"	"Evening"	"863"	8	6	3	17
3488	2001-10-30	"Tue"	"Midday"	"638"	6	3	8	17
3487	2001-10-29	"Mon"	"Evening"	"919"	9	1	9	19
3486	2001-10-28	"Sun"	"Midday"	"714"	7	1	4	12
3485	2001-10-27	"Sat"	"Evening"	"610"	6	1	0	7
3484	2001-10-26	"Fri"	"Midday"	"299"	2	9	9	20
3483	2001-10-25	"Thu"	"Evening"	"183"	1	8	3	12
3482	2001-10-24	"Wed"	"Midday"	"667"	6	6	7	19
3481	2001-10-23	"Tue"	"Evening"	"616"	6	1	6	13
3480	2001-10-22	"Mon"	"Midday"	"147"	1	4	7	12
3479	2001-10-21	"Sun"	"Evening"	"455"	4	5	5	14
3478	2001-10-20	"Sat"	"Midday"	"209"	2	0	9	11
3477	2001-10-19	"Fri"	"Evening"	"652"	6	5	2	13
3476	2001-10-18	"Thu"	"Midday"	"094"	0	9	4	13
3475	2001-10-17	"Wed"	"Evening"	"578"	5	7	8	20
3474	2001-10-16	"Tue"	"Midday"	"683"	6	8	3	17
3473	2001-10-15	"Mon"	"Evening"	"761"	7	6	1	14
3472	2001-10-14	"Sun"	"Midday"	"646"	6	4	6	16
3471	2001-10-13	"Sat"	"Evening"	"765"	7	6	5	18
3470	2001-10-12	"Fri"	"Midday"	"422"	4	2	2	8
3469	2001-10-11	"Thu"	"Evening"	"587"	5	8	7	20
3468	2001-10-10	"Wed"	"Midday"	"166"	1	6	6	13
3467	2001-10-09	"Tue"	"Evening"	"180"	1	8	0	9
3466	2001-10-08	"Mon"	"Midday"	"601"	6	0	1	7
3465	2001-10-07	"Sun"	"Evening"	"890"	8	9	0	17
3464	2001-10-06	"Sat"	"Midday"	"960"	9	6	0	15
3463	2001-10-05	"Fri"	"Evening"	"879"	8	7	9	24
3462	2001-10-04	"Thu"	"Midday"	"893"	8	9	3	20
3461	2001-10-03	"Wed"	"Evening"	"573"	5	7	3	15
3460	2001-10-02	"Tue"	"Midday"	"568"	5	6	8	19
3459	2001-10-01	"Mon"	"Evening"	"489"	4	8	9	21
3458	2001-09-30	"Sun"	"Midday"	"443"	4	4	3	11
3457	2001-09-29	"Sat"	"Evening"	"271"	2	7	1	10
3456	2001-09-28	"Fri"	"Midday"	"366"	3	6	6	15
3455	2001-09-27	"Thu"	"Evening"	"130"	1	3	0	4
3454	2001-09-26	"Wed"	"Midday"	"483"	4	8	3	15
3453	2001-09-25	"Tue"	"Evening"	"774"	7	7	4	18
3452	2001-09-24	"Mon"	"Midday"	"250"	2	5	0	7
3451	2001-09-23	"Sun"	"Evening"	"042"	0	4	2	6
3450	2001-09-22	"Sat"	"Midday"	"676"	6	7	6	19
3449	2001-09-21	"Fri"	"Evening"	"684"	6	8	4	18
3448	2001-09-20	"Thu"	"Midday"	"004"	0	0	4	4
3447	2001-09-19	"Wed"	"Evening"	"175"	1	7	5	13
3446	2001-09-18	"Tue"	"Midday"	"004"	0	0	4	4
3445	2001-09-17	"Mon"	"Evening"	"691"	6	9	1	16
3444	2001-09-16	"Sun"	"Midday"	"370"	3	7	0	10
3443	2001-09-15	"Sat"	"Evening"	"878"	8	7	8	23
3442	2001-09-14	"Fri"	"Midday"	"259"	2	5	9	16
3441	2001-09-13	"Thu"	"Evening"	"341"	3	4	1	8
3440	2001-09-12	"Wed"	"Midday"	"933"	9	3	3	15
3439	2001-09-11	"Tue"	"Evening"	"099"	0	9	9	18
3438	2001-09-10	"Mon"	"Midday"	"102"	1	0	2	3
3437	2001-09-09	"Sun"	"Evening"	"357"	3	5	7	15
3436	2001-09-08	"Sat"	"Midday"	"666"	6	6	6	18
3435	2001-09-07	"Fri"	"Evening"	"876"	8	7	6	21
3434	2001-09-06	"Thu"	"Midday"	"260"	2	6	0	8
3433	2001-09-05	"Wed"	"Evening"	"889"	8	8	9	25
3432	2001-09-04	"Tue"	"Midday"	"083"	0	8	3	11
3431	2001-09-03	"Mon"	"Evening"	"844"	8	4	4	16
3430	2001-09-02	"Sun"	"Midday"	"144"	1	4	4	9
3429	2001-09-01	"Sat"	"Evening"	"478"	4	7	8	19
3428	2001-08-31	"Fri"	"Midday"	"425"	4	2	5	11
3427	2001-08-30	"Thu"	"Evening"	"664"	6	6	4	16
3426	2001-08-29	"Wed"	"Midday"	"022"	0	2	2	4
3425	2001-08-28	"Tue"	"Evening"	"717"	7	1	7	15
3424	2001-08-27	"Mon"	"Midday"	"607"	6	0	7	13
3423	2001-08-26	"Sun"	"Evening"	"691"	6	9	1	16
3422	2001-08-25	"Sat"	"Midday"	"499"	4	9	9	22
3421	2001-08-24	"Fri"	"Evening"	"792"	7	9	2	18
3420	2001-08-23	"Thu"	"Midday"	"230"	2	3	0	5
3419	2001-08-22	"Wed"	"Evening"	"456"	4	5	6	15
3418	2001-08-21	"Tue"	"Midday"	"552"	5	5	2	12
3417	2001-08-20	"Mon"	"Evening"	"346"	3	4	6	13
3416	2001-08-19	"Sun"	"Midday"	"986"	9	8	6	23
3415	2001-08-18	"Sat"	"Evening"	"307"	3	0	7	10
3414	2001-08-17	"Fri"	"Midday"	"367"	3	6	7	16
3413	2001-08-16	"Thu"	"Evening"	"879"	8	7	9	24
3412	2001-08-15	"Wed"	"Midday"	"791"	7	9	1	17
3411	2001-08-14	"Tue"	"Evening"	"115"	1	1	5	7
3410	2001-08-13	"Mon"	"Midday"	"149"	1	4	9	14
3409	2001-08-12	"Sun"	"Evening"	"443"	4	4	3	11
3408	2001-08-11	"Sat"	"Midday"	"598"	5	9	8	22
3407	2001-08-10	"Fri"	"Evening"	"689"	6	8	9	23
3406	2001-08-09	"Thu"	"Midday"	"127"	1	2	7	10
3405	2001-08-08	"Wed"	"Evening"	"854"	8	5	4	17
3404	2001-08-07	"Tue"	"Midday"	"221"	2	2	1	5
3403	2001-08-06	"Mon"	"Evening"	"241"	2	4	1	7
3402	2001-08-05	"Sun"	"Midday"	"101"	1	0	1	2
3401	2001-08-04	"Sat"	"Evening"	"009"	0	0	9	9
3400	2001-08-03	"Fri"	"Midday"	"478"	4	7	8	19
3399	2001-08-02	"Thu"	"Evening"	"938"	9	3	8	20
3398	2001-08-01	"Wed"	"Midday"	"300"	3	0	0	3
3397	2001-07-31	"Tue"	"Evening"	"392"	3	9	2	14
3396	2001-07-30	"Mon"	"Midday"	"120"	1	2	0	3
3395	2001-07-29	"Sun"	"Evening"	"611"	6	1	1	8
3394	2001-07-28	"Sat"	"Midday"	"835"	8	3	5	16
3393	2001-07-27	"Fri"	"Evening"	"241"	2	4	1	7
3392	2001-07-26	"Thu"	"Midday"	"507"	5	0	7	12
3391	2001-07-25	"Wed"	"Evening"	"357"	3	5	7	15
3390	2001-07-24	"Tue"	"Midday"	"820"	8	2	0	10
3389	2001-07-23	"Mon"	"Evening"	"541"	5	4	1	10
3388	2001-07-22	"Sun"	"Midday"	"645"	6	4	5	15
3387	2001-07-21	"Sat"	"Evening"	"170"	1	7	0	8
3386	2001-07-20	"Fri"	"Midday"	"080"	0	8	0	8
3385	2001-07-19	"Thu"	"Evening"	"473"	4	7	3	14
3384	2001-07-18	"Wed"	"Midday"	"390"	3	9	0	12
3383	2001-07-17	"Tue"	"Evening"	"724"	7	2	4	13
3382	2001-07-16	"Mon"	"Midday"	"230"	2	3	0	5
3381	2001-07-15	"Sun"	"Evening"	"769"	7	6	9	22
3380	2001-07-14	"Sat"	"Midday"	"641"	6	4	1	11
3379	2001-07-13	"Fri"	"Evening"	"271"	2	7	1	10
3378	2001-07-12	"Thu"	"Midday"	"761"	7	6	1	14
3377	2001-07-11	"Wed"	"Evening"	"010"	0	1	0	1
3376	2001-07-10	"Tue"	"Midday"	"123"	1	2	3	6
3375	2001-07-09	"Mon"	"Evening"	"993"	9	9	3	21
3374	2001-07-08	"Sun"	"Midday"	"315"	3	1	5	9
3373	2001-07-07	"Sat"	"Evening"	"224"	2	2	4	8
3372	2001-07-06	"Fri"	"Midday"	"856"	8	5	6	19
3371	2001-07-05	"Thu"	"Evening"	"435"	4	3	5	12
3370	2001-07-04	"Wed"	"Midday"	"918"	9	1	8	18
3369	2001-07-03	"Tue"	"Evening"	"794"	7	9	4	20
3368	2001-07-02	"Mon"	"Midday"	"999"	9	9	9	27
3367	2001-07-01	"Sun"	"Evening"	"498"	4	9	8	21
3366	2001-06-30	"Sat"	"Midday"	"174"	1	7	4	12
3365	2001-06-29	"Fri"	"Evening"	"536"	5	3	6	14
3364	2001-06-28	"Thu"	"Midday"	"269"	2	6	9	17
3363	2001-06-27	"Wed"	"Evening"	"420"	4	2	0	6
3362	2001-06-26	"Tue"	"Midday"	"085"	0	8	5	13
3361	2001-06-25	"Mon"	"Evening"	"514"	5	1	4	10
3360	2001-06-24	"Sun"	"Midday"	"305"	3	0	5	8
3359	2001-06-23	"Sat"	"Evening"	"967"	9	6	7	22
3358	2001-06-22	"Fri"	"Midday"	"613"	6	1	3	10
3357	2001-06-21	"Thu"	"Evening"	"285"	2	8	5	15
3356	2001-06-20	"Wed"	"Midday"	"439"	4	3	9	16
3355	2001-06-19	"Tue"	"Evening"	"835"	8	3	5	16
3354	2001-06-18	"Mon"	"Midday"	"424"	4	2	4	10
3353	2001-06-17	"Sun"	"Evening"	"095"	0	9	5	14
3352	2001-06-16	"Sat"	"Midday"	"816"	8	1	6	15
3351	2001-06-15	"Fri"	"Evening"	"001"	0	0	1	1
3350	2001-06-14	"Thu"	"Midday"	"415"	4	1	5	10
3349	2001-06-13	"Wed"	"Evening"	"927"	9	2	7	18
3348	2001-06-12	"Tue"	"Midday"	"568"	5	6	8	19
3347	2001-06-11	"Mon"	"Evening"	"705"	7	0	5	12
3346	2001-06-10	"Sun"	"Midday"	"672"	6	7	2	15
3345	2001-06-09	"Sat"	"Evening"	"146"	1	4	6	11
3344	2001-06-08	"Fri"	"Midday"	"983"	9	8	3	20
3343	2001-06-07	"Thu"	"Evening"	"444"	4	4	4	12
3342	2001-06-06	"Wed"	"Midday"	"196"	1	9	6	16
3341	2001-06-05	"Tue"	"Evening"	"152"	1	5	2	8
3340	2001-06-04	"Mon"	"Midday"	"638"	6	3	8	17
3339	2001-06-03	"Sun"	"Evening"	"264"	2	6	4	12
3338	2001-06-02	"Sat"	"Midday"	"506"	5	0	6	11
3337	2001-06-01	"Fri"	"Evening"	"899"	8	9	9	26
3336	2001-05-31	"Thu"	"Midday"	"532"	5	3	2	10
3335	2001-05-30	"Wed"	"Evening"	"830"	8	3	0	11
3334	2001-05-29	"Tue"	"Midday"	"889"	8	8	9	25
3333	2001-05-28	"Mon"	"Evening"	"640"	6	4	0	10
3332	2001-05-27	"Sun"	"Midday"	"061"	0	6	1	7
3331	2001-05-26	"Sat"	"Evening"	"374"	3	7	4	14
3330	2001-05-25	"Fri"	"Midday"	"322"	3	2	2	7
3329	2001-05-24	"Thu"	"Evening"	"197"	1	9	7	17
3328	2001-05-23	"Wed"	"Midday"	"577"	5	7	7	19
3327	2001-05-22	"Tue"	"Evening"	"721"	7	2	1	10
3326	2001-05-21	"Mon"	"Midday"	"841"	8	4	1	13
3325	2001-05-20	"Sun"	"Evening"	"032"	0	3	2	5
3324	2001-05-19	"Sat"	"Midday"	"000"	0	0	0	0
3323	2001-05-18	"Fri"	"Evening"	"440"	4	4	0	8
3322	2001-05-17	"Thu"	"Midday"	"298"	2	9	8	19
3321	2001-05-16	"Wed"	"Evening"	"673"	6	7	3	16
3320	2001-05-15	"Tue"	"Midday"	"016"	0	1	6	7
3319	2001-05-14	"Mon"	"Evening"	"927"	9	2	7	18
3318	2001-05-13	"Sun"	"Midday"	"001"	0	0	1	1
3317	2001-05-12	"Sat"	"Evening"	"791"	7	9	1	17
3316	2001-05-11	"Fri"	"Midday"	"809"	8	0	9	17
3315	2001-05-10	"Thu"	"Evening"	"948"	9	4	8	21
3314	2001-05-09	"Wed"	"Midday"	"539"	5	3	9	17
3313	2001-05-08	"Tue"	"Evening"	"723"	7	2	3	12
3312	2001-05-07	"Mon"	"Midday"	"384"	3	8	4	15
3311	2001-05-06	"Sun"	"Evening"	"865"	8	6	5	19
3310	2001-05-05	"Sat"	"Midday"	"372"	3	7	2	12
3309	2001-05-04	"Fri"	"Evening"	"179"	1	7	9	17
3308	2001-05-03	"Thu"	"Midday"	"029"	0	2	9	11
3307	2001-05-02	"Wed"	"Evening"	"272"	2	7	2	11
3306	2001-05-01	"Tue"	"Midday"	"131"	1	3	1	5
3305	2001-04-30	"Mon"	"Evening"	"523"	5	2	3	10
3304	2001-04-29	"Sun"	"Midday"	"056"	0	5	6	11
3303	2001-04-28	"Sat"	"Evening"	"422"	4	2	2	8
3302	2001-04-27	"Fri"	"Midday"	"471"	4	7	1	12
3301	2001-04-26	"Thu"	"Evening"	"611"	6	1	1	8
3300	2001-04-25	"Wed"	"Midday"	"115"	1	1	5	7
3299	2001-04-24	"Tue"	"Evening"	"878"	8	7	8	23
3298	2001-04-23	"Mon"	"Midday"	"931"	9	3	1	13
3297	2001-04-22	"Sun"	"Evening"	"550"	5	5	0	10
3296	2001-04-21	"Sat"	"Midday"	"124"	1	2	4	7
3295	2001-04-20	"Fri"	"Evening"	"408"	4	0	8	12
3294	2001-04-19	"Thu"	"Midday"	"518"	5	1	8	14
3293	2001-04-18	"Wed"	"Evening"	"938"	9	3	8	20
3292	2001-04-17	"Tue"	"Midday"	"829"	8	2	9	19
3291	2001-04-16	"Mon"	"Evening"	"573"	5	7	3	15
3290	2001-04-15	"Sun"	"Midday"	"573"	5	7	3	15
3289	2001-04-14	"Sat"	"Evening"	"042"	0	4	2	6
3288	2001-04-13	"Fri"	"Midday"	"119"	1	1	9	11
3287	2001-04-12	"Thu"	"Evening"	"823"	8	2	3	13
3286	2001-04-11	"Wed"	"Midday"	"520"	5	2	0	7
3285	2001-04-10	"Tue"	"Evening"	"121"	1	2	1	4
3284	2001-04-09	"Mon"	"Midday"	"796"	7	9	6	22
3283	2001-04-08	"Sun"	"Evening"	"890"	8	9	0	17
3282	2001-04-07	"Sat"	"Midday"	"239"	2	3	9	14
3281	2001-04-06	"Fri"	"Evening"	"143"	1	4	3	8
3280	2001-04-05	"Thu"	"Midday"	"871"	8	7	1	16
3279	2001-04-04	"Wed"	"Evening"	"034"	0	3	4	7
3278	2001-04-03	"Tue"	"Midday"	"558"	5	5	8	18
3277	2001-04-02	"Mon"	"Evening"	"832"	8	3	2	13
3276	2001-04-01	"Sun"	"Midday"	"959"	9	5	9	23
3275	2001-03-31	"Sat"	"Evening"	"480"	4	8	0	12
3274	2001-03-30	"Fri"	"Midday"	"347"	3	4	7	14
3273	2001-03-29	"Thu"	"Evening"	"533"	5	3	3	11
3272	2001-03-28	"Wed"	"Midday"	"646"	6	4	6	16
3271	2001-03-27	"Tue"	"Evening"	"478"	4	7	8	19
3270	2001-03-26	"Mon"	"Midday"	"700"	7	0	0	7
3269	2001-03-25	"Sun"	"Evening"	"215"	2	1	5	8
3268	2001-03-24	"Sat"	"Midday"	"211"	2	1	1	4
3267	2001-03-23	"Fri"	"Evening"	"228"	2	2	8	12
3266	2001-03-22	"Thu"	"Midday"	"083"	0	8	3	11
3265	2001-03-21	"Wed"	"Evening"	"157"	1	5	7	13
3264	2001-03-20	"Tue"	"Midday"	"879"	8	7	9	24
3263	2001-03-19	"Mon"	"Evening"	"202"	2	0	2	4
3262	2001-03-18	"Sun"	"Midday"	"125"	1	2	5	8
3261	2001-03-17	"Sat"	"Evening"	"906"	9	0	6	15
3260	2001-03-16	"Fri"	"Midday"	"424"	4	2	4	10
3259	2001-03-15	"Thu"	"Evening"	"404"	4	0	4	8
3258	2001-03-14	"Wed"	"Midday"	"168"	1	6	8	15
3257	2001-03-13	"Tue"	"Evening"	"821"	8	2	1	11
3256	2001-03-12	"Mon"	"Midday"	"226"	2	2	6	10
3255	2001-03-11	"Sun"	"Evening"	"492"	4	9	2	15
3254	2001-03-10	"Sat"	"Midday"	"126"	1	2	6	9
3253	2001-03-09	"Fri"	"Evening"	"980"	9	8	0	17
3252	2001-03-08	"Thu"	"Midday"	"150"	1	5	0	6
3251	2001-03-07	"Wed"	"Evening"	"250"	2	5	0	7
3250	2001-03-06	"Tue"	"Midday"	"104"	1	0	4	5
3249	2001-03-05	"Mon"	"Evening"	"803"	8	0	3	11
3248	2001-03-04	"Sun"	"Midday"	"108"	1	0	8	9
3247	2001-03-03	"Sat"	"Evening"	"707"	7	0	7	14
3246	2001-03-02	"Fri"	"Midday"	"001"	0	0	1	1
3245	2001-03-01	"Thu"	"Evening"	"595"	5	9	5	19
3244	2001-02-28	"Wed"	"Midday"	"046"	0	4	6	10
3243	2001-02-27	"Tue"	"Evening"	"193"	1	9	3	13
3242	2001-02-26	"Mon"	"Midday"	"776"	7	7	6	20
3241	2001-02-25	"Sun"	"Evening"	"877"	8	7	7	22
3240	2001-02-24	"Sat"	"Midday"	"875"	8	7	5	20
3239	2001-02-23	"Fri"	"Evening"	"274"	2	7	4	13
3238	2001-02-22	"Thu"	"Midday"	"627"	6	2	7	15
3237	2001-02-21	"Wed"	"Evening"	"784"	7	8	4	19
3236	2001-02-20	"Tue"	"Midday"	"056"	0	5	6	11
3235	2001-02-19	"Mon"	"Evening"	"535"	5	3	5	13
3234	2001-02-18	"Sun"	"Midday"	"412"	4	1	2	7
3233	2001-02-17	"Sat"	"Evening"	"098"	0	9	8	17
3232	2001-02-16	"Fri"	"Midday"	"658"	6	5	8	19
3231	2001-02-15	"Thu"	"Evening"	"810"	8	1	0	9
3230	2001-02-14	"Wed"	"Midday"	"739"	7	3	9	19
3229	2001-02-13	"Tue"	"Evening"	"370"	3	7	0	10
3228	2001-02-12	"Mon"	"Midday"	"593"	5	9	3	17
3227	2001-02-11	"Sun"	"Evening"	"642"	6	4	2	12
3226	2001-02-10	"Sat"	"Midday"	"599"	5	9	9	23
3225	2001-02-09	"Fri"	"Evening"	"965"	9	6	5	20
3224	2001-02-08	"Thu"	"Midday"	"045"	0	4	5	9
3223	2001-02-07	"Wed"	"Evening"	"001"	0	0	1	1
3222	2001-02-06	"Tue"	"Midday"	"448"	4	4	8	16
3221	2001-02-05	"Mon"	"Evening"	"804"	8	0	4	12
3220	2001-02-04	"Sun"	"Midday"	"589"	5	8	9	22
3219	2001-02-03	"Sat"	"Evening"	"104"	1	0	4	5
3218	2001-02-02	"Fri"	"Midday"	"428"	4	2	8	14
3217	2001-02-01	"Thu"	"Evening"	"777"	7	7	7	21
3216	2001-01-31	"Wed"	"Midday"	"674"	6	7	4	17
3215	2001-01-30	"Tue"	"Evening"	"786"	7	8	6	21
3214	2001-01-29	"Mon"	"Midday"	"671"	6	7	1	14
3213	2001-01-28	"Sun"	"Evening"	"002"	0	0	2	2
3212	2001-01-27	"Sat"	"Midday"	"982"	9	8	2	19
3211	2001-01-26	"Fri"	"Evening"	"034"	0	3	4	7
3210	2001-01-25	"Thu"	"Midday"	"912"	9	1	2	12
3209	2001-01-24	"Wed"	"Evening"	"649"	6	4	9	19
3208	2001-01-23	"Tue"	"Midday"	"111"	1	1	1	3
3207	2001-01-22	"Mon"	"Evening"	"887"	8	8	7	23
3206	2001-01-21	"Sun"	"Midday"	"846"	8	4	6	18
3205	2001-01-20	"Sat"	"Evening"	"788"	7	8	8	23
3204	2001-01-19	"Fri"	"Midday"	"843"	8	4	3	15
3203	2001-01-18	"Thu"	"Evening"	"554"	5	5	4	14
3202	2001-01-17	"Wed"	"Midday"	"969"	9	6	9	24
3201	2001-01-16	"Tue"	"Evening"	"230"	2	3	0	5
3200	2001-01-15	"Mon"	"Midday"	"255"	2	5	5	12
3199	2001-01-14	"Sun"	"Evening"	"572"	5	7	2	14
3198	2001-01-13	"Sat"	"Midday"	"241"	2	4	1	7
3197	2001-01-12	"Fri"	"Evening"	"715"	7	1	5	13
3196	2001-01-11	"Thu"	"Midday"	"282"	2	8	2	12
3195	2001-01-10	"Wed"	"Evening"	"711"	7	1	1	9
3194	2001-01-09	"Tue"	"Midday"	"534"	5	3	4	12
3193	2001-01-08	"Mon"	"Evening"	"651"	6	5	1	12
3192	2001-01-07	"Sun"	"Midday"	"284"	2	8	4	14
3191	2001-01-06	"Sat"	"Evening"	"816"	8	1	6	15
3190	2001-01-05	"Fri"	"Midday"	"933"	9	3	3	15
3189	2001-01-04	"Thu"	"Evening"	"053"	0	5	3	8
3188	2001-01-03	"Wed"	"Midday"	"927"	9	2	7	18
3187	2001-01-02	"Tue"	"Evening"	"742"	7	4	2	13
3186	2001-01-01	"Mon"	"Midday"	"847"	8	4	7	19
3185	2000-12-31	"Sun"	"Evening"	"878"	8	7	8	23
3184	2000-12-30	"Sat"	"Midday"	"523"	5	2	3	10
3183	2000-12-29	"Fri"	"Evening"	"155"	1	5	5	11
3182	2000-12-28	"Thu"	"Midday"	"465"	4	6	5	15
3181	2000-12-27	"Wed"	"Evening"	"952"	9	5	2	16
3180	2000-12-26	"Tue"	"Midday"	"247"	2	4	7	13
3179	2000-12-25	"Mon"	"Evening"	"260"	2	6	0	8
3178	2000-12-24	"Sun"	"Midday"	"012"	0	1	2	3
3177	2000-12-23	"Sat"	"Evening"	"642"	6	4	2	12
3176	2000-12-22	"Fri"	"Midday"	"110"	1	1	0	2
3175	2000-12-21	"Thu"	"Evening"	"104"	1	0	4	5
3174	2000-12-20	"Wed"	"Midday"	"522"	5	2	2	9
3173	2000-12-19	"Tue"	"Evening"	"131"	1	3	1	5
3172	2000-12-18	"Mon"	"Midday"	"756"	7	5	6	18
3171	2000-12-17	"Sun"	"Evening"	"026"	0	2	6	8
3170	2000-12-16	"Sat"	"Midday"	"941"	9	4	1	14
3169	2000-12-15	"Fri"	"Evening"	"409"	4	0	9	13
3168	2000-12-14	"Thu"	"Midday"	"958"	9	5	8	22
3167	2000-12-13	"Wed"	"Evening"	"558"	5	5	8	18
3166	2000-12-12	"Tue"	"Midday"	"398"	3	9	8	20
3165	2000-12-11	"Mon"	"Evening"	"914"	9	1	4	14
3164	2000-12-10	"Sun"	"Midday"	"743"	7	4	3	14
3163	2000-12-09	"Sat"	"Evening"	"358"	3	5	8	16
3162	2000-12-08	"Fri"	"Midday"	"674"	6	7	4	17
3161	2000-12-07	"Thu"	"Evening"	"432"	4	3	2	9
3160	2000-12-06	"Wed"	"Midday"	"663"	6	6	3	15
3159	2000-12-05	"Tue"	"Evening"	"171"	1	7	1	9
3158	2000-12-04	"Mon"	"Midday"	"295"	2	9	5	16
3157	2000-12-03	"Sun"	"Evening"	"771"	7	7	1	15
3156	2000-12-02	"Sat"	"Midday"	"475"	4	7	5	16
3155	2000-12-01	"Fri"	"Evening"	"127"	1	2	7	10
3154	2000-11-30	"Thu"	"Midday"	"518"	5	1	8	14
3153	2000-11-29	"Wed"	"Evening"	"767"	7	6	7	20
3152	2000-11-28	"Tue"	"Midday"	"548"	5	4	8	17
3151	2000-11-27	"Mon"	"Evening"	"897"	8	9	7	24
3150	2000-11-26	"Sun"	"Midday"	"876"	8	7	6	21
3149	2000-11-25	"Sat"	"Evening"	"634"	6	3	4	13
3148	2000-11-24	"Fri"	"Midday"	"890"	8	9	0	17
3147	2000-11-23	"Thu"	"Evening"	"704"	7	0	4	11
3146	2000-11-22	"Wed"	"Midday"	"318"	3	1	8	12
3145	2000-11-21	"Tue"	"Evening"	"187"	1	8	7	16
3144	2000-11-20	"Mon"	"Midday"	"749"	7	4	9	20
3143	2000-11-19	"Sun"	"Evening"	"294"	2	9	4	15
3142	2000-11-18	"Sat"	"Midday"	"768"	7	6	8	21
3141	2000-11-17	"Fri"	"Evening"	"585"	5	8	5	18
3140	2000-11-16	"Thu"	"Midday"	"861"	8	6	1	15
3139	2000-11-15	"Wed"	"Evening"	"617"	6	1	7	14
3138	2000-11-14	"Tue"	"Midday"	"523"	5	2	3	10
3137	2000-11-13	"Mon"	"Evening"	"288"	2	8	8	18
3136	2000-11-12	"Sun"	"Midday"	"631"	6	3	1	10
3135	2000-11-11	"Sat"	"Evening"	"661"	6	6	1	13
3134	2000-11-10	"Fri"	"Midday"	"555"	5	5	5	15
3133	2000-11-09	"Thu"	"Evening"	"346"	3	4	6	13
3132	2000-11-08	"Wed"	"Midday"	"667"	6	6	7	19
3131	2000-11-07	"Tue"	"Evening"	"055"	0	5	5	10
3130	2000-11-06	"Mon"	"Midday"	"713"	7	1	3	11
3129	2000-11-05	"Sun"	"Evening"	"623"	6	2	3	11
3128	2000-11-04	"Sat"	"Midday"	"687"	6	8	7	21
3127	2000-11-03	"Fri"	"Evening"	"715"	7	1	5	13
3126	2000-11-02	"Thu"	"Midday"	"319"	3	1	9	13
3125	2000-11-01	"Wed"	"Evening"	"723"	7	2	3	12
3124	2000-10-31	"Tue"	"Midday"	"738"	7	3	8	18
3123	2000-10-30	"Mon"	"Evening"	"948"	9	4	8	21
3122	2000-10-29	"Sun"	"Midday"	"967"	9	6	7	22
3121	2000-10-28	"Sat"	"Evening"	"943"	9	4	3	16
3120	2000-10-27	"Fri"	"Midday"	"832"	8	3	2	13
3119	2000-10-26	"Thu"	"Evening"	"329"	3	2	9	14
3118	2000-10-25	"Wed"	"Midday"	"663"	6	6	3	15
3117	2000-10-24	"Tue"	"Evening"	"564"	5	6	4	15
3116	2000-10-23	"Mon"	"Midday"	"201"	2	0	1	3
3115	2000-10-22	"Sun"	"Evening"	"295"	2	9	5	16
3114	2000-10-21	"Sat"	"Midday"	"553"	5	5	3	13
3113	2000-10-20	"Fri"	"Evening"	"318"	3	1	8	12
3112	2000-10-19	"Thu"	"Midday"	"683"	6	8	3	17
3111	2000-10-18	"Wed"	"Evening"	"826"	8	2	6	16
3110	2000-10-17	"Tue"	"Midday"	"498"	4	9	8	21
3109	2000-10-16	"Mon"	"Evening"	"441"	4	4	1	9
3108	2000-10-15	"Sun"	"Midday"	"701"	7	0	1	8
3107	2000-10-14	"Sat"	"Evening"	"303"	3	0	3	6
3106	2000-10-13	"Fri"	"Midday"	"425"	4	2	5	11
3105	2000-10-12	"Thu"	"Evening"	"054"	0	5	4	9
3104	2000-10-11	"Wed"	"Midday"	"302"	3	0	2	5
3103	2000-10-10	"Tue"	"Evening"	"925"	9	2	5	16
3102	2000-10-09	"Mon"	"Midday"	"977"	9	7	7	23
3101	2000-10-08	"Sun"	"Evening"	"112"	1	1	2	4
3100	2000-10-07	"Sat"	"Midday"	"420"	4	2	0	6
3099	2000-10-06	"Fri"	"Evening"	"567"	5	6	7	18
3098	2000-10-05	"Thu"	"Midday"	"086"	0	8	6	14
3097	2000-10-04	"Wed"	"Evening"	"785"	7	8	5	20
3096	2000-10-03	"Tue"	"Midday"	"422"	4	2	2	8
3095	2000-10-02	"Mon"	"Evening"	"919"	9	1	9	19
3094	2000-10-01	"Sun"	"Midday"	"645"	6	4	5	15
3093	2000-09-30	"Sat"	"Evening"	"871"	8	7	1	16
3092	2000-09-29	"Fri"	"Midday"	"580"	5	8	0	13
3091	2000-09-28	"Thu"	"Evening"	"040"	0	4	0	4
3090	2000-09-27	"Wed"	"Midday"	"791"	7	9	1	17
3089	2000-09-26	"Tue"	"Evening"	"942"	9	4	2	15
3088	2000-09-25	"Mon"	"Midday"	"812"	8	1	2	11
3087	2000-09-24	"Sun"	"Evening"	"582"	5	8	2	15
3086	2000-09-23	"Sat"	"Midday"	"858"	8	5	8	21
3085	2000-09-22	"Fri"	"Evening"	"254"	2	5	4	11
3084	2000-09-21	"Thu"	"Midday"	"866"	8	6	6	20
3083	2000-09-20	"Wed"	"Evening"	"877"	8	7	7	22
3082	2000-09-19	"Tue"	"Midday"	"178"	1	7	8	16
3081	2000-09-18	"Mon"	"Evening"	"272"	2	7	2	11
3080	2000-09-17	"Sun"	"Midday"	"630"	6	3	0	9
3079	2000-09-16	"Sat"	"Evening"	"319"	3	1	9	13
3078	2000-09-15	"Fri"	"Midday"	"137"	1	3	7	11
3077	2000-09-14	"Thu"	"Evening"	"625"	6	2	5	13
3076	2000-09-13	"Wed"	"Midday"	"908"	9	0	8	17
3075	2000-09-12	"Tue"	"Evening"	"527"	5	2	7	14
3074	2000-09-11	"Mon"	"Midday"	"000"	0	0	0	0
3073	2000-09-10	"Sun"	"Evening"	"191"	1	9	1	11
3072	2000-09-09	"Sat"	"Midday"	"225"	2	2	5	9
3071	2000-09-08	"Fri"	"Evening"	"852"	8	5	2	15
3070	2000-09-07	"Thu"	"Midday"	"958"	9	5	8	22
3069	2000-09-06	"Wed"	"Evening"	"654"	6	5	4	15
3068	2000-09-05	"Tue"	"Midday"	"277"	2	7	7	16
3067	2000-09-04	"Mon"	"Evening"	"182"	1	8	2	11
3066	2000-09-03	"Sun"	"Midday"	"092"	0	9	2	11
3065	2000-09-02	"Sat"	"Evening"	"083"	0	8	3	11
3064	2000-09-01	"Fri"	"Midday"	"327"	3	2	7	12
3063	2000-08-31	"Thu"	"Evening"	"314"	3	1	4	8
3062	2000-08-30	"Wed"	"Midday"	"131"	1	3	1	5
3061	2000-08-29	"Tue"	"Evening"	"137"	1	3	7	11
3060	2000-08-28	"Mon"	"Midday"	"459"	4	5	9	18
3059	2000-08-27	"Sun"	"Evening"	"191"	1	9	1	11
3058	2000-08-26	"Sat"	"Midday"	"333"	3	3	3	9
3057	2000-08-25	"Fri"	"Evening"	"048"	0	4	8	12
3056	2000-08-24	"Thu"	"Midday"	"473"	4	7	3	14
3055	2000-08-23	"Wed"	"Evening"	"417"	4	1	7	12
3054	2000-08-22	"Tue"	"Midday"	"964"	9	6	4	19
3053	2000-08-21	"Mon"	"Evening"	"250"	2	5	0	7
3052	2000-08-20	"Sun"	"Midday"	"323"	3	2	3	8
3051	2000-08-19	"Sat"	"Evening"	"994"	9	9	4	22
3050	2000-08-18	"Fri"	"Midday"	"787"	7	8	7	22
3049	2000-08-17	"Thu"	"Evening"	"298"	2	9	8	19
3048	2000-08-16	"Wed"	"Midday"	"811"	8	1	1	10
3047	2000-08-15	"Tue"	"Evening"	"191"	1	9	1	11
3046	2000-08-14	"Mon"	"Midday"	"517"	5	1	7	13
3045	2000-08-13	"Sun"	"Evening"	"328"	3	2	8	13
3044	2000-08-12	"Sat"	"Midday"	"063"	0	6	3	9
3043	2000-08-11	"Fri"	"Evening"	"743"	7	4	3	14
3042	2000-08-10	"Thu"	"Midday"	"892"	8	9	2	19
3041	2000-08-09	"Wed"	"Evening"	"239"	2	3	9	14
3040	2000-08-08	"Tue"	"Midday"	"314"	3	1	4	8
3039	2000-08-07	"Mon"	"Evening"	"589"	5	8	9	22
3038	2000-08-06	"Sun"	"Midday"	"751"	7	5	1	13
3037	2000-08-05	"Sat"	"Evening"	"745"	7	4	5	16
3036	2000-08-04	"Fri"	"Midday"	"884"	8	8	4	20
3035	2000-08-03	"Thu"	"Evening"	"535"	5	3	5	13
3034	2000-08-02	"Wed"	"Midday"	"135"	1	3	5	9
3033	2000-08-01	"Tue"	"Evening"	"864"	8	6	4	18
3032	2000-07-31	"Mon"	"Midday"	"594"	5	9	4	18
3031	2000-07-30	"Sun"	"Evening"	"730"	7	3	0	10
3030	2000-07-29	"Sat"	"Midday"	"379"	3	7	9	19
3029	2000-07-28	"Fri"	"Evening"	"100"	1	0	0	1
3028	2000-07-27	"Thu"	"Midday"	"916"	9	1	6	16
3027	2000-07-26	"Wed"	"Evening"	"789"	7	8	9	24
3026	2000-07-25	"Tue"	"Midday"	"389"	3	8	9	20
3025	2000-07-24	"Mon"	"Evening"	"968"	9	6	8	23
3024	2000-07-23	"Sun"	"Midday"	"631"	6	3	1	10
3023	2000-07-22	"Sat"	"Evening"	"426"	4	2	6	12
3022	2000-07-21	"Fri"	"Midday"	"305"	3	0	5	8
3021	2000-07-20	"Thu"	"Evening"	"922"	9	2	2	13
3020	2000-07-19	"Wed"	"Midday"	"975"	9	7	5	21
3019	2000-07-18	"Tue"	"Evening"	"646"	6	4	6	16
3018	2000-07-17	"Mon"	"Midday"	"795"	7	9	5	21
3017	2000-07-16	"Sun"	"Evening"	"322"	3	2	2	7
3016	2000-07-15	"Sat"	"Midday"	"599"	5	9	9	23
3015	2000-07-14	"Fri"	"Evening"	"535"	5	3	5	13
3014	2000-07-13	"Thu"	"Midday"	"022"	0	2	2	4
3013	2000-07-12	"Wed"	"Evening"	"872"	8	7	2	17
3012	2000-07-11	"Tue"	"Midday"	"356"	3	5	6	14
3011	2000-07-10	"Mon"	"Evening"	"781"	7	8	1	16
3010	2000-07-09	"Sun"	"Midday"	"621"	6	2	1	9
3009	2000-07-08	"Sat"	"Evening"	"801"	8	0	1	9
3008	2000-07-07	"Fri"	"Midday"	"017"	0	1	7	8
3007	2000-07-06	"Thu"	"Evening"	"223"	2	2	3	7
3006	2000-07-05	"Wed"	"Midday"	"685"	6	8	5	19
3005	2000-07-04	"Tue"	"Evening"	"227"	2	2	7	11
3004	2000-07-03	"Mon"	"Midday"	"515"	5	1	5	11
3003	2000-07-02	"Sun"	"Evening"	"069"	0	6	9	15
3002	2000-07-01	"Sat"	"Midday"	"779"	7	7	9	23
3001	2000-06-30	"Fri"	"Evening"	"876"	8	7	6	21
3000	2000-06-29	"Thu"	"Midday"	"051"	0	5	1	6
2999	2000-06-28	"Wed"	"Evening"	"474"	4	7	4	15
2998	2000-06-27	"Tue"	"Midday"	"201"	2	0	1	3
2997	2000-06-26	"Mon"	"Evening"	"903"	9	0	3	12
2996	2000-06-25	"Sun"	"Midday"	"764"	7	6	4	17
2995	2000-06-24	"Sat"	"Evening"	"946"	9	4	6	19
2994	2000-06-23	"Fri"	"Midday"	"218"	2	1	8	11
2993	2000-06-22	"Thu"	"Evening"	"380"	3	8	0	11
2992	2000-06-21	"Wed"	"Midday"	"531"	5	3	1	9
2991	2000-06-20	"Tue"	"Evening"	"942"	9	4	2	15
2990	2000-06-19	"Mon"	"Midday"	"459"	4	5	9	18
2989	2000-06-18	"Sun"	"Evening"	"044"	0	4	4	8
2988	2000-06-17	"Sat"	"Midday"	"310"	3	1	0	4
2987	2000-06-16	"Fri"	"Evening"	"906"	9	0	6	15
2986	2000-06-15	"Thu"	"Midday"	"148"	1	4	8	13
2985	2000-06-14	"Wed"	"Evening"	"196"	1	9	6	16
2984	2000-06-13	"Tue"	"Midday"	"566"	5	6	6	17
2983	2000-06-12	"Mon"	"Evening"	"703"	7	0	3	10
2982	2000-06-11	"Sun"	"Midday"	"859"	8	5	9	22
2981	2000-06-10	"Sat"	"Evening"	"175"	1	7	5	13
2980	2000-06-09	"Fri"	"Midday"	"170"	1	7	0	8
2979	2000-06-08	"Thu"	"Evening"	"835"	8	3	5	16
2978	2000-06-07	"Wed"	"Midday"	"529"	5	2	9	16
2977	2000-06-06	"Tue"	"Evening"	"575"	5	7	5	17
2976	2000-06-05	"Mon"	"Midday"	"272"	2	7	2	11
2975	2000-06-04	"Sun"	"Evening"	"292"	2	9	2	13
2974	2000-06-03	"Sat"	"Midday"	"129"	1	2	9	12
2973	2000-06-02	"Fri"	"Evening"	"180"	1	8	0	9
2972	2000-06-01	"Thu"	"Midday"	"300"	3	0	0	3
2971	2000-05-31	"Wed"	"Evening"	"090"	0	9	0	9
2970	2000-05-30	"Tue"	"Midday"	"658"	6	5	8	19
2969	2000-05-29	"Mon"	"Evening"	"590"	5	9	0	14
2968	2000-05-28	"Sun"	"Midday"	"176"	1	7	6	14
2967	2000-05-27	"Sat"	"Evening"	"986"	9	8	6	23
2966	2000-05-26	"Fri"	"Midday"	"682"	6	8	2	16
2965	2000-05-25	"Thu"	"Evening"	"906"	9	0	6	15
2964	2000-05-24	"Wed"	"Midday"	"369"	3	6	9	18
2963	2000-05-23	"Tue"	"Evening"	"063"	0	6	3	9
2962	2000-05-22	"Mon"	"Midday"	"461"	4	6	1	11
2961	2000-05-21	"Sun"	"Evening"	"594"	5	9	4	18
2960	2000-05-20	"Sat"	"Midday"	"279"	2	7	9	18
2959	2000-05-19	"Fri"	"Evening"	"863"	8	6	3	17
2958	2000-05-18	"Thu"	"Midday"	"467"	4	6	7	17
2957	2000-05-17	"Wed"	"Evening"	"724"	7	2	4	13
2956	2000-05-16	"Tue"	"Midday"	"303"	3	0	3	6
2955	2000-05-15	"Mon"	"Evening"	"567"	5	6	7	18
2954	2000-05-14	"Sun"	"Midday"	"429"	4	2	9	15
2953	2000-05-13	"Sat"	"Evening"	"842"	8	4	2	14
2952	2000-05-12	"Fri"	"Midday"	"694"	6	9	4	19
2951	2000-05-11	"Thu"	"Evening"	"394"	3	9	4	16
2950	2000-05-10	"Wed"	"Midday"	"685"	6	8	5	19
2949	2000-05-09	"Tue"	"Evening"	"370"	3	7	0	10
2948	2000-05-08	"Mon"	"Midday"	"720"	7	2	0	9
2947	2000-05-07	"Sun"	"Evening"	"457"	4	5	7	16
2946	2000-05-06	"Sat"	"Midday"	"498"	4	9	8	21
2945	2000-05-05	"Fri"	"Evening"	"251"	2	5	1	8
2944	2000-05-04	"Thu"	"Midday"	"312"	3	1	2	6
2943	2000-05-03	"Wed"	"Evening"	"128"	1	2	8	11
2942	2000-05-02	"Tue"	"Midday"	"015"	0	1	5	6
2941	2000-05-01	"Mon"	"Evening"	"894"	8	9	4	21
2940	2000-04-30	"Sun"	"Midday"	"149"	1	4	9	14
2939	2000-04-29	"Sat"	"Evening"	"886"	8	8	6	22
2938	2000-04-28	"Fri"	"Midday"	"645"	6	4	5	15
2937	2000-04-27	"Thu"	"Evening"	"094"	0	9	4	13
2936	2000-04-26	"Wed"	"Midday"	"484"	4	8	4	16
2935	2000-04-25	"Tue"	"Evening"	"711"	7	1	1	9
2934	2000-04-24	"Mon"	"Midday"	"556"	5	5	6	16
2933	2000-04-23	"Sun"	"Evening"	"872"	8	7	2	17
2932	2000-04-22	"Sat"	"Midday"	"486"	4	8	6	18
2931	2000-04-21	"Fri"	"Evening"	"900"	9	0	0	9
2930	2000-04-20	"Thu"	"Midday"	"448"	4	4	8	16
2929	2000-04-19	"Wed"	"Evening"	"562"	5	6	2	13
2928	2000-04-18	"Tue"	"Midday"	"830"	8	3	0	11
2927	2000-04-17	"Mon"	"Evening"	"381"	3	8	1	12
2926	2000-04-16	"Sun"	"Midday"	"308"	3	0	8	11
2925	2000-04-15	"Sat"	"Evening"	"701"	7	0	1	8
2924	2000-04-14	"Fri"	"Midday"	"046"	0	4	6	10
2923	2000-04-13	"Thu"	"Evening"	"580"	5	8	0	13
2922	2000-04-12	"Wed"	"Midday"	"904"	9	0	4	13
2921	2000-04-11	"Tue"	"Evening"	"146"	1	4	6	11
2920	2000-04-10	"Mon"	"Midday"	"287"	2	8	7	17
2919	2000-04-09	"Sun"	"Evening"	"449"	4	4	9	17
2918	2000-04-08	"Sat"	"Midday"	"773"	7	7	3	17
2917	2000-04-07	"Fri"	"Evening"	"901"	9	0	1	10
2916	2000-04-06	"Thu"	"Midday"	"990"	9	9	0	18
2915	2000-04-05	"Wed"	"Evening"	"375"	3	7	5	15
2914	2000-04-04	"Tue"	"Midday"	"390"	3	9	0	12
2913	2000-04-03	"Mon"	"Evening"	"723"	7	2	3	12
2912	2000-04-02	"Sun"	"Midday"	"307"	3	0	7	10
2911	2000-04-01	"Sat"	"Evening"	"501"	5	0	1	6
2910	2000-03-31	"Fri"	"Midday"	"384"	3	8	4	15
2909	2000-03-30	"Thu"	"Evening"	"270"	2	7	0	9
2908	2000-03-29	"Wed"	"Midday"	"740"	7	4	0	11
2907	2000-03-28	"Tue"	"Evening"	"275"	2	7	5	14
2906	2000-03-27	"Mon"	"Midday"	"849"	8	4	9	21
2905	2000-03-26	"Sun"	"Evening"	"389"	3	8	9	20
2904	2000-03-25	"Sat"	"Midday"	"225"	2	2	5	9
2903	2000-03-24	"Fri"	"Evening"	"168"	1	6	8	15
2902	2000-03-23	"Thu"	"Midday"	"625"	6	2	5	13
2901	2000-03-22	"Wed"	"Evening"	"423"	4	2	3	9
2900	2000-03-21	"Tue"	"Midday"	"333"	3	3	3	9
2899	2000-03-20	"Mon"	"Evening"	"216"	2	1	6	9
2898	2000-03-19	"Sun"	"Midday"	"636"	6	3	6	15
2897	2000-03-18	"Sat"	"Evening"	"949"	9	4	9	22
2896	2000-03-17	"Fri"	"Midday"	"944"	9	4	4	17
2895	2000-03-16	"Thu"	"Evening"	"198"	1	9	8	18
2894	2000-03-15	"Wed"	"Midday"	"349"	3	4	9	16
2893	2000-03-14	"Tue"	"Evening"	"106"	1	0	6	7
2892	2000-03-13	"Mon"	"Midday"	"011"	0	1	1	2
2891	2000-03-12	"Sun"	"Evening"	"403"	4	0	3	7
2890	2000-03-11	"Sat"	"Midday"	"560"	5	6	0	11
2889	2000-03-10	"Fri"	"Evening"	"378"	3	7	8	18
2888	2000-03-09	"Thu"	"Midday"	"172"	1	7	2	10
2887	2000-03-08	"Wed"	"Evening"	"791"	7	9	1	17
2886	2000-03-07	"Tue"	"Midday"	"784"	7	8	4	19
2885	2000-03-06	"Mon"	"Evening"	"406"	4	0	6	10
2884	2000-03-05	"Sun"	"Midday"	"939"	9	3	9	21
2883	2000-03-04	"Sat"	"Evening"	"092"	0	9	2	11
2882	2000-03-03	"Fri"	"Midday"	"076"	0	7	6	13
2881	2000-03-02	"Thu"	"Evening"	"170"	1	7	0	8
2880	2000-03-01	"Wed"	"Midday"	"292"	2	9	2	13
2879	2000-02-29	"Tue"	"Evening"	"224"	2	2	4	8
2878	2000-02-28	"Mon"	"Midday"	"480"	4	8	0	12
2877	2000-02-27	"Sun"	"Evening"	"330"	3	3	0	6
2876	2000-02-26	"Sat"	"Midday"	"623"	6	2	3	11
2875	2000-02-25	"Fri"	"Evening"	"750"	7	5	0	12
2874	2000-02-24	"Thu"	"Midday"	"748"	7	4	8	19
2873	2000-02-23	"Wed"	"Evening"	"647"	6	4	7	17
2872	2000-02-22	"Tue"	"Midday"	"044"	0	4	4	8
2871	2000-02-21	"Mon"	"Evening"	"255"	2	5	5	12
2870	2000-02-20	"Sun"	"Midday"	"855"	8	5	5	18
2869	2000-02-19	"Sat"	"Evening"	"699"	6	9	9	24
2868	2000-02-18	"Fri"	"Midday"	"463"	4	6	3	13
2867	2000-02-17	"Thu"	"Evening"	"128"	1	2	8	11
2866	2000-02-16	"Wed"	"Midday"	"672"	6	7	2	15
2865	2000-02-15	"Tue"	"Evening"	"228"	2	2	8	12
2864	2000-02-14	"Mon"	"Midday"	"743"	7	4	3	14
2863	2000-02-13	"Sun"	"Evening"	"486"	4	8	6	18
2862	2000-02-12	"Sat"	"Midday"	"251"	2	5	1	8
2861	2000-02-11	"Fri"	"Evening"	"562"	5	6	2	13
2860	2000-02-10	"Thu"	"Midday"	"721"	7	2	1	10
2859	2000-02-09	"Wed"	"Evening"	"049"	0	4	9	13
2858	2000-02-08	"Tue"	"Midday"	"735"	7	3	5	15
2857	2000-02-07	"Mon"	"Evening"	"084"	0	8	4	12
2856	2000-02-06	"Sun"	"Midday"	"537"	5	3	7	15
2855	2000-02-05	"Sat"	"Evening"	"572"	5	7	2	14
2854	2000-02-04	"Fri"	"Midday"	"448"	4	4	8	16
2853	2000-02-03	"Thu"	"Evening"	"063"	0	6	3	9
2852	2000-02-02	"Wed"	"Midday"	"137"	1	3	7	11
2851	2000-02-01	"Tue"	"Evening"	"830"	8	3	0	11
2850	2000-01-31	"Mon"	"Midday"	"446"	4	4	6	14
2849	2000-01-30	"Sun"	"Evening"	"716"	7	1	6	14
2848	2000-01-29	"Sat"	"Midday"	"405"	4	0	5	9
2847	2000-01-28	"Fri"	"Evening"	"986"	9	8	6	23
2846	2000-01-27	"Thu"	"Midday"	"771"	7	7	1	15
2845	2000-01-26	"Wed"	"Evening"	"203"	2	0	3	5
2844	2000-01-25	"Tue"	"Midday"	"536"	5	3	6	14
2843	2000-01-24	"Mon"	"Evening"	"460"	4	6	0	10
2842	2000-01-23	"Sun"	"Midday"	"669"	6	6	9	21
2841	2000-01-22	"Sat"	"Evening"	"039"	0	3	9	12
2840	2000-01-21	"Fri"	"Midday"	"312"	3	1	2	6
2839	2000-01-20	"Thu"	"Evening"	"221"	2	2	1	5
2838	2000-01-19	"Wed"	"Midday"	"297"	2	9	7	18
2837	2000-01-18	"Tue"	"Evening"	"296"	2	9	6	17
2836	2000-01-17	"Mon"	"Midday"	"076"	0	7	6	13
2835	2000-01-16	"Sun"	"Evening"	"479"	4	7	9	20
2834	2000-01-15	"Sat"	"Midday"	"323"	3	2	3	8
2833	2000-01-14	"Fri"	"Evening"	"522"	5	2	2	9
2832	2000-01-13	"Thu"	"Midday"	"555"	5	5	5	15
2831	2000-01-12	"Wed"	"Evening"	"532"	5	3	2	10
2830	2000-01-11	"Tue"	"Midday"	"505"	5	0	5	10
2829	2000-01-10	"Mon"	"Evening"	"229"	2	2	9	13
2828	2000-01-09	"Sun"	"Midday"	"866"	8	6	6	20
2827	2000-01-08	"Sat"	"Evening"	"748"	7	4	8	19
2826	2000-01-07	"Fri"	"Midday"	"158"	1	5	8	14
2825	2000-01-06	"Thu"	"Evening"	"041"	0	4	1	5
2824	2000-01-05	"Wed"	"Midday"	"166"	1	6	6	13
2823	2000-01-04	"Tue"	"Evening"	"512"	5	1	2	8
2822	2000-01-03	"Mon"	"Midday"	"920"	9	2	0	11
2821	2000-01-02	"Sun"	"Evening"	"764"	7	6	4	17
2820	2000-01-01	"Sat"	"Midday"	"390"	3	9	0	12
2819	1999-12-31	"Fri"	"Evening"	"165"	1	6	5	12
2818	1999-12-30	"Thu"	"Midday"	"599"	5	9	9	23
2817	1999-12-29	"Wed"	"Evening"	"630"	6	3	0	9
2816	1999-12-28	"Tue"	"Midday"	"538"	5	3	8	16
2815	1999-12-27	"Mon"	"Evening"	"979"	9	7	9	25
2814	1999-12-26	"Sun"	"Midday"	"399"	3	9	9	21
2813	1999-12-25	"Sat"	"Evening"	"536"	5	3	6	14
2812	1999-12-24	"Fri"	"Midday"	"477"	4	7	7	18
2811	1999-12-23	"Thu"	"Evening"	"664"	6	6	4	16
2810	1999-12-22	"Wed"	"Midday"	"167"	1	6	7	14
2809	1999-12-21	"Tue"	"Evening"	"934"	9	3	4	16
2808	1999-12-20	"Mon"	"Midday"	"377"	3	7	7	17
2807	1999-12-19	"Sun"	"Evening"	"876"	8	7	6	21
2806	1999-12-18	"Sat"	"Midday"	"170"	1	7	0	8
2805	1999-12-17	"Fri"	"Evening"	"113"	1	1	3	5
2804	1999-12-16	"Thu"	"Midday"	"034"	0	3	4	7
2803	1999-12-15	"Wed"	"Evening"	"703"	7	0	3	10
2802	1999-12-14	"Tue"	"Midday"	"548"	5	4	8	17
2801	1999-12-13	"Mon"	"Evening"	"170"	1	7	0	8
2800	1999-12-12	"Sun"	"Midday"	"556"	5	5	6	16
2799	1999-12-11	"Sat"	"Evening"	"453"	4	5	3	12
2798	1999-12-10	"Fri"	"Midday"	"978"	9	7	8	24
2797	1999-12-09	"Thu"	"Evening"	"677"	6	7	7	20
2796	1999-12-08	"Wed"	"Midday"	"519"	5	1	9	15
2795	1999-12-07	"Tue"	"Evening"	"245"	2	4	5	11
2794	1999-12-06	"Mon"	"Midday"	"800"	8	0	0	8
2793	1999-12-05	"Sun"	"Evening"	"796"	7	9	6	22
2792	1999-12-04	"Sat"	"Midday"	"854"	8	5	4	17
2791	1999-12-03	"Fri"	"Evening"	"799"	7	9	9	25
2790	1999-12-02	"Thu"	"Midday"	"615"	6	1	5	12
2789	1999-12-01	"Wed"	"Evening"	"132"	1	3	2	6
2788	1999-11-30	"Tue"	"Midday"	"454"	4	5	4	13
2787	1999-11-29	"Mon"	"Evening"	"686"	6	8	6	20
2786	1999-11-28	"Sun"	"Midday"	"364"	3	6	4	13
2785	1999-11-27	"Sat"	"Evening"	"000"	0	0	0	0
2784	1999-11-26	"Fri"	"Midday"	"763"	7	6	3	16
2783	1999-11-25	"Thu"	"Evening"	"210"	2	1	0	3
2782	1999-11-24	"Wed"	"Midday"	"609"	6	0	9	15
2781	1999-11-23	"Tue"	"Evening"	"023"	0	2	3	5
2780	1999-11-22	"Mon"	"Midday"	"009"	0	0	9	9
2779	1999-11-21	"Sun"	"Evening"	"104"	1	0	4	5
2778	1999-11-20	"Sat"	"Midday"	"439"	4	3	9	16
2777	1999-11-19	"Fri"	"Evening"	"635"	6	3	5	14
2776	1999-11-18	"Thu"	"Midday"	"276"	2	7	6	15
2775	1999-11-17	"Wed"	"Evening"	"215"	2	1	5	8
2774	1999-11-16	"Tue"	"Midday"	"381"	3	8	1	12
2773	1999-11-15	"Mon"	"Evening"	"320"	3	2	0	5
2772	1999-11-14	"Sun"	"Midday"	"593"	5	9	3	17
2771	1999-11-13	"Sat"	"Evening"	"881"	8	8	1	17
2770	1999-11-12	"Fri"	"Midday"	"491"	4	9	1	14
2769	1999-11-11	"Thu"	"Evening"	"454"	4	5	4	13
2768	1999-11-10	"Wed"	"Midday"	"899"	8	9	9	26
2767	1999-11-09	"Tue"	"Evening"	"920"	9	2	0	11
2766	1999-11-08	"Mon"	"Midday"	"686"	6	8	6	20
2765	1999-11-07	"Sun"	"Evening"	"250"	2	5	0	7
2764	1999-11-06	"Sat"	"Midday"	"283"	2	8	3	13
2763	1999-11-05	"Fri"	"Evening"	"097"	0	9	7	16
2762	1999-11-04	"Thu"	"Midday"	"086"	0	8	6	14
2761	1999-11-03	"Wed"	"Evening"	"523"	5	2	3	10
2760	1999-11-02	"Tue"	"Midday"	"290"	2	9	0	11
2759	1999-11-01	"Mon"	"Evening"	"745"	7	4	5	16
2758	1999-10-31	"Sun"	"Midday"	"324"	3	2	4	9
2757	1999-10-30	"Sat"	"Evening"	"727"	7	2	7	16
2756	1999-10-29	"Fri"	"Midday"	"870"	8	7	0	15
2755	1999-10-28	"Thu"	"Evening"	"000"	0	0	0	0
2754	1999-10-27	"Wed"	"Midday"	"039"	0	3	9	12
2753	1999-10-26	"Tue"	"Evening"	"560"	5	6	0	11
2752	1999-10-25	"Mon"	"Midday"	"127"	1	2	7	10
2751	1999-10-24	"Sun"	"Evening"	"066"	0	6	6	12
2750	1999-10-23	"Sat"	"Midday"	"912"	9	1	2	12
2749	1999-10-22	"Fri"	"Evening"	"392"	3	9	2	14
2748	1999-10-21	"Thu"	"Midday"	"159"	1	5	9	15
2747	1999-10-20	"Wed"	"Evening"	"494"	4	9	4	17
2746	1999-10-19	"Tue"	"Midday"	"449"	4	4	9	17
2745	1999-10-18	"Mon"	"Evening"	"141"	1	4	1	6
2744	1999-10-17	"Sun"	"Midday"	"075"	0	7	5	12
2743	1999-10-16	"Sat"	"Evening"	"933"	9	3	3	15
2742	1999-10-15	"Fri"	"Midday"	"515"	5	1	5	11
2741	1999-10-14	"Thu"	"Evening"	"550"	5	5	0	10
2740	1999-10-13	"Wed"	"Midday"	"935"	9	3	5	17
2739	1999-10-12	"Tue"	"Evening"	"173"	1	7	3	11
2738	1999-10-11	"Mon"	"Midday"	"456"	4	5	6	15
2737	1999-10-10	"Sun"	"Evening"	"678"	6	7	8	21
2736	1999-10-09	"Sat"	"Midday"	"799"	7	9	9	25
2735	1999-10-08	"Fri"	"Evening"	"021"	0	2	1	3
2734	1999-10-07	"Thu"	"Midday"	"921"	9	2	1	12
2733	1999-10-06	"Wed"	"Evening"	"552"	5	5	2	12
2732	1999-10-05	"Tue"	"Midday"	"371"	3	7	1	11
2731	1999-10-04	"Mon"	"Evening"	"681"	6	8	1	15
2730	1999-10-03	"Sun"	"Midday"	"892"	8	9	2	19
2729	1999-10-02	"Sat"	"Evening"	"392"	3	9	2	14
2728	1999-10-01	"Fri"	"Midday"	"722"	7	2	2	11
2727	1999-09-30	"Thu"	"Evening"	"320"	3	2	0	5
2726	1999-09-29	"Wed"	"Midday"	"585"	5	8	5	18
2725	1999-09-28	"Tue"	"Evening"	"980"	9	8	0	17
2724	1999-09-27	"Mon"	"Midday"	"035"	0	3	5	8
2723	1999-09-26	"Sun"	"Evening"	"104"	1	0	4	5
2722	1999-09-25	"Sat"	"Midday"	"036"	0	3	6	9
2721	1999-09-24	"Fri"	"Evening"	"654"	6	5	4	15
2720	1999-09-23	"Thu"	"Midday"	"289"	2	8	9	19
2719	1999-09-22	"Wed"	"Evening"	"123"	1	2	3	6
2718	1999-09-21	"Tue"	"Midday"	"961"	9	6	1	16
2717	1999-09-20	"Mon"	"Evening"	"080"	0	8	0	8
2716	1999-09-19	"Sun"	"Midday"	"589"	5	8	9	22
2715	1999-09-18	"Sat"	"Evening"	"162"	1	6	2	9
2714	1999-09-17	"Fri"	"Midday"	"977"	9	7	7	23
2713	1999-09-16	"Thu"	"Evening"	"558"	5	5	8	18
2712	1999-09-15	"Wed"	"Midday"	"596"	5	9	6	20
2711	1999-09-14	"Tue"	"Evening"	"840"	8	4	0	12
2710	1999-09-13	"Mon"	"Midday"	"085"	0	8	5	13
2709	1999-09-12	"Sun"	"Evening"	"301"	3	0	1	4
2708	1999-09-11	"Sat"	"Midday"	"050"	0	5	0	5
2707	1999-09-10	"Fri"	"Evening"	"906"	9	0	6	15
2706	1999-09-09	"Thu"	"Midday"	"463"	4	6	3	13
2705	1999-09-08	"Wed"	"Evening"	"141"	1	4	1	6
2704	1999-09-07	"Tue"	"Midday"	"889"	8	8	9	25
2703	1999-09-06	"Mon"	"Evening"	"588"	5	8	8	21
2702	1999-09-05	"Sun"	"Midday"	"648"	6	4	8	18
2701	1999-09-04	"Sat"	"Evening"	"443"	4	4	3	11
2700	1999-09-03	"Fri"	"Midday"	"153"	1	5	3	9
2699	1999-09-02	"Thu"	"Evening"	"256"	2	5	6	13
2698	1999-09-01	"Wed"	"Midday"	"809"	8	0	9	17
2697	1999-08-31	"Tue"	"Evening"	"797"	7	9	7	23
2696	1999-08-30	"Mon"	"Midday"	"846"	8	4	6	18
2695	1999-08-29	"Sun"	"Evening"	"434"	4	3	4	11
2694	1999-08-28	"Sat"	"Midday"	"925"	9	2	5	16
2693	1999-08-27	"Fri"	"Evening"	"876"	8	7	6	21
2692	1999-08-26	"Thu"	"Midday"	"863"	8	6	3	17
2691	1999-08-25	"Wed"	"Evening"	"873"	8	7	3	18
2690	1999-08-24	"Tue"	"Midday"	"070"	0	7	0	7
2689	1999-08-23	"Mon"	"Evening"	"594"	5	9	4	18
2688	1999-08-22	"Sun"	"Midday"	"218"	2	1	8	11
2687	1999-08-21	"Sat"	"Evening"	"973"	9	7	3	19
2686	1999-08-20	"Fri"	"Midday"	"967"	9	6	7	22
2685	1999-08-19	"Thu"	"Evening"	"766"	7	6	6	19
2684	1999-08-18	"Wed"	"Midday"	"001"	0	0	1	1
2683	1999-08-17	"Tue"	"Evening"	"359"	3	5	9	17
2682	1999-08-16	"Mon"	"Midday"	"178"	1	7	8	16
2681	1999-08-15	"Sun"	"Evening"	"359"	3	5	9	17
2680	1999-08-14	"Sat"	"Midday"	"215"	2	1	5	8
2679	1999-08-13	"Fri"	"Evening"	"916"	9	1	6	16
2678	1999-08-12	"Thu"	"Midday"	"481"	4	8	1	13
2677	1999-08-11	"Wed"	"Evening"	"008"	0	0	8	8
2676	1999-08-10	"Tue"	"Midday"	"739"	7	3	9	19
2675	1999-08-09	"Mon"	"Evening"	"724"	7	2	4	13
2674	1999-08-08	"Sun"	"Midday"	"987"	9	8	7	24
2673	1999-08-07	"Sat"	"Evening"	"031"	0	3	1	4
2672	1999-08-06	"Fri"	"Midday"	"663"	6	6	3	15
2671	1999-08-05	"Thu"	"Evening"	"426"	4	2	6	12
2670	1999-08-04	"Wed"	"Midday"	"997"	9	9	7	25
2669	1999-08-03	"Tue"	"Evening"	"945"	9	4	5	18
2668	1999-08-02	"Mon"	"Midday"	"224"	2	2	4	8
2667	1999-08-01	"Sun"	"Evening"	"915"	9	1	5	15
2666	1999-07-31	"Sat"	"Midday"	"480"	4	8	0	12
2665	1999-07-30	"Fri"	"Evening"	"005"	0	0	5	5
2664	1999-07-29	"Thu"	"Midday"	"361"	3	6	1	10
2663	1999-07-28	"Wed"	"Evening"	"825"	8	2	5	15
2662	1999-07-27	"Tue"	"Midday"	"875"	8	7	5	20
2661	1999-07-26	"Mon"	"Evening"	"422"	4	2	2	8
2660	1999-07-25	"Sun"	"Midday"	"776"	7	7	6	20
2659	1999-07-24	"Sat"	"Evening"	"666"	6	6	6	18
2658	1999-07-23	"Fri"	"Midday"	"207"	2	0	7	9
2657	1999-07-22	"Thu"	"Evening"	"690"	6	9	0	15
2656	1999-07-21	"Wed"	"Midday"	"162"	1	6	2	9
2655	1999-07-20	"Tue"	"Evening"	"832"	8	3	2	13
2654	1999-07-19	"Mon"	"Midday"	"430"	4	3	0	7
2653	1999-07-18	"Sun"	"Evening"	"451"	4	5	1	10
2652	1999-07-17	"Sat"	"Midday"	"665"	6	6	5	17
2651	1999-07-16	"Fri"	"Evening"	"074"	0	7	4	11
2650	1999-07-15	"Thu"	"Midday"	"705"	7	0	5	12
2649	1999-07-14	"Wed"	"Evening"	"970"	9	7	0	16
2648	1999-07-13	"Tue"	"Midday"	"386"	3	8	6	17
2647	1999-07-12	"Mon"	"Evening"	"148"	1	4	8	13
2646	1999-07-11	"Sun"	"Midday"	"656"	6	5	6	17
2645	1999-07-10	"Sat"	"Evening"	"710"	7	1	0	8
2644	1999-07-09	"Fri"	"Midday"	"639"	6	3	9	18
2643	1999-07-08	"Thu"	"Evening"	"843"	8	4	3	15
2642	1999-07-07	"Wed"	"Midday"	"315"	3	1	5	9
2641	1999-07-06	"Tue"	"Evening"	"807"	8	0	7	15
2640	1999-07-05	"Mon"	"Midday"	"352"	3	5	2	10
2639	1999-07-04	"Sun"	"Evening"	"667"	6	6	7	19
2638	1999-07-03	"Sat"	"Midday"	"748"	7	4	8	19
2637	1999-07-02	"Fri"	"Evening"	"036"	0	3	6	9
2636	1999-07-01	"Thu"	"Midday"	"183"	1	8	3	12
2635	1999-06-30	"Wed"	"Evening"	"432"	4	3	2	9
2634	1999-06-29	"Tue"	"Midday"	"042"	0	4	2	6
2633	1999-06-28	"Mon"	"Evening"	"061"	0	6	1	7
2632	1999-06-27	"Sun"	"Midday"	"630"	6	3	0	9
2631	1999-06-26	"Sat"	"Evening"	"208"	2	0	8	10
2630	1999-06-25	"Fri"	"Midday"	"993"	9	9	3	21
2629	1999-06-24	"Thu"	"Evening"	"560"	5	6	0	11
2628	1999-06-23	"Wed"	"Midday"	"067"	0	6	7	13
2627	1999-06-22	"Tue"	"Evening"	"098"	0	9	8	17
2626	1999-06-21	"Mon"	"Midday"	"080"	0	8	0	8
2625	1999-06-20	"Sun"	"Evening"	"062"	0	6	2	8
2624	1999-06-19	"Sat"	"Midday"	"522"	5	2	2	9
2623	1999-06-18	"Fri"	"Evening"	"728"	7	2	8	17
2622	1999-06-17	"Thu"	"Midday"	"801"	8	0	1	9
2621	1999-06-16	"Wed"	"Evening"	"601"	6	0	1	7
2620	1999-06-15	"Tue"	"Midday"	"305"	3	0	5	8
2619	1999-06-14	"Mon"	"Evening"	"020"	0	2	0	2
2618	1999-06-13	"Sun"	"Midday"	"521"	5	2	1	8
2617	1999-06-12	"Sat"	"Evening"	"000"	0	0	0	0
2616	1999-06-11	"Fri"	"Midday"	"706"	7	0	6	13
2615	1999-06-10	"Thu"	"Evening"	"183"	1	8	3	12
2614	1999-06-09	"Wed"	"Midday"	"440"	4	4	0	8
2613	1999-06-08	"Tue"	"Evening"	"490"	4	9	0	13
2612	1999-06-07	"Mon"	"Midday"	"733"	7	3	3	13
2611	1999-06-06	"Sun"	"Evening"	"316"	3	1	6	10
2610	1999-06-05	"Sat"	"Midday"	"045"	0	4	5	9
2609	1999-06-04	"Fri"	"Evening"	"983"	9	8	3	20
2608	1999-06-03	"Thu"	"Midday"	"833"	8	3	3	14
2607	1999-06-02	"Wed"	"Evening"	"668"	6	6	8	20
2606	1999-06-01	"Tue"	"Midday"	"881"	8	8	1	17
2605	1999-05-31	"Mon"	"Evening"	"554"	5	5	4	14
2604	1999-05-30	"Sun"	"Midday"	"699"	6	9	9	24
2603	1999-05-29	"Sat"	"Evening"	"224"	2	2	4	8
2602	1999-05-28	"Fri"	"Midday"	"487"	4	8	7	19
2601	1999-05-27	"Thu"	"Evening"	"450"	4	5	0	9
2600	1999-05-26	"Wed"	"Midday"	"900"	9	0	0	9
2599	1999-05-25	"Tue"	"Evening"	"496"	4	9	6	19
2598	1999-05-24	"Mon"	"Midday"	"789"	7	8	9	24
2597	1999-05-23	"Sun"	"Evening"	"278"	2	7	8	17
2596	1999-05-22	"Sat"	"Midday"	"412"	4	1	2	7
2595	1999-05-21	"Fri"	"Evening"	"101"	1	0	1	2
2594	1999-05-20	"Thu"	"Midday"	"115"	1	1	5	7
2593	1999-05-19	"Wed"	"Evening"	"851"	8	5	1	14
2592	1999-05-18	"Tue"	"Midday"	"466"	4	6	6	16
2591	1999-05-17	"Mon"	"Evening"	"480"	4	8	0	12
2590	1999-05-16	"Sun"	"Midday"	"378"	3	7	8	18
2589	1999-05-15	"Sat"	"Evening"	"202"	2	0	2	4
2588	1999-05-14	"Fri"	"Midday"	"699"	6	9	9	24
2587	1999-05-13	"Thu"	"Evening"	"812"	8	1	2	11
2586	1999-05-12	"Wed"	"Midday"	"032"	0	3	2	5
2585	1999-05-11	"Tue"	"Evening"	"367"	3	6	7	16
2584	1999-05-10	"Mon"	"Midday"	"082"	0	8	2	10
2583	1999-05-09	"Sun"	"Evening"	"055"	0	5	5	10
2582	1999-05-08	"Sat"	"Midday"	"688"	6	8	8	22
2581	1999-05-07	"Fri"	"Evening"	"297"	2	9	7	18
2580	1999-05-06	"Thu"	"Midday"	"961"	9	6	1	16
2579	1999-05-05	"Wed"	"Evening"	"102"	1	0	2	3
2578	1999-05-04	"Tue"	"Midday"	"589"	5	8	9	22
2577	1999-05-03	"Mon"	"Evening"	"116"	1	1	6	8
2576	1999-05-02	"Sun"	"Midday"	"917"	9	1	7	17
2575	1999-05-01	"Sat"	"Evening"	"961"	9	6	1	16
2574	1999-04-30	"Fri"	"Midday"	"133"	1	3	3	7
2573	1999-04-29	"Thu"	"Evening"	"595"	5	9	5	19
2572	1999-04-28	"Wed"	"Midday"	"154"	1	5	4	10
2571	1999-04-27	"Tue"	"Evening"	"188"	1	8	8	17
2570	1999-04-26	"Mon"	"Midday"	"324"	3	2	4	9
2569	1999-04-25	"Sun"	"Evening"	"331"	3	3	1	7
2568	1999-04-24	"Sat"	"Midday"	"872"	8	7	2	17
2567	1999-04-23	"Fri"	"Evening"	"189"	1	8	9	18
2566	1999-04-22	"Thu"	"Midday"	"688"	6	8	8	22
2565	1999-04-21	"Wed"	"Evening"	"604"	6	0	4	10
2564	1999-04-20	"Tue"	"Midday"	"176"	1	7	6	14
2563	1999-04-19	"Mon"	"Evening"	"776"	7	7	6	20
2562	1999-04-18	"Sun"	"Midday"	"199"	1	9	9	19
2561	1999-04-17	"Sat"	"Evening"	"019"	0	1	9	10
2560	1999-04-16	"Fri"	"Midday"	"998"	9	9	8	26
2559	1999-04-15	"Thu"	"Evening"	"833"	8	3	3	14
2558	1999-04-14	"Wed"	"Midday"	"759"	7	5	9	21
2557	1999-04-13	"Tue"	"Evening"	"345"	3	4	5	12
2556	1999-04-12	"Mon"	"Midday"	"623"	6	2	3	11
2555	1999-04-11	"Sun"	"Evening"	"759"	7	5	9	21
2554	1999-04-10	"Sat"	"Midday"	"946"	9	4	6	19
2553	1999-04-09	"Fri"	"Evening"	"956"	9	5	6	20
2552	1999-04-08	"Thu"	"Midday"	"203"	2	0	3	5
2551	1999-04-07	"Wed"	"Evening"	"416"	4	1	6	11
2550	1999-04-06	"Tue"	"Midday"	"596"	5	9	6	20
2549	1999-04-05	"Mon"	"Evening"	"395"	3	9	5	17
2548	1999-04-04	"Sun"	"Midday"	"421"	4	2	1	7
2547	1999-04-03	"Sat"	"Evening"	"345"	3	4	5	12
2546	1999-04-02	"Fri"	"Midday"	"229"	2	2	9	13
2545	1999-04-01	"Thu"	"Evening"	"317"	3	1	7	11
2544	1999-03-31	"Wed"	"Midday"	"794"	7	9	4	20
2543	1999-03-30	"Tue"	"Evening"	"429"	4	2	9	15
2542	1999-03-29	"Mon"	"Midday"	"063"	0	6	3	9
2541	1999-03-28	"Sun"	"Evening"	"308"	3	0	8	11
2540	1999-03-27	"Sat"	"Midday"	"735"	7	3	5	15
2539	1999-03-26	"Fri"	"Evening"	"554"	5	5	4	14
2538	1999-03-25	"Thu"	"Midday"	"281"	2	8	1	11
2537	1999-03-24	"Wed"	"Evening"	"173"	1	7	3	11
2536	1999-03-23	"Tue"	"Midday"	"517"	5	1	7	13
2535	1999-03-22	"Mon"	"Evening"	"454"	4	5	4	13
2534	1999-03-21	"Sun"	"Midday"	"012"	0	1	2	3
2533	1999-03-20	"Sat"	"Evening"	"172"	1	7	2	10
2532	1999-03-19	"Fri"	"Midday"	"970"	9	7	0	16
2531	1999-03-18	"Thu"	"Evening"	"068"	0	6	8	14
2530	1999-03-17	"Wed"	"Midday"	"506"	5	0	6	11
2529	1999-03-16	"Tue"	"Evening"	"991"	9	9	1	19
2528	1999-03-15	"Mon"	"Midday"	"538"	5	3	8	16
2527	1999-03-14	"Sun"	"Evening"	"213"	2	1	3	6
2526	1999-03-13	"Sat"	"Midday"	"029"	0	2	9	11
2525	1999-03-12	"Fri"	"Evening"	"910"	9	1	0	10
2524	1999-03-11	"Thu"	"Midday"	"051"	0	5	1	6
2523	1999-03-10	"Wed"	"Evening"	"923"	9	2	3	14
2522	1999-03-09	"Tue"	"Midday"	"152"	1	5	2	8
2521	1999-03-08	"Mon"	"Evening"	"778"	7	7	8	22
2520	1999-03-07	"Sun"	"Midday"	"718"	7	1	8	16
2519	1999-03-06	"Sat"	"Evening"	"154"	1	5	4	10
2518	1999-03-05	"Fri"	"Midday"	"039"	0	3	9	12
2517	1999-03-04	"Thu"	"Evening"	"286"	2	8	6	16
2516	1999-03-03	"Wed"	"Midday"	"139"	1	3	9	13
2515	1999-03-02	"Tue"	"Evening"	"916"	9	1	6	16
2514	1999-03-01	"Mon"	"Midday"	"083"	0	8	3	11
2513	1999-02-28	"Sun"	"Evening"	"274"	2	7	4	13
2512	1999-02-27	"Sat"	"Midday"	"262"	2	6	2	10
2511	1999-02-26	"Fri"	"Evening"	"057"	0	5	7	12
2510	1999-02-25	"Thu"	"Midday"	"816"	8	1	6	15
2509	1999-02-24	"Wed"	"Evening"	"208"	2	0	8	10
2508	1999-02-23	"Tue"	"Midday"	"433"	4	3	3	10
2507	1999-02-22	"Mon"	"Evening"	"324"	3	2	4	9
2506	1999-02-21	"Sun"	"Midday"	"964"	9	6	4	19
2505	1999-02-20	"Sat"	"Evening"	"554"	5	5	4	14
2504	1999-02-19	"Fri"	"Midday"	"887"	8	8	7	23
2503	1999-02-18	"Thu"	"Evening"	"090"	0	9	0	9
2502	1999-02-17	"Wed"	"Midday"	"386"	3	8	6	17
2501	1999-02-16	"Tue"	"Evening"	"353"	3	5	3	11
2500	1999-02-15	"Mon"	"Midday"	"761"	7	6	1	14
2499	1999-02-14	"Sun"	"Evening"	"249"	2	4	9	15
2498	1999-02-13	"Sat"	"Midday"	"874"	8	7	4	19
2497	1999-02-12	"Fri"	"Evening"	"758"	7	5	8	20
2496	1999-02-11	"Thu"	"Midday"	"077"	0	7	7	14
2495	1999-02-10	"Wed"	"Evening"	"364"	3	6	4	13
2494	1999-02-09	"Tue"	"Midday"	"437"	4	3	7	14
2493	1999-02-08	"Mon"	"Evening"	"208"	2	0	8	10
2492	1999-02-07	"Sun"	"Midday"	"596"	5	9	6	20
2491	1999-02-06	"Sat"	"Evening"	"829"	8	2	9	19
2490	1999-02-05	"Fri"	"Midday"	"570"	5	7	0	12
2489	1999-02-04	"Thu"	"Evening"	"060"	0	6	0	6
2488	1999-02-03	"Wed"	"Midday"	"210"	2	1	0	3
2487	1999-02-02	"Tue"	"Evening"	"159"	1	5	9	15
2486	1999-02-01	"Mon"	"Midday"	"997"	9	9	7	25
2485	1999-01-31	"Sun"	"Evening"	"596"	5	9	6	20
2484	1999-01-30	"Sat"	"Midday"	"736"	7	3	6	16
2483	1999-01-29	"Fri"	"Evening"	"114"	1	1	4	6
2482	1999-01-28	"Thu"	"Midday"	"014"	0	1	4	5
2481	1999-01-27	"Wed"	"Evening"	"748"	7	4	8	19
2480	1999-01-26	"Tue"	"Midday"	"666"	6	6	6	18
2479	1999-01-25	"Mon"	"Evening"	"613"	6	1	3	10
2478	1999-01-24	"Sun"	"Midday"	"471"	4	7	1	12
2477	1999-01-23	"Sat"	"Evening"	"152"	1	5	2	8
2476	1999-01-22	"Fri"	"Midday"	"382"	3	8	2	13
2475	1999-01-21	"Thu"	"Evening"	"715"	7	1	5	13
2474	1999-01-20	"Wed"	"Midday"	"031"	0	3	1	4
2473	1999-01-19	"Tue"	"Evening"	"460"	4	6	0	10
2472	1999-01-18	"Mon"	"Midday"	"677"	6	7	7	20
2471	1999-01-17	"Sun"	"Evening"	"899"	8	9	9	26
2470	1999-01-16	"Sat"	"Midday"	"138"	1	3	8	12
2469	1999-01-15	"Fri"	"Evening"	"354"	3	5	4	12
2468	1999-01-14	"Thu"	"Midday"	"391"	3	9	1	13
2467	1999-01-13	"Wed"	"Evening"	"004"	0	0	4	4
2466	1999-01-12	"Tue"	"Midday"	"557"	5	5	7	17
2465	1999-01-11	"Mon"	"Evening"	"898"	8	9	8	25
2464	1999-01-10	"Sun"	"Midday"	"320"	3	2	0	5
2463	1999-01-09	"Sat"	"Evening"	"027"	0	2	7	9
2462	1999-01-08	"Fri"	"Midday"	"732"	7	3	2	12
2461	1999-01-07	"Thu"	"Evening"	"066"	0	6	6	12
2460	1999-01-06	"Wed"	"Midday"	"300"	3	0	0	3
2459	1999-01-05	"Tue"	"Evening"	"002"	0	0	2	2
2458	1999-01-04	"Mon"	"Midday"	"050"	0	5	0	5
2457	1999-01-03	"Sun"	"Evening"	"659"	6	5	9	20
2456	1999-01-02	"Sat"	"Midday"	"062"	0	6	2	8
2455	1999-01-01	"Fri"	"Evening"	"275"	2	7	5	14
2454	1998-12-31	"Thu"	"Midday"	"865"	8	6	5	19
2453	1998-12-30	"Wed"	"Evening"	"936"	9	3	6	18
2452	1998-12-29	"Tue"	"Midday"	"905"	9	0	5	14
2451	1998-12-28	"Mon"	"Evening"	"355"	3	5	5	13
2450	1998-12-27	"Sun"	"Midday"	"572"	5	7	2	14
2449	1998-12-26	"Sat"	"Evening"	"683"	6	8	3	17
2448	1998-12-25	"Fri"	"Midday"	"585"	5	8	5	18
2447	1998-12-24	"Thu"	"Evening"	"023"	0	2	3	5
2446	1998-12-23	"Wed"	"Midday"	"126"	1	2	6	9
2445	1998-12-22	"Tue"	"Evening"	"527"	5	2	7	14
2444	1998-12-21	"Mon"	"Midday"	"172"	1	7	2	10
2443	1998-12-20	"Sun"	"Evening"	"472"	4	7	2	13
2442	1998-12-19	"Sat"	"Midday"	"253"	2	5	3	10
2441	1998-12-18	"Fri"	"Evening"	"733"	7	3	3	13
2440	1998-12-17	"Thu"	"Midday"	"358"	3	5	8	16
2439	1998-12-16	"Wed"	"Evening"	"074"	0	7	4	11
2438	1998-12-15	"Tue"	"Midday"	"188"	1	8	8	17
2437	1998-12-14	"Mon"	"Evening"	"054"	0	5	4	9
2436	1998-12-13	"Sun"	"Midday"	"619"	6	1	9	16
2435	1998-12-12	"Sat"	"Evening"	"046"	0	4	6	10
2434	1998-12-11	"Fri"	"Midday"	"785"	7	8	5	20
2433	1998-12-10	"Thu"	"Evening"	"653"	6	5	3	14
2432	1998-12-09	"Wed"	"Midday"	"514"	5	1	4	10
2431	1998-12-08	"Tue"	"Evening"	"409"	4	0	9	13
2430	1998-12-07	"Mon"	"Midday"	"796"	7	9	6	22
2429	1998-12-06	"Sun"	"Evening"	"424"	4	2	4	10
2428	1998-12-05	"Sat"	"Midday"	"996"	9	9	6	24
2427	1998-12-04	"Fri"	"Evening"	"089"	0	8	9	17
2426	1998-12-03	"Thu"	"Midday"	"291"	2	9	1	12
2425	1998-12-02	"Wed"	"Evening"	"421"	4	2	1	7
2424	1998-12-01	"Tue"	"Midday"	"002"	0	0	2	2
2423	1998-11-30	"Mon"	"Evening"	"934"	9	3	4	16
2422	1998-11-29	"Sun"	"Midday"	"631"	6	3	1	10
2421	1998-11-28	"Sat"	"Evening"	"621"	6	2	1	9
2420	1998-11-27	"Fri"	"Midday"	"131"	1	3	1	5
2419	1998-11-26	"Thu"	"Evening"	"599"	5	9	9	23
2418	1998-11-25	"Wed"	"Midday"	"621"	6	2	1	9
2417	1998-11-24	"Tue"	"Evening"	"900"	9	0	0	9
2416	1998-11-23	"Mon"	"Midday"	"964"	9	6	4	19
2415	1998-11-22	"Sun"	"Evening"	"763"	7	6	3	16
2414	1998-11-21	"Sat"	"Midday"	"690"	6	9	0	15
2413	1998-11-20	"Fri"	"Evening"	"255"	2	5	5	12
2412	1998-11-19	"Thu"	"Midday"	"171"	1	7	1	9
2411	1998-11-18	"Wed"	"Evening"	"760"	7	6	0	13
2410	1998-11-17	"Tue"	"Midday"	"506"	5	0	6	11
2409	1998-11-16	"Mon"	"Evening"	"207"	2	0	7	9
2408	1998-11-15	"Sun"	"Midday"	"568"	5	6	8	19
2407	1998-11-14	"Sat"	"Evening"	"841"	8	4	1	13
2406	1998-11-13	"Fri"	"Midday"	"068"	0	6	8	14
2405	1998-11-12	"Thu"	"Evening"	"210"	2	1	0	3
2404	1998-11-11	"Wed"	"Midday"	"550"	5	5	0	10
2403	1998-11-10	"Tue"	"Evening"	"325"	3	2	5	10
2402	1998-11-09	"Mon"	"Midday"	"565"	5	6	5	16
2401	1998-11-08	"Sun"	"Evening"	"106"	1	0	6	7
2400	1998-11-07	"Sat"	"Midday"	"529"	5	2	9	16
2399	1998-11-06	"Fri"	"Evening"	"177"	1	7	7	15
2398	1998-11-05	"Thu"	"Midday"	"380"	3	8	0	11
2397	1998-11-04	"Wed"	"Evening"	"191"	1	9	1	11
2396	1998-11-03	"Tue"	"Midday"	"069"	0	6	9	15
2395	1998-11-02	"Mon"	"Evening"	"219"	2	1	9	12
2394	1998-11-01	"Sun"	"Midday"	"717"	7	1	7	15
2393	1998-10-31	"Sat"	"Evening"	"911"	9	1	1	11
2392	1998-10-30	"Fri"	"Midday"	"554"	5	5	4	14
2391	1998-10-29	"Thu"	"Evening"	"359"	3	5	9	17
2390	1998-10-28	"Wed"	"Midday"	"884"	8	8	4	20
2389	1998-10-27	"Tue"	"Evening"	"356"	3	5	6	14
2388	1998-10-26	"Mon"	"Midday"	"976"	9	7	6	22
2387	1998-10-25	"Sun"	"Evening"	"086"	0	8	6	14
2386	1998-10-24	"Sat"	"Midday"	"264"	2	6	4	12
2385	1998-10-23	"Fri"	"Evening"	"688"	6	8	8	22
2384	1998-10-22	"Thu"	"Midday"	"101"	1	0	1	2
2383	1998-10-21	"Wed"	"Evening"	"067"	0	6	7	13
2382	1998-10-20	"Tue"	"Midday"	"852"	8	5	2	15
2381	1998-10-19	"Mon"	"Evening"	"074"	0	7	4	11
2380	1998-10-18	"Sun"	"Midday"	"186"	1	8	6	15
2379	1998-10-17	"Sat"	"Evening"	"300"	3	0	0	3
2378	1998-10-16	"Fri"	"Midday"	"694"	6	9	4	19
2377	1998-10-15	"Thu"	"Evening"	"216"	2	1	6	9
2376	1998-10-14	"Wed"	"Midday"	"296"	2	9	6	17
2375	1998-10-13	"Tue"	"Evening"	"508"	5	0	8	13
2374	1998-10-12	"Mon"	"Midday"	"446"	4	4	6	14
2373	1998-10-11	"Sun"	"Evening"	"107"	1	0	7	8
2372	1998-10-10	"Sat"	"Midday"	"676"	6	7	6	19
2371	1998-10-09	"Fri"	"Evening"	"021"	0	2	1	3
2370	1998-10-08	"Thu"	"Midday"	"799"	7	9	9	25
2369	1998-10-07	"Wed"	"Evening"	"605"	6	0	5	11
2368	1998-10-06	"Tue"	"Midday"	"976"	9	7	6	22
2367	1998-10-05	"Mon"	"Evening"	"261"	2	6	1	9
2366	1998-10-04	"Sun"	"Midday"	"856"	8	5	6	19
2365	1998-10-03	"Sat"	"Evening"	"318"	3	1	8	12
2364	1998-10-02	"Fri"	"Midday"	"545"	5	4	5	14
2363	1998-10-01	"Thu"	"Evening"	"303"	3	0	3	6
2362	1998-09-30	"Wed"	"Midday"	"457"	4	5	7	16
2361	1998-09-29	"Tue"	"Evening"	"376"	3	7	6	16
2360	1998-09-28	"Mon"	"Midday"	"508"	5	0	8	13
2359	1998-09-27	"Sun"	"Evening"	"451"	4	5	1	10
2358	1998-09-26	"Sat"	"Midday"	"792"	7	9	2	18
2357	1998-09-25	"Fri"	"Evening"	"126"	1	2	6	9
2356	1998-09-24	"Thu"	"Midday"	"321"	3	2	1	6
2355	1998-09-23	"Wed"	"Evening"	"746"	7	4	6	17
2354	1998-09-22	"Tue"	"Midday"	"712"	7	1	2	10
2353	1998-09-21	"Mon"	"Evening"	"331"	3	3	1	7
2352	1998-09-20	"Sun"	"Midday"	"319"	3	1	9	13
2351	1998-09-19	"Sat"	"Evening"	"083"	0	8	3	11
2350	1998-09-18	"Fri"	"Midday"	"490"	4	9	0	13
2349	1998-09-17	"Thu"	"Evening"	"613"	6	1	3	10
2348	1998-09-16	"Wed"	"Midday"	"618"	6	1	8	15
2347	1998-09-15	"Tue"	"Evening"	"375"	3	7	5	15
2346	1998-09-14	"Mon"	"Midday"	"022"	0	2	2	4
2345	1998-09-13	"Sun"	"Evening"	"549"	5	4	9	18
2344	1998-09-12	"Sat"	"Midday"	"069"	0	6	9	15
2343	1998-09-11	"Fri"	"Evening"	"454"	4	5	4	13
2342	1998-09-10	"Thu"	"Midday"	"981"	9	8	1	18
2341	1998-09-09	"Wed"	"Evening"	"925"	9	2	5	16
2340	1998-09-08	"Tue"	"Midday"	"840"	8	4	0	12
2339	1998-09-07	"Mon"	"Evening"	"279"	2	7	9	18
2338	1998-09-06	"Sun"	"Midday"	"513"	5	1	3	9
2337	1998-09-05	"Sat"	"Evening"	"221"	2	2	1	5
2336	1998-09-04	"Fri"	"Midday"	"317"	3	1	7	11
2335	1998-09-03	"Thu"	"Evening"	"057"	0	5	7	12
2334	1998-09-02	"Wed"	"Midday"	"954"	9	5	4	18
2333	1998-09-01	"Tue"	"Evening"	"314"	3	1	4	8
2332	1998-08-31	"Mon"	"Midday"	"649"	6	4	9	19
2331	1998-08-30	"Sun"	"Evening"	"133"	1	3	3	7
2330	1998-08-29	"Sat"	"Midday"	"422"	4	2	2	8
2329	1998-08-28	"Fri"	"Evening"	"222"	2	2	2	6
2328	1998-08-27	"Thu"	"Midday"	"256"	2	5	6	13
2327	1998-08-26	"Wed"	"Evening"	"672"	6	7	2	15
2326	1998-08-25	"Tue"	"Midday"	"322"	3	2	2	7
2325	1998-08-24	"Mon"	"Evening"	"481"	4	8	1	13
2324	1998-08-23	"Sun"	"Midday"	"289"	2	8	9	19
2323	1998-08-22	"Sat"	"Evening"	"167"	1	6	7	14
2322	1998-08-21	"Fri"	"Midday"	"230"	2	3	0	5
2321	1998-08-20	"Thu"	"Evening"	"290"	2	9	0	11
2320	1998-08-19	"Wed"	"Midday"	"205"	2	0	5	7
2319	1998-08-18	"Tue"	"Evening"	"337"	3	3	7	13
2318	1998-08-17	"Mon"	"Midday"	"712"	7	1	2	10
2317	1998-08-16	"Sun"	"Evening"	"041"	0	4	1	5
2316	1998-08-15	"Sat"	"Midday"	"412"	4	1	2	7
2315	1998-08-14	"Fri"	"Evening"	"658"	6	5	8	19
2314	1998-08-13	"Thu"	"Midday"	"750"	7	5	0	12
2313	1998-08-12	"Wed"	"Evening"	"296"	2	9	6	17
2312	1998-08-11	"Tue"	"Midday"	"310"	3	1	0	4
2311	1998-08-10	"Mon"	"Evening"	"299"	2	9	9	20
2310	1998-08-09	"Sun"	"Midday"	"316"	3	1	6	10
2309	1998-08-08	"Sat"	"Evening"	"579"	5	7	9	21
2308	1998-08-07	"Fri"	"Midday"	"821"	8	2	1	11
2307	1998-08-06	"Thu"	"Evening"	"734"	7	3	4	14
2306	1998-08-05	"Wed"	"Midday"	"838"	8	3	8	19
2305	1998-08-04	"Tue"	"Evening"	"069"	0	6	9	15
2304	1998-08-03	"Mon"	"Midday"	"497"	4	9	7	20
2303	1998-08-02	"Sun"	"Evening"	"676"	6	7	6	19
2302	1998-08-01	"Sat"	"Midday"	"932"	9	3	2	14
2301	1998-07-31	"Fri"	"Evening"	"631"	6	3	1	10
2300	1998-07-30	"Thu"	"Midday"	"444"	4	4	4	12
2299	1998-07-29	"Wed"	"Evening"	"879"	8	7	9	24
2298	1998-07-28	"Tue"	"Midday"	"211"	2	1	1	4
2297	1998-07-27	"Mon"	"Evening"	"729"	7	2	9	18
2296	1998-07-26	"Sun"	"Midday"	"015"	0	1	5	6
2295	1998-07-25	"Sat"	"Evening"	"673"	6	7	3	16
2294	1998-07-24	"Fri"	"Midday"	"863"	8	6	3	17
2293	1998-07-23	"Thu"	"Evening"	"923"	9	2	3	14
2292	1998-07-22	"Wed"	"Midday"	"584"	5	8	4	17
2291	1998-07-21	"Tue"	"Evening"	"891"	8	9	1	18
2290	1998-07-20	"Mon"	"Midday"	"053"	0	5	3	8
2289	1998-07-19	"Sun"	"Evening"	"338"	3	3	8	14
2288	1998-07-18	"Sat"	"Midday"	"648"	6	4	8	18
2287	1998-07-17	"Fri"	"Evening"	"308"	3	0	8	11
2286	1998-07-16	"Thu"	"Midday"	"236"	2	3	6	11
2285	1998-07-15	"Wed"	"Evening"	"456"	4	5	6	15
2284	1998-07-14	"Tue"	"Midday"	"746"	7	4	6	17
2283	1998-07-13	"Mon"	"Evening"	"361"	3	6	1	10
2282	1998-07-12	"Sun"	"Midday"	"843"	8	4	3	15
2281	1998-07-11	"Sat"	"Evening"	"230"	2	3	0	5
2280	1998-07-10	"Fri"	"Midday"	"174"	1	7	4	12
2279	1998-07-09	"Thu"	"Evening"	"812"	8	1	2	11
2278	1998-07-08	"Wed"	"Midday"	"197"	1	9	7	17
2277	1998-07-07	"Tue"	"Evening"	"987"	9	8	7	24
2276	1998-07-06	"Mon"	"Midday"	"903"	9	0	3	12
2275	1998-07-05	"Sun"	"Evening"	"817"	8	1	7	16
2274	1998-07-04	"Sat"	"Midday"	"826"	8	2	6	16
2273	1998-07-03	"Fri"	"Evening"	"440"	4	4	0	8
2272	1998-07-02	"Thu"	"Midday"	"430"	4	3	0	7
2271	1998-07-01	"Wed"	"Evening"	"236"	2	3	6	11
2270	1998-06-30	"Tue"	"Midday"	"881"	8	8	1	17
2269	1998-06-29	"Mon"	"Evening"	"578"	5	7	8	20
2268	1998-06-28	"Sun"	"Midday"	"445"	4	4	5	13
2267	1998-06-27	"Sat"	"Evening"	"674"	6	7	4	17
2266	1998-06-26	"Fri"	"Midday"	"603"	6	0	3	9
2265	1998-06-25	"Thu"	"Evening"	"039"	0	3	9	12
2264	1998-06-24	"Wed"	"Midday"	"710"	7	1	0	8
2263	1998-06-23	"Tue"	"Evening"	"706"	7	0	6	13
2262	1998-06-22	"Mon"	"Midday"	"983"	9	8	3	20
2261	1998-06-21	"Sun"	"Evening"	"135"	1	3	5	9
2260	1998-06-20	"Sat"	"Midday"	"375"	3	7	5	15
2259	1998-06-19	"Fri"	"Evening"	"346"	3	4	6	13
2258	1998-06-18	"Thu"	"Midday"	"743"	7	4	3	14
2257	1998-06-17	"Wed"	"Evening"	"530"	5	3	0	8
2256	1998-06-16	"Tue"	"Midday"	"693"	6	9	3	18
2255	1998-06-15	"Mon"	"Evening"	"028"	0	2	8	10
2254	1998-06-14	"Sun"	"Midday"	"078"	0	7	8	15
2253	1998-06-13	"Sat"	"Evening"	"229"	2	2	9	13
2252	1998-06-12	"Fri"	"Midday"	"142"	1	4	2	7
2251	1998-06-11	"Thu"	"Evening"	"927"	9	2	7	18
2250	1998-06-10	"Wed"	"Midday"	"170"	1	7	0	8
2249	1998-06-09	"Tue"	"Evening"	"812"	8	1	2	11
2248	1998-06-08	"Mon"	"Midday"	"534"	5	3	4	12
2247	1998-06-07	"Sun"	"Evening"	"780"	7	8	0	15
2246	1998-06-06	"Sat"	"Midday"	"325"	3	2	5	10
2245	1998-06-05	"Fri"	"Evening"	"539"	5	3	9	17
2244	1998-06-04	"Thu"	"Midday"	"652"	6	5	2	13
2243	1998-06-03	"Wed"	"Evening"	"411"	4	1	1	6
2242	1998-06-02	"Tue"	"Midday"	"021"	0	2	1	3
2241	1998-06-01	"Mon"	"Evening"	"911"	9	1	1	11
2240	1998-05-31	"Sun"	"Midday"	"271"	2	7	1	10
2239	1998-05-30	"Sat"	"Evening"	"136"	1	3	6	10
2238	1998-05-29	"Fri"	"Midday"	"088"	0	8	8	16
2237	1998-05-28	"Thu"	"Evening"	"650"	6	5	0	11
2236	1998-05-27	"Wed"	"Midday"	"192"	1	9	2	12
2235	1998-05-26	"Tue"	"Evening"	"984"	9	8	4	21
2234	1998-05-25	"Mon"	"Midday"	"756"	7	5	6	18
2233	1998-05-24	"Sun"	"Evening"	"104"	1	0	4	5
2232	1998-05-23	"Sat"	"Midday"	"406"	4	0	6	10
2231	1998-05-22	"Fri"	"Evening"	"533"	5	3	3	11
2230	1998-05-21	"Thu"	"Midday"	"462"	4	6	2	12
2229	1998-05-20	"Wed"	"Evening"	"159"	1	5	9	15
2228	1998-05-19	"Tue"	"Midday"	"673"	6	7	3	16
2227	1998-05-18	"Mon"	"Evening"	"197"	1	9	7	17
2226	1998-05-17	"Sun"	"Midday"	"988"	9	8	8	25
2225	1998-05-16	"Sat"	"Evening"	"880"	8	8	0	16
2224	1998-05-15	"Fri"	"Midday"	"154"	1	5	4	10
2223	1998-05-14	"Thu"	"Evening"	"580"	5	8	0	13
2222	1998-05-13	"Wed"	"Midday"	"190"	1	9	0	10
2221	1998-05-12	"Tue"	"Evening"	"092"	0	9	2	11
2220	1998-05-11	"Mon"	"Midday"	"868"	8	6	8	22
2219	1998-05-10	"Sun"	"Evening"	"412"	4	1	2	7
2218	1998-05-09	"Sat"	"Midday"	"770"	7	7	0	14
2217	1998-05-08	"Fri"	"Evening"	"950"	9	5	0	14
2216	1998-05-07	"Thu"	"Midday"	"488"	4	8	8	20
2215	1998-05-06	"Wed"	"Evening"	"030"	0	3	0	3
2214	1998-05-05	"Tue"	"Midday"	"811"	8	1	1	10
2213	1998-05-04	"Mon"	"Evening"	"204"	2	0	4	6
2212	1998-05-03	"Sun"	"Midday"	"214"	2	1	4	7
2211	1998-05-02	"Sat"	"Evening"	"174"	1	7	4	12
2210	1998-05-01	"Fri"	"Midday"	"933"	9	3	3	15
2209	1998-04-30	"Thu"	"Evening"	"776"	7	7	6	20
2208	1998-04-29	"Wed"	"Midday"	"049"	0	4	9	13
2207	1998-04-28	"Tue"	"Evening"	"806"	8	0	6	14
2206	1998-04-27	"Mon"	"Midday"	"366"	3	6	6	15
2205	1998-04-26	"Sun"	"Evening"	"981"	9	8	1	18
2204	1998-04-25	"Sat"	"Midday"	"809"	8	0	9	17
2203	1998-04-24	"Fri"	"Evening"	"969"	9	6	9	24
2202	1998-04-23	"Thu"	"Midday"	"499"	4	9	9	22
2201	1998-04-22	"Wed"	"Evening"	"492"	4	9	2	15
2200	1998-04-21	"Tue"	"Midday"	"186"	1	8	6	15
2199	1998-04-20	"Mon"	"Evening"	"856"	8	5	6	19
2198	1998-04-19	"Sun"	"Midday"	"350"	3	5	0	8
2197	1998-04-18	"Sat"	"Evening"	"237"	2	3	7	12
2196	1998-04-17	"Fri"	"Midday"	"059"	0	5	9	14
2195	1998-04-16	"Thu"	"Evening"	"942"	9	4	2	15
2194	1998-04-15	"Wed"	"Midday"	"856"	8	5	6	19
2193	1998-04-14	"Tue"	"Evening"	"680"	6	8	0	14
2192	1998-04-13	"Mon"	"Midday"	"580"	5	8	0	13
2191	1998-04-12	"Sun"	"Evening"	"508"	5	0	8	13
2190	1998-04-11	"Sat"	"Midday"	"015"	0	1	5	6
2189	1998-04-10	"Fri"	"Evening"	"139"	1	3	9	13
2188	1998-04-09	"Thu"	"Midday"	"111"	1	1	1	3
2187	1998-04-08	"Wed"	"Evening"	"422"	4	2	2	8
2186	1998-04-07	"Tue"	"Midday"	"805"	8	0	5	13
2185	1998-04-06	"Mon"	"Evening"	"824"	8	2	4	14
2184	1998-04-05	"Sun"	"Midday"	"266"	2	6	6	14
2183	1998-04-04	"Sat"	"Evening"	"457"	4	5	7	16
2182	1998-04-03	"Fri"	"Midday"	"760"	7	6	0	13
2181	1998-04-02	"Thu"	"Evening"	"499"	4	9	9	22
2180	1998-04-01	"Wed"	"Midday"	"740"	7	4	0	11
2179	1998-03-31	"Tue"	"Evening"	"218"	2	1	8	11
2178	1998-03-30	"Mon"	"Midday"	"956"	9	5	6	20
2177	1998-03-29	"Sun"	"Evening"	"015"	0	1	5	6
2176	1998-03-28	"Sat"	"Midday"	"963"	9	6	3	18
2175	1998-03-27	"Fri"	"Evening"	"404"	4	0	4	8
2174	1998-03-26	"Thu"	"Midday"	"903"	9	0	3	12
2173	1998-03-25	"Wed"	"Evening"	"654"	6	5	4	15
2172	1998-03-24	"Tue"	"Midday"	"965"	9	6	5	20
2171	1998-03-23	"Mon"	"Evening"	"736"	7	3	6	16
2170	1998-03-22	"Sun"	"Midday"	"696"	6	9	6	21
2169	1998-03-21	"Sat"	"Evening"	"953"	9	5	3	17
2168	1998-03-20	"Fri"	"Midday"	"620"	6	2	0	8
2167	1998-03-19	"Thu"	"Evening"	"981"	9	8	1	18
2166	1998-03-18	"Wed"	"Midday"	"552"	5	5	2	12
2165	1998-03-17	"Tue"	"Evening"	"437"	4	3	7	14
2164	1998-03-16	"Mon"	"Midday"	"846"	8	4	6	18
2163	1998-03-15	"Sun"	"Evening"	"556"	5	5	6	16
2162	1998-03-14	"Sat"	"Midday"	"542"	5	4	2	11
2161	1998-03-13	"Fri"	"Evening"	"841"	8	4	1	13
2160	1998-03-12	"Thu"	"Midday"	"011"	0	1	1	2
2159	1998-03-11	"Wed"	"Evening"	"681"	6	8	1	15
2158	1998-03-10	"Tue"	"Midday"	"935"	9	3	5	17
2157	1998-03-09	"Mon"	"Evening"	"824"	8	2	4	14
2156	1998-03-08	"Sun"	"Midday"	"371"	3	7	1	11
2155	1998-03-07	"Sat"	"Evening"	"163"	1	6	3	10
2154	1998-03-06	"Fri"	"Midday"	"885"	8	8	5	21
2153	1998-03-05	"Thu"	"Evening"	"372"	3	7	2	12
2152	1998-03-04	"Wed"	"Midday"	"686"	6	8	6	20
2151	1998-03-03	"Tue"	"Evening"	"842"	8	4	2	14
2150	1998-03-02	"Mon"	"Midday"	"331"	3	3	1	7
2149	1998-03-01	"Sun"	"Evening"	"557"	5	5	7	17
2148	1998-02-28	"Sat"	"Midday"	"050"	0	5	0	5
2147	1998-02-27	"Fri"	"Evening"	"588"	5	8	8	21
2146	1998-02-26	"Thu"	"Midday"	"650"	6	5	0	11
2145	1998-02-25	"Wed"	"Evening"	"017"	0	1	7	8
2144	1998-02-24	"Tue"	"Midday"	"873"	8	7	3	18
2143	1998-02-23	"Mon"	"Evening"	"793"	7	9	3	19
2142	1998-02-22	"Sun"	"Midday"	"888"	8	8	8	24
2141	1998-02-21	"Sat"	"Evening"	"608"	6	0	8	14
2140	1998-02-20	"Fri"	"Midday"	"764"	7	6	4	17
2139	1998-02-19	"Thu"	"Evening"	"910"	9	1	0	10
2138	1998-02-18	"Wed"	"Midday"	"985"	9	8	5	22
2137	1998-02-17	"Tue"	"Evening"	"520"	5	2	0	7
2136	1998-02-16	"Mon"	"Midday"	"766"	7	6	6	19
2135	1998-02-15	"Sun"	"Evening"	"937"	9	3	7	19
2134	1998-02-14	"Sat"	"Midday"	"817"	8	1	7	16
2133	1998-02-13	"Fri"	"Evening"	"561"	5	6	1	12
2132	1998-02-12	"Thu"	"Midday"	"568"	5	6	8	19
2131	1998-02-11	"Wed"	"Evening"	"830"	8	3	0	11
2130	1998-02-10	"Tue"	"Midday"	"063"	0	6	3	9
2129	1998-02-09	"Mon"	"Evening"	"478"	4	7	8	19
2128	1998-02-08	"Sun"	"Midday"	"228"	2	2	8	12
2127	1998-02-07	"Sat"	"Evening"	"046"	0	4	6	10
2126	1998-02-06	"Fri"	"Midday"	"464"	4	6	4	14
2125	1998-02-05	"Thu"	"Evening"	"716"	7	1	6	14
2124	1998-02-04	"Wed"	"Midday"	"976"	9	7	6	22
2123	1998-02-03	"Tue"	"Evening"	"686"	6	8	6	20
2122	1998-02-02	"Mon"	"Midday"	"575"	5	7	5	17
2121	1998-02-01	"Sun"	"Evening"	"094"	0	9	4	13
2120	1998-01-31	"Sat"	"Midday"	"930"	9	3	0	12
2119	1998-01-30	"Fri"	"Evening"	"046"	0	4	6	10
2118	1998-01-29	"Thu"	"Midday"	"262"	2	6	2	10
2117	1998-01-28	"Wed"	"Evening"	"566"	5	6	6	17
2116	1998-01-27	"Tue"	"Midday"	"285"	2	8	5	15
2115	1998-01-26	"Mon"	"Evening"	"890"	8	9	0	17
2114	1998-01-25	"Sun"	"Midday"	"555"	5	5	5	15
2113	1998-01-24	"Sat"	"Evening"	"009"	0	0	9	9
2112	1998-01-23	"Fri"	"Midday"	"975"	9	7	5	21
2111	1998-01-22	"Thu"	"Evening"	"786"	7	8	6	21
2110	1998-01-21	"Wed"	"Midday"	"734"	7	3	4	14
2109	1998-01-20	"Tue"	"Evening"	"590"	5	9	0	14
2108	1998-01-19	"Mon"	"Midday"	"622"	6	2	2	10
2107	1998-01-18	"Sun"	"Evening"	"256"	2	5	6	13
2106	1998-01-17	"Sat"	"Midday"	"325"	3	2	5	10
2105	1998-01-16	"Fri"	"Evening"	"715"	7	1	5	13
2104	1998-01-15	"Thu"	"Midday"	"378"	3	7	8	18
2103	1998-01-14	"Wed"	"Evening"	"036"	0	3	6	9
2102	1998-01-13	"Tue"	"Midday"	"482"	4	8	2	14
2101	1998-01-12	"Mon"	"Evening"	"837"	8	3	7	18
2100	1998-01-11	"Sun"	"Midday"	"330"	3	3	0	6
2099	1998-01-10	"Sat"	"Evening"	"701"	7	0	1	8
2098	1998-01-09	"Fri"	"Midday"	"392"	3	9	2	14
2097	1998-01-08	"Thu"	"Evening"	"938"	9	3	8	20
2096	1998-01-07	"Wed"	"Midday"	"019"	0	1	9	10
2095	1998-01-06	"Tue"	"Evening"	"054"	0	5	4	9
2094	1998-01-05	"Mon"	"Midday"	"195"	1	9	5	15
2093	1998-01-04	"Sun"	"Evening"	"321"	3	2	1	6
2092	1998-01-03	"Sat"	"Midday"	"899"	8	9	9	26
2091	1998-01-02	"Fri"	"Evening"	"812"	8	1	2	11
2090	1998-01-01	"Thu"	"Midday"	"962"	9	6	2	17
2089	1997-12-31	"Wed"	"Evening"	"514"	5	1	4	10
2088	1997-12-30	"Tue"	"Midday"	"387"	3	8	7	18
2087	1997-12-29	"Mon"	"Evening"	"494"	4	9	4	17
2086	1997-12-28	"Sun"	"Midday"	"312"	3	1	2	6
2085	1997-12-27	"Sat"	"Evening"	"111"	1	1	1	3
2084	1997-12-26	"Fri"	"Midday"	"398"	3	9	8	20
2083	1997-12-25	"Thu"	"Evening"	"786"	7	8	6	21
2082	1997-12-24	"Wed"	"Midday"	"083"	0	8	3	11
2081	1997-12-23	"Tue"	"Evening"	"915"	9	1	5	15
2080	1997-12-22	"Mon"	"Midday"	"508"	5	0	8	13
2079	1997-12-21	"Sun"	"Evening"	"101"	1	0	1	2
2078	1997-12-20	"Sat"	"Midday"	"748"	7	4	8	19
2077	1997-12-19	"Fri"	"Evening"	"954"	9	5	4	18
2076	1997-12-18	"Thu"	"Midday"	"120"	1	2	0	3
2075	1997-12-17	"Wed"	"Evening"	"515"	5	1	5	11
2074	1997-12-16	"Tue"	"Midday"	"426"	4	2	6	12
2073	1997-12-15	"Mon"	"Evening"	"601"	6	0	1	7
2072	1997-12-14	"Sun"	"Midday"	"405"	4	0	5	9
2071	1997-12-13	"Sat"	"Evening"	"239"	2	3	9	14
2070	1997-12-12	"Fri"	"Midday"	"563"	5	6	3	14
2069	1997-12-11	"Thu"	"Evening"	"451"	4	5	1	10
2068	1997-12-10	"Wed"	"Midday"	"826"	8	2	6	16
2067	1997-12-09	"Tue"	"Evening"	"273"	2	7	3	12
2066	1997-12-08	"Mon"	"Midday"	"547"	5	4	7	16
2065	1997-12-07	"Sun"	"Evening"	"484"	4	8	4	16
2064	1997-12-06	"Sat"	"Midday"	"052"	0	5	2	7
2063	1997-12-05	"Fri"	"Evening"	"030"	0	3	0	3
2062	1997-12-04	"Thu"	"Midday"	"185"	1	8	5	14
2061	1997-12-03	"Wed"	"Evening"	"849"	8	4	9	21
2060	1997-12-02	"Tue"	"Midday"	"404"	4	0	4	8
2059	1997-12-01	"Mon"	"Evening"	"745"	7	4	5	16
2058	1997-11-30	"Sun"	"Midday"	"302"	3	0	2	5
2057	1997-11-29	"Sat"	"Evening"	"894"	8	9	4	21
2056	1997-11-28	"Fri"	"Midday"	"493"	4	9	3	16
2055	1997-11-27	"Thu"	"Evening"	"059"	0	5	9	14
2054	1997-11-26	"Wed"	"Midday"	"884"	8	8	4	20
2053	1997-11-25	"Tue"	"Evening"	"760"	7	6	0	13
2052	1997-11-24	"Mon"	"Midday"	"135"	1	3	5	9
2051	1997-11-23	"Sun"	"Evening"	"262"	2	6	2	10
2050	1997-11-22	"Sat"	"Midday"	"827"	8	2	7	17
2049	1997-11-21	"Fri"	"Evening"	"385"	3	8	5	16
2048	1997-11-20	"Thu"	"Midday"	"747"	7	4	7	18
2047	1997-11-19	"Wed"	"Evening"	"865"	8	6	5	19
2046	1997-11-18	"Tue"	"Midday"	"003"	0	0	3	3
2045	1997-11-17	"Mon"	"Evening"	"254"	2	5	4	11
2044	1997-11-16	"Sun"	"Midday"	"024"	0	2	4	6
2043	1997-11-15	"Sat"	"Evening"	"447"	4	4	7	15
2042	1997-11-14	"Fri"	"Midday"	"138"	1	3	8	12
2041	1997-11-13	"Thu"	"Evening"	"469"	4	6	9	19
2040	1997-11-12	"Wed"	"Midday"	"279"	2	7	9	18
2039	1997-11-11	"Tue"	"Evening"	"710"	7	1	0	8
2038	1997-11-10	"Mon"	"Midday"	"175"	1	7	5	13
2037	1997-11-09	"Sun"	"Evening"	"258"	2	5	8	15
2036	1997-11-08	"Sat"	"Midday"	"531"	5	3	1	9
2035	1997-11-07	"Fri"	"Evening"	"513"	5	1	3	9
2034	1997-11-06	"Thu"	"Midday"	"678"	6	7	8	21
2033	1997-11-05	"Wed"	"Evening"	"574"	5	7	4	16
2032	1997-11-04	"Tue"	"Midday"	"547"	5	4	7	16
2031	1997-11-03	"Mon"	"Evening"	"173"	1	7	3	11
2030	1997-11-02	"Sun"	"Midday"	"871"	8	7	1	16
2029	1997-11-01	"Sat"	"Evening"	"171"	1	7	1	9
2028	1997-10-31	"Fri"	"Midday"	"670"	6	7	0	13
2027	1997-10-30	"Thu"	"Evening"	"902"	9	0	2	11
2026	1997-10-29	"Wed"	"Midday"	"529"	5	2	9	16
2025	1997-10-28	"Tue"	"Evening"	"619"	6	1	9	16
2024	1997-10-27	"Mon"	"Midday"	"198"	1	9	8	18
2023	1997-10-26	"Sun"	"Evening"	"328"	3	2	8	13
2022	1997-10-25	"Sat"	"Midday"	"053"	0	5	3	8
2021	1997-10-24	"Fri"	"Evening"	"842"	8	4	2	14
2020	1997-10-23	"Thu"	"Midday"	"212"	2	1	2	5
2019	1997-10-22	"Wed"	"Evening"	"148"	1	4	8	13
2018	1997-10-21	"Tue"	"Midday"	"159"	1	5	9	15
2017	1997-10-20	"Mon"	"Evening"	"970"	9	7	0	16
2016	1997-10-19	"Sun"	"Midday"	"000"	0	0	0	0
2015	1997-10-18	"Sat"	"Evening"	"185"	1	8	5	14
2014	1997-10-17	"Fri"	"Midday"	"329"	3	2	9	14
2013	1997-10-16	"Thu"	"Evening"	"785"	7	8	5	20
2012	1997-10-15	"Wed"	"Midday"	"995"	9	9	5	23
2011	1997-10-14	"Tue"	"Evening"	"662"	6	6	2	14
2010	1997-10-13	"Mon"	"Midday"	"576"	5	7	6	18
2009	1997-10-12	"Sun"	"Evening"	"536"	5	3	6	14
2008	1997-10-11	"Sat"	"Midday"	"949"	9	4	9	22
2007	1997-10-10	"Fri"	"Evening"	"380"	3	8	0	11
2006	1997-10-09	"Thu"	"Midday"	"678"	6	7	8	21
2005	1997-10-08	"Wed"	"Evening"	"889"	8	8	9	25
2004	1997-10-07	"Tue"	"Midday"	"400"	4	0	0	4
2003	1997-10-06	"Mon"	"Evening"	"021"	0	2	1	3
2002	1997-10-05	"Sun"	"Midday"	"848"	8	4	8	20
2001	1997-10-04	"Sat"	"Evening"	"018"	0	1	8	9
2000	1997-10-03	"Fri"	"Midday"	"372"	3	7	2	12
1999	1997-10-02	"Thu"	"Evening"	"383"	3	8	3	14
1998	1997-10-01	"Wed"	"Midday"	"518"	5	1	8	14
1997	1997-09-30	"Tue"	"Evening"	"400"	4	0	0	4
1996	1997-09-29	"Mon"	"Midday"	"583"	5	8	3	16
1995	1997-09-28	"Sun"	"Evening"	"694"	6	9	4	19
1994	1997-09-27	"Sat"	"Midday"	"065"	0	6	5	11
1993	1997-09-26	"Fri"	"Evening"	"612"	6	1	2	9
1992	1997-09-25	"Thu"	"Midday"	"101"	1	0	1	2
1991	1997-09-24	"Wed"	"Evening"	"559"	5	5	9	19
1990	1997-09-23	"Tue"	"Midday"	"625"	6	2	5	13
1989	1997-09-22	"Mon"	"Evening"	"858"	8	5	8	21
1988	1997-09-21	"Sun"	"Midday"	"389"	3	8	9	20
1987	1997-09-20	"Sat"	"Evening"	"085"	0	8	5	13
1986	1997-09-19	"Fri"	"Midday"	"183"	1	8	3	12
1985	1997-09-18	"Thu"	"Evening"	"931"	9	3	1	13
1984	1997-09-17	"Wed"	"Midday"	"728"	7	2	8	17
1983	1997-09-16	"Tue"	"Evening"	"288"	2	8	8	18
1982	1997-09-15	"Mon"	"Midday"	"055"	0	5	5	10
1981	1997-09-14	"Sun"	"Evening"	"524"	5	2	4	11
1980	1997-09-13	"Sat"	"Midday"	"891"	8	9	1	18
1979	1997-09-12	"Fri"	"Evening"	"671"	6	7	1	14
1978	1997-09-11	"Thu"	"Midday"	"131"	1	3	1	5
1977	1997-09-10	"Wed"	"Evening"	"490"	4	9	0	13
1976	1997-09-09	"Tue"	"Midday"	"773"	7	7	3	17
1975	1997-09-08	"Mon"	"Evening"	"803"	8	0	3	11
1974	1997-09-07	"Sun"	"Midday"	"449"	4	4	9	17
1973	1997-09-06	"Sat"	"Evening"	"669"	6	6	9	21
1972	1997-09-05	"Fri"	"Midday"	"223"	2	2	3	7
1971	1997-09-04	"Thu"	"Evening"	"405"	4	0	5	9
1970	1997-09-03	"Wed"	"Midday"	"797"	7	9	7	23
1969	1997-09-02	"Tue"	"Evening"	"197"	1	9	7	17
1968	1997-09-01	"Mon"	"Midday"	"381"	3	8	1	12
1967	1997-08-31	"Sun"	"Evening"	"627"	6	2	7	15
1966	1997-08-30	"Sat"	"Midday"	"419"	4	1	9	14
1965	1997-08-29	"Fri"	"Evening"	"304"	3	0	4	7
1964	1997-08-28	"Thu"	"Midday"	"121"	1	2	1	4
1963	1997-08-27	"Wed"	"Evening"	"959"	9	5	9	23
1962	1997-08-26	"Tue"	"Midday"	"719"	7	1	9	17
1961	1997-08-25	"Mon"	"Evening"	"100"	1	0	0	1
1960	1997-08-24	"Sun"	"Midday"	"964"	9	6	4	19
1959	1997-08-23	"Sat"	"Evening"	"879"	8	7	9	24
1958	1997-08-22	"Fri"	"Midday"	"935"	9	3	5	17
1957	1997-08-21	"Thu"	"Evening"	"736"	7	3	6	16
1956	1997-08-20	"Wed"	"Midday"	"974"	9	7	4	20
1955	1997-08-19	"Tue"	"Evening"	"637"	6	3	7	16
1954	1997-08-18	"Mon"	"Midday"	"716"	7	1	6	14
1953	1997-08-17	"Sun"	"Evening"	"266"	2	6	6	14
1952	1997-08-16	"Sat"	"Midday"	"360"	3	6	0	9
1951	1997-08-15	"Fri"	"Evening"	"816"	8	1	6	15
1950	1997-08-14	"Thu"	"Midday"	"224"	2	2	4	8
1949	1997-08-13	"Wed"	"Evening"	"341"	3	4	1	8
1948	1997-08-12	"Tue"	"Midday"	"878"	8	7	8	23
1947	1997-08-11	"Mon"	"Evening"	"370"	3	7	0	10
1946	1997-08-10	"Sun"	"Midday"	"640"	6	4	0	10
1945	1997-08-09	"Sat"	"Evening"	"514"	5	1	4	10
1944	1997-08-08	"Fri"	"Midday"	"939"	9	3	9	21
1943	1997-08-07	"Thu"	"Evening"	"419"	4	1	9	14
1942	1997-08-06	"Wed"	"Midday"	"121"	1	2	1	4
1941	1997-08-05	"Tue"	"Evening"	"245"	2	4	5	11
1940	1997-08-04	"Mon"	"Midday"	"640"	6	4	0	10
1939	1997-08-03	"Sun"	"Evening"	"680"	6	8	0	14
1938	1997-08-02	"Sat"	"Midday"	"415"	4	1	5	10
1937	1997-08-01	"Fri"	"Evening"	"917"	9	1	7	17
1936	1997-07-31	"Thu"	"Midday"	"570"	5	7	0	12
1935	1997-07-30	"Wed"	"Evening"	"962"	9	6	2	17
1934	1997-07-29	"Tue"	"Midday"	"669"	6	6	9	21
1933	1997-07-28	"Mon"	"Evening"	"858"	8	5	8	21
1932	1997-07-27	"Sun"	"Midday"	"509"	5	0	9	14
1931	1997-07-26	"Sat"	"Evening"	"954"	9	5	4	18
1930	1997-07-25	"Fri"	"Midday"	"198"	1	9	8	18
1929	1997-07-24	"Thu"	"Evening"	"666"	6	6	6	18
1928	1997-07-23	"Wed"	"Midday"	"501"	5	0	1	6
1927	1997-07-22	"Tue"	"Evening"	"950"	9	5	0	14
1926	1997-07-21	"Mon"	"Midday"	"878"	8	7	8	23
1925	1997-07-20	"Sun"	"Evening"	"426"	4	2	6	12
1924	1997-07-19	"Sat"	"Midday"	"219"	2	1	9	12
1923	1997-07-18	"Fri"	"Evening"	"466"	4	6	6	16
1922	1997-07-17	"Thu"	"Midday"	"083"	0	8	3	11
1921	1997-07-16	"Wed"	"Evening"	"245"	2	4	5	11
1920	1997-07-15	"Tue"	"Midday"	"405"	4	0	5	9
1919	1997-07-14	"Mon"	"Evening"	"472"	4	7	2	13
1918	1997-07-13	"Sun"	"Midday"	"490"	4	9	0	13
1917	1997-07-12	"Sat"	"Evening"	"384"	3	8	4	15
1916	1997-07-11	"Fri"	"Midday"	"078"	0	7	8	15
1915	1997-07-10	"Thu"	"Evening"	"041"	0	4	1	5
1914	1997-07-09	"Wed"	"Midday"	"591"	5	9	1	15
1913	1997-07-08	"Tue"	"Evening"	"585"	5	8	5	18
1912	1997-07-07	"Mon"	"Midday"	"768"	7	6	8	21
1911	1997-07-06	"Sun"	"Evening"	"145"	1	4	5	10
1910	1997-07-05	"Sat"	"Midday"	"231"	2	3	1	6
1909	1997-07-04	"Fri"	"Evening"	"695"	6	9	5	20
1908	1997-07-03	"Thu"	"Midday"	"131"	1	3	1	5
1907	1997-07-02	"Wed"	"Evening"	"072"	0	7	2	9
1906	1997-07-01	"Tue"	"Midday"	"737"	7	3	7	17
1905	1997-06-30	"Mon"	"Evening"	"746"	7	4	6	17
1904	1997-06-29	"Sun"	"Midday"	"992"	9	9	2	20
1903	1997-06-28	"Sat"	"Evening"	"319"	3	1	9	13
1902	1997-06-27	"Fri"	"Midday"	"814"	8	1	4	13
1901	1997-06-26	"Thu"	"Evening"	"731"	7	3	1	11
1900	1997-06-25	"Wed"	"Midday"	"113"	1	1	3	5
1899	1997-06-24	"Tue"	"Evening"	"113"	1	1	3	5
1898	1997-06-23	"Mon"	"Midday"	"523"	5	2	3	10
1897	1997-06-22	"Sun"	"Evening"	"306"	3	0	6	9
1896	1997-06-21	"Sat"	"Midday"	"017"	0	1	7	8
1895	1997-06-20	"Fri"	"Evening"	"536"	5	3	6	14
1894	1997-06-19	"Thu"	"Midday"	"815"	8	1	5	14
1893	1997-06-18	"Wed"	"Evening"	"781"	7	8	1	16
1892	1997-06-17	"Tue"	"Midday"	"894"	8	9	4	21
1891	1997-06-16	"Mon"	"Evening"	"148"	1	4	8	13
1890	1997-06-15	"Sun"	"Midday"	"053"	0	5	3	8
1889	1997-06-14	"Sat"	"Evening"	"666"	6	6	6	18
1888	1997-06-13	"Fri"	"Midday"	"852"	8	5	2	15
1887	1997-06-12	"Thu"	"Evening"	"077"	0	7	7	14
1886	1997-06-11	"Wed"	"Midday"	"531"	5	3	1	9
1885	1997-06-10	"Tue"	"Evening"	"290"	2	9	0	11
1884	1997-06-09	"Mon"	"Midday"	"285"	2	8	5	15
1883	1997-06-08	"Sun"	"Evening"	"179"	1	7	9	17
1882	1997-06-07	"Sat"	"Midday"	"127"	1	2	7	10
1881	1997-06-06	"Fri"	"Evening"	"320"	3	2	0	5
1880	1997-06-05	"Thu"	"Midday"	"632"	6	3	2	11
1879	1997-06-04	"Wed"	"Evening"	"564"	5	6	4	15
1878	1997-06-03	"Tue"	"Midday"	"348"	3	4	8	15
1877	1997-06-02	"Mon"	"Evening"	"856"	8	5	6	19
1876	1997-06-01	"Sun"	"Midday"	"146"	1	4	6	11
1875	1997-05-31	"Sat"	"Evening"	"372"	3	7	2	12
1874	1997-05-30	"Fri"	"Midday"	"553"	5	5	3	13
1873	1997-05-29	"Thu"	"Evening"	"879"	8	7	9	24
1872	1997-05-28	"Wed"	"Midday"	"344"	3	4	4	11
1871	1997-05-27	"Tue"	"Evening"	"700"	7	0	0	7
1870	1997-05-26	"Mon"	"Midday"	"512"	5	1	2	8
1869	1997-05-25	"Sun"	"Evening"	"279"	2	7	9	18
1868	1997-05-24	"Sat"	"Midday"	"992"	9	9	2	20
1867	1997-05-23	"Fri"	"Evening"	"626"	6	2	6	14
1866	1997-05-22	"Thu"	"Midday"	"298"	2	9	8	19
1865	1997-05-21	"Wed"	"Evening"	"104"	1	0	4	5
1864	1997-05-20	"Tue"	"Midday"	"547"	5	4	7	16
1863	1997-05-19	"Mon"	"Evening"	"212"	2	1	2	5
1862	1997-05-18	"Sun"	"Midday"	"585"	5	8	5	18
1861	1997-05-17	"Sat"	"Evening"	"838"	8	3	8	19
1860	1997-05-16	"Fri"	"Midday"	"642"	6	4	2	12
1859	1997-05-15	"Thu"	"Evening"	"506"	5	0	6	11
1858	1997-05-14	"Wed"	"Midday"	"154"	1	5	4	10
1857	1997-05-13	"Tue"	"Evening"	"692"	6	9	2	17
1856	1997-05-12	"Mon"	"Midday"	"190"	1	9	0	10
1855	1997-05-11	"Sun"	"Evening"	"287"	2	8	7	17
1854	1997-05-10	"Sat"	"Midday"	"023"	0	2	3	5
1853	1997-05-09	"Fri"	"Evening"	"094"	0	9	4	13
1852	1997-05-08	"Thu"	"Midday"	"399"	3	9	9	21
1851	1997-05-07	"Wed"	"Evening"	"876"	8	7	6	21
1850	1997-05-06	"Tue"	"Midday"	"827"	8	2	7	17
1849	1997-05-05	"Mon"	"Evening"	"216"	2	1	6	9
1848	1997-05-04	"Sun"	"Midday"	"771"	7	7	1	15
1847	1997-05-03	"Sat"	"Evening"	"404"	4	0	4	8
1846	1997-05-02	"Fri"	"Midday"	"502"	5	0	2	7
1845	1997-05-01	"Thu"	"Evening"	"697"	6	9	7	22
1844	1997-04-30	"Wed"	"Midday"	"204"	2	0	4	6
1843	1997-04-29	"Tue"	"Evening"	"701"	7	0	1	8
1842	1997-04-28	"Mon"	"Midday"	"319"	3	1	9	13
1841	1997-04-27	"Sun"	"Evening"	"503"	5	0	3	8
1840	1997-04-26	"Sat"	"Midday"	"151"	1	5	1	7
1839	1997-04-25	"Fri"	"Evening"	"099"	0	9	9	18
1838	1997-04-24	"Thu"	"Midday"	"819"	8	1	9	18
1837	1997-04-23	"Wed"	"Evening"	"241"	2	4	1	7
1836	1997-04-22	"Tue"	"Midday"	"453"	4	5	3	12
1835	1997-04-21	"Mon"	"Evening"	"421"	4	2	1	7
1834	1997-04-20	"Sun"	"Midday"	"436"	4	3	6	13
1833	1997-04-19	"Sat"	"Evening"	"250"	2	5	0	7
1832	1997-04-18	"Fri"	"Midday"	"537"	5	3	7	15
1831	1997-04-17	"Thu"	"Evening"	"467"	4	6	7	17
1830	1997-04-16	"Wed"	"Midday"	"076"	0	7	6	13
1829	1997-04-15	"Tue"	"Evening"	"316"	3	1	6	10
1828	1997-04-14	"Mon"	"Midday"	"402"	4	0	2	6
1827	1997-04-13	"Sun"	"Evening"	"566"	5	6	6	17
1826	1997-04-12	"Sat"	"Midday"	"649"	6	4	9	19
1825	1997-04-11	"Fri"	"Evening"	"412"	4	1	2	7
1824	1997-04-10	"Thu"	"Midday"	"737"	7	3	7	17
1823	1997-04-09	"Wed"	"Evening"	"983"	9	8	3	20
1822	1997-04-08	"Tue"	"Midday"	"005"	0	0	5	5
1821	1997-04-07	"Mon"	"Evening"	"649"	6	4	9	19
1820	1997-04-06	"Sun"	"Midday"	"594"	5	9	4	18
1819	1997-04-05	"Sat"	"Evening"	"212"	2	1	2	5
1818	1997-04-04	"Fri"	"Midday"	"991"	9	9	1	19
1817	1997-04-03	"Thu"	"Evening"	"145"	1	4	5	10
1816	1997-04-02	"Wed"	"Midday"	"554"	5	5	4	14
1815	1997-04-01	"Tue"	"Evening"	"810"	8	1	0	9
1814	1997-03-31	"Mon"	"Midday"	"570"	5	7	0	12
1813	1997-03-30	"Sun"	"Evening"	"443"	4	4	3	11
1812	1997-03-29	"Sat"	"Midday"	"155"	1	5	5	11
1811	1997-03-28	"Fri"	"Evening"	"325"	3	2	5	10
1810	1997-03-27	"Thu"	"Midday"	"921"	9	2	1	12
1809	1997-03-26	"Wed"	"Evening"	"145"	1	4	5	10
1808	1997-03-25	"Tue"	"Midday"	"978"	9	7	8	24
1807	1997-03-24	"Mon"	"Evening"	"274"	2	7	4	13
1806	1997-03-23	"Sun"	"Midday"	"859"	8	5	9	22
1805	1997-03-22	"Sat"	"Evening"	"099"	0	9	9	18
1804	1997-03-21	"Fri"	"Midday"	"541"	5	4	1	10
1803	1997-03-20	"Thu"	"Evening"	"789"	7	8	9	24
1802	1997-03-19	"Wed"	"Midday"	"532"	5	3	2	10
1801	1997-03-18	"Tue"	"Evening"	"412"	4	1	2	7
1800	1997-03-17	"Mon"	"Midday"	"577"	5	7	7	19
1799	1997-03-16	"Sun"	"Evening"	"020"	0	2	0	2
1798	1997-03-15	"Sat"	"Midday"	"875"	8	7	5	20
1797	1997-03-14	"Fri"	"Evening"	"374"	3	7	4	14
1796	1997-03-13	"Thu"	"Midday"	"257"	2	5	7	14
1795	1997-03-12	"Wed"	"Evening"	"369"	3	6	9	18
1794	1997-03-11	"Tue"	"Midday"	"058"	0	5	8	13
1793	1997-03-10	"Mon"	"Evening"	"620"	6	2	0	8
1792	1997-03-09	"Sun"	"Midday"	"446"	4	4	6	14
1791	1997-03-08	"Sat"	"Evening"	"002"	0	0	2	2
1790	1997-03-07	"Fri"	"Midday"	"652"	6	5	2	13
1789	1997-03-06	"Thu"	"Evening"	"401"	4	0	1	5
1788	1997-03-05	"Wed"	"Midday"	"027"	0	2	7	9
1787	1997-03-04	"Tue"	"Evening"	"369"	3	6	9	18
1786	1997-03-03	"Mon"	"Midday"	"096"	0	9	6	15
1785	1997-03-02	"Sun"	"Evening"	"468"	4	6	8	18
1784	1997-03-01	"Sat"	"Midday"	"659"	6	5	9	20
1783	1997-02-28	"Fri"	"Evening"	"428"	4	2	8	14
1782	1997-02-27	"Thu"	"Midday"	"613"	6	1	3	10
1781	1997-02-26	"Wed"	"Evening"	"521"	5	2	1	8
1780	1997-02-25	"Tue"	"Midday"	"458"	4	5	8	17
1779	1997-02-24	"Mon"	"Evening"	"567"	5	6	7	18
1778	1997-02-23	"Sun"	"Midday"	"815"	8	1	5	14
1777	1997-02-22	"Sat"	"Evening"	"732"	7	3	2	12
1776	1997-02-21	"Fri"	"Midday"	"741"	7	4	1	12
1775	1997-02-20	"Thu"	"Evening"	"244"	2	4	4	10
1774	1997-02-19	"Wed"	"Midday"	"653"	6	5	3	14
1773	1997-02-18	"Tue"	"Evening"	"949"	9	4	9	22
1772	1997-02-17	"Mon"	"Midday"	"406"	4	0	6	10
1771	1997-02-16	"Sun"	"Evening"	"864"	8	6	4	18
1770	1997-02-15	"Sat"	"Midday"	"398"	3	9	8	20
1769	1997-02-14	"Fri"	"Evening"	"545"	5	4	5	14
1768	1997-02-13	"Thu"	"Midday"	"610"	6	1	0	7
1767	1997-02-12	"Wed"	"Evening"	"840"	8	4	0	12
1766	1997-02-11	"Tue"	"Midday"	"070"	0	7	0	7
1765	1997-02-10	"Mon"	"Evening"	"538"	5	3	8	16
1764	1997-02-09	"Sun"	"Midday"	"433"	4	3	3	10
1763	1997-02-08	"Sat"	"Evening"	"956"	9	5	6	20
1762	1997-02-07	"Fri"	"Midday"	"977"	9	7	7	23
1761	1997-02-06	"Thu"	"Evening"	"210"	2	1	0	3
1760	1997-02-05	"Wed"	"Midday"	"213"	2	1	3	6
1759	1997-02-04	"Tue"	"Evening"	"350"	3	5	0	8
1758	1997-02-03	"Mon"	"Midday"	"250"	2	5	0	7
1757	1997-02-02	"Sun"	"Evening"	"592"	5	9	2	16
1756	1997-02-01	"Sat"	"Midday"	"470"	4	7	0	11
1755	1997-01-31	"Fri"	"Evening"	"281"	2	8	1	11
1754	1997-01-30	"Thu"	"Midday"	"721"	7	2	1	10
1753	1997-01-29	"Wed"	"Evening"	"303"	3	0	3	6
1752	1997-01-28	"Tue"	"Midday"	"469"	4	6	9	19
1751	1997-01-27	"Mon"	"Evening"	"001"	0	0	1	1
1750	1997-01-26	"Sun"	"Midday"	"586"	5	8	6	19
1749	1997-01-25	"Sat"	"Evening"	"822"	8	2	2	12
1748	1997-01-24	"Fri"	"Midday"	"501"	5	0	1	6
1747	1997-01-23	"Thu"	"Evening"	"075"	0	7	5	12
1746	1997-01-22	"Wed"	"Midday"	"310"	3	1	0	4
1745	1997-01-21	"Tue"	"Evening"	"204"	2	0	4	6
1744	1997-01-20	"Mon"	"Midday"	"188"	1	8	8	17
1743	1997-01-19	"Sun"	"Evening"	"712"	7	1	2	10
1742	1997-01-18	"Sat"	"Midday"	"470"	4	7	0	11
1741	1997-01-17	"Fri"	"Evening"	"412"	4	1	2	7
1740	1997-01-16	"Thu"	"Midday"	"339"	3	3	9	15
1739	1997-01-15	"Wed"	"Evening"	"367"	3	6	7	16
1738	1997-01-14	"Tue"	"Midday"	"290"	2	9	0	11
1737	1997-01-13	"Mon"	"Evening"	"225"	2	2	5	9
1736	1997-01-12	"Sun"	"Midday"	"316"	3	1	6	10
1735	1997-01-11	"Sat"	"Evening"	"633"	6	3	3	12
1734	1997-01-10	"Fri"	"Midday"	"871"	8	7	1	16
1733	1997-01-09	"Thu"	"Evening"	"030"	0	3	0	3
1732	1997-01-08	"Wed"	"Midday"	"074"	0	7	4	11
1731	1997-01-07	"Tue"	"Evening"	"255"	2	5	5	12
1730	1997-01-06	"Mon"	"Midday"	"091"	0	9	1	10
1729	1997-01-05	"Sun"	"Evening"	"443"	4	4	3	11
1728	1997-01-04	"Sat"	"Midday"	"928"	9	2	8	19
1727	1997-01-03	"Fri"	"Evening"	"794"	7	9	4	20
1726	1997-01-02	"Thu"	"Midday"	"976"	9	7	6	22
1725	1997-01-01	"Wed"	"Evening"	"926"	9	2	6	17
1724	1996-12-31	"Tue"	"Midday"	"453"	4	5	3	12
1723	1996-12-30	"Mon"	"Evening"	"698"	6	9	8	23
1722	1996-12-29	"Sun"	"Midday"	"807"	8	0	7	15
1721	1996-12-28	"Sat"	"Evening"	"539"	5	3	9	17
1720	1996-12-27	"Fri"	"Midday"	"739"	7	3	9	19
1719	1996-12-26	"Thu"	"Evening"	"833"	8	3	3	14
1718	1996-12-25	"Wed"	"Midday"	"129"	1	2	9	12
1717	1996-12-24	"Tue"	"Evening"	"848"	8	4	8	20
1716	1996-12-23	"Mon"	"Midday"	"520"	5	2	0	7
1715	1996-12-22	"Sun"	"Evening"	"099"	0	9	9	18
1714	1996-12-21	"Sat"	"Midday"	"370"	3	7	0	10
1713	1996-12-20	"Fri"	"Evening"	"437"	4	3	7	14
1712	1996-12-19	"Thu"	"Midday"	"668"	6	6	8	20
1711	1996-12-18	"Wed"	"Evening"	"631"	6	3	1	10
1710	1996-12-17	"Tue"	"Midday"	"510"	5	1	0	6
1709	1996-12-16	"Mon"	"Evening"	"963"	9	6	3	18
1708	1996-12-15	"Sun"	"Midday"	"320"	3	2	0	5
1707	1996-12-14	"Sat"	"Evening"	"828"	8	2	8	18
1706	1996-12-13	"Fri"	"Midday"	"412"	4	1	2	7
1705	1996-12-12	"Thu"	"Evening"	"530"	5	3	0	8
1704	1996-12-11	"Wed"	"Midday"	"556"	5	5	6	16
1703	1996-12-10	"Tue"	"Evening"	"808"	8	0	8	16
1702	1996-12-09	"Mon"	"Midday"	"069"	0	6	9	15
1701	1996-12-08	"Sun"	"Evening"	"411"	4	1	1	6
1700	1996-12-07	"Sat"	"Midday"	"521"	5	2	1	8
1699	1996-12-06	"Fri"	"Evening"	"830"	8	3	0	11
1698	1996-12-05	"Thu"	"Midday"	"483"	4	8	3	15
1697	1996-12-04	"Wed"	"Evening"	"555"	5	5	5	15
1696	1996-12-03	"Tue"	"Midday"	"032"	0	3	2	5
1695	1996-12-02	"Mon"	"Evening"	"858"	8	5	8	21
1694	1996-12-01	"Sun"	"Midday"	"646"	6	4	6	16
1693	1996-11-30	"Sat"	"Evening"	"742"	7	4	2	13
1692	1996-11-29	"Fri"	"Midday"	"999"	9	9	9	27
1691	1996-11-28	"Thu"	"Evening"	"966"	9	6	6	21
1690	1996-11-27	"Wed"	"Midday"	"643"	6	4	3	13
1689	1996-11-26	"Tue"	"Evening"	"613"	6	1	3	10
1688	1996-11-25	"Mon"	"Midday"	"163"	1	6	3	10
1687	1996-11-24	"Sun"	"Evening"	"836"	8	3	6	17
1686	1996-11-23	"Sat"	"Midday"	"850"	8	5	0	13
1685	1996-11-22	"Fri"	"Evening"	"123"	1	2	3	6
1684	1996-11-21	"Thu"	"Midday"	"665"	6	6	5	17
1683	1996-11-20	"Wed"	"Evening"	"423"	4	2	3	9
1682	1996-11-19	"Tue"	"Midday"	"408"	4	0	8	12
1681	1996-11-18	"Mon"	"Evening"	"877"	8	7	7	22
1680	1996-11-17	"Sun"	"Midday"	"578"	5	7	8	20
1679	1996-11-16	"Sat"	"Evening"	"270"	2	7	0	9
1678	1996-11-15	"Fri"	"Midday"	"243"	2	4	3	9
1677	1996-11-14	"Thu"	"Evening"	"680"	6	8	0	14
1676	1996-11-13	"Wed"	"Midday"	"644"	6	4	4	14
1675	1996-11-12	"Tue"	"Evening"	"859"	8	5	9	22
1674	1996-11-11	"Mon"	"Midday"	"306"	3	0	6	9
1673	1996-11-10	"Sun"	"Evening"	"212"	2	1	2	5
1672	1996-11-09	"Sat"	"Midday"	"864"	8	6	4	18
1671	1996-11-08	"Fri"	"Evening"	"551"	5	5	1	11
1670	1996-11-07	"Thu"	"Midday"	"706"	7	0	6	13
1669	1996-11-06	"Wed"	"Evening"	"498"	4	9	8	21
1668	1996-11-05	"Tue"	"Midday"	"554"	5	5	4	14
1667	1996-11-04	"Mon"	"Evening"	"084"	0	8	4	12
1666	1996-11-03	"Sun"	"Midday"	"291"	2	9	1	12
1665	1996-11-02	"Sat"	"Evening"	"008"	0	0	8	8
1664	1996-11-01	"Fri"	"Midday"	"051"	0	5	1	6
1663	1996-10-31	"Thu"	"Evening"	"083"	0	8	3	11
1662	1996-10-30	"Wed"	"Midday"	"008"	0	0	8	8
1661	1996-10-29	"Tue"	"Evening"	"887"	8	8	7	23
1660	1996-10-28	"Mon"	"Midday"	"953"	9	5	3	17
1659	1996-10-27	"Sun"	"Evening"	"351"	3	5	1	9
1658	1996-10-26	"Sat"	"Midday"	"902"	9	0	2	11
1657	1996-10-25	"Fri"	"Evening"	"204"	2	0	4	6
1656	1996-10-24	"Thu"	"Midday"	"131"	1	3	1	5
1655	1996-10-23	"Wed"	"Evening"	"693"	6	9	3	18
1654	1996-10-22	"Tue"	"Midday"	"286"	2	8	6	16
1653	1996-10-21	"Mon"	"Evening"	"905"	9	0	5	14
1652	1996-10-20	"Sun"	"Midday"	"829"	8	2	9	19
1651	1996-10-19	"Sat"	"Evening"	"745"	7	4	5	16
1650	1996-10-18	"Fri"	"Midday"	"020"	0	2	0	2
1649	1996-10-17	"Thu"	"Evening"	"903"	9	0	3	12
1648	1996-10-16	"Wed"	"Midday"	"009"	0	0	9	9
1647	1996-10-15	"Tue"	"Evening"	"942"	9	4	2	15
1646	1996-10-14	"Mon"	"Midday"	"145"	1	4	5	10
1645	1996-10-13	"Sun"	"Evening"	"661"	6	6	1	13
1644	1996-10-12	"Sat"	"Midday"	"358"	3	5	8	16
1643	1996-10-11	"Fri"	"Evening"	"387"	3	8	7	18
1642	1996-10-10	"Thu"	"Midday"	"724"	7	2	4	13
1641	1996-10-09	"Wed"	"Evening"	"342"	3	4	2	9
1640	1996-10-08	"Tue"	"Midday"	"217"	2	1	7	10
1639	1996-10-07	"Mon"	"Evening"	"695"	6	9	5	20
1638	1996-10-06	"Sun"	"Midday"	"539"	5	3	9	17
1637	1996-10-05	"Sat"	"Evening"	"316"	3	1	6	10
1636	1996-10-04	"Fri"	"Midday"	"065"	0	6	5	11
1635	1996-10-03	"Thu"	"Evening"	"487"	4	8	7	19
1634	1996-10-02	"Wed"	"Midday"	"056"	0	5	6	11
1633	1996-10-01	"Tue"	"Evening"	"950"	9	5	0	14
1632	1996-09-30	"Mon"	"Midday"	"383"	3	8	3	14
1631	1996-09-29	"Sun"	"Evening"	"055"	0	5	5	10
1630	1996-09-28	"Sat"	"Midday"	"356"	3	5	6	14
1629	1996-09-27	"Fri"	"Evening"	"863"	8	6	3	17
1628	1996-09-26	"Thu"	"Midday"	"178"	1	7	8	16
1627	1996-09-25	"Wed"	"Evening"	"530"	5	3	0	8
1626	1996-09-24	"Tue"	"Midday"	"743"	7	4	3	14
1625	1996-09-23	"Mon"	"Evening"	"015"	0	1	5	6
1624	1996-09-22	"Sun"	"Midday"	"483"	4	8	3	15
1623	1996-09-21	"Sat"	"Evening"	"134"	1	3	4	8
1622	1996-09-20	"Fri"	"Midday"	"460"	4	6	0	10
1621	1996-09-19	"Thu"	"Evening"	"085"	0	8	5	13
1620	1996-09-18	"Wed"	"Midday"	"710"	7	1	0	8
1619	1996-09-17	"Tue"	"Evening"	"585"	5	8	5	18
1618	1996-09-16	"Mon"	"Midday"	"693"	6	9	3	18
1617	1996-09-15	"Sun"	"Evening"	"932"	9	3	2	14
1616	1996-09-14	"Sat"	"Midday"	"099"	0	9	9	18
1615	1996-09-13	"Fri"	"Evening"	"524"	5	2	4	11
1614	1996-09-12	"Thu"	"Midday"	"823"	8	2	3	13
1613	1996-09-11	"Wed"	"Evening"	"902"	9	0	2	11
1612	1996-09-10	"Tue"	"Midday"	"490"	4	9	0	13
1611	1996-09-09	"Mon"	"Evening"	"260"	2	6	0	8
1610	1996-09-08	"Sun"	"Midday"	"305"	3	0	5	8
1609	1996-09-07	"Sat"	"Evening"	"539"	5	3	9	17
1608	1996-09-06	"Fri"	"Midday"	"169"	1	6	9	16
1607	1996-09-05	"Thu"	"Evening"	"992"	9	9	2	20
1606	1996-09-04	"Wed"	"Midday"	"501"	5	0	1	6
1605	1996-09-03	"Tue"	"Evening"	"551"	5	5	1	11
1604	1996-09-02	"Mon"	"Midday"	"501"	5	0	1	6
1603	1996-09-01	"Sun"	"Evening"	"371"	3	7	1	11
1602	1996-08-31	"Sat"	"Midday"	"128"	1	2	8	11
1601	1996-08-30	"Fri"	"Evening"	"443"	4	4	3	11
1600	1996-08-29	"Thu"	"Midday"	"341"	3	4	1	8
1599	1996-08-28	"Wed"	"Evening"	"284"	2	8	4	14
1598	1996-08-27	"Tue"	"Midday"	"032"	0	3	2	5
1597	1996-08-26	"Mon"	"Evening"	"867"	8	6	7	21
1596	1996-08-25	"Sun"	"Midday"	"258"	2	5	8	15
1595	1996-08-24	"Sat"	"Evening"	"058"	0	5	8	13
1594	1996-08-23	"Fri"	"Midday"	"524"	5	2	4	11
1593	1996-08-22	"Thu"	"Evening"	"063"	0	6	3	9
1592	1996-08-21	"Wed"	"Midday"	"648"	6	4	8	18
1591	1996-08-20	"Tue"	"Evening"	"739"	7	3	9	19
1590	1996-08-19	"Mon"	"Midday"	"126"	1	2	6	9
1589	1996-08-18	"Sun"	"Evening"	"868"	8	6	8	22
1588	1996-08-17	"Sat"	"Midday"	"673"	6	7	3	16
1587	1996-08-16	"Fri"	"Evening"	"595"	5	9	5	19
1586	1996-08-15	"Thu"	"Midday"	"983"	9	8	3	20
1585	1996-08-14	"Wed"	"Evening"	"547"	5	4	7	16
1584	1996-08-13	"Tue"	"Midday"	"860"	8	6	0	14
1583	1996-08-12	"Mon"	"Evening"	"539"	5	3	9	17
1582	1996-08-11	"Sun"	"Midday"	"557"	5	5	7	17
1581	1996-08-10	"Sat"	"Evening"	"765"	7	6	5	18
1580	1996-08-09	"Fri"	"Midday"	"484"	4	8	4	16
1579	1996-08-08	"Thu"	"Evening"	"386"	3	8	6	17
1578	1996-08-07	"Wed"	"Midday"	"261"	2	6	1	9
1577	1996-08-06	"Tue"	"Evening"	"348"	3	4	8	15
1576	1996-08-05	"Mon"	"Midday"	"426"	4	2	6	12
1575	1996-08-04	"Sun"	"Evening"	"485"	4	8	5	17
1574	1996-08-03	"Sat"	"Midday"	"311"	3	1	1	5
1573	1996-08-02	"Fri"	"Evening"	"752"	7	5	2	14
1572	1996-08-01	"Thu"	"Midday"	"931"	9	3	1	13
1571	1996-07-31	"Wed"	"Evening"	"767"	7	6	7	20
1570	1996-07-30	"Tue"	"Midday"	"783"	7	8	3	18
1569	1996-07-29	"Mon"	"Evening"	"593"	5	9	3	17
1568	1996-07-28	"Sun"	"Midday"	"773"	7	7	3	17
1567	1996-07-27	"Sat"	"Evening"	"148"	1	4	8	13
1566	1996-07-26	"Fri"	"Midday"	"486"	4	8	6	18
1565	1996-07-25	"Thu"	"Evening"	"991"	9	9	1	19
1564	1996-07-24	"Wed"	"Midday"	"244"	2	4	4	10
1563	1996-07-23	"Tue"	"Evening"	"751"	7	5	1	13
1562	1996-07-22	"Mon"	"Midday"	"199"	1	9	9	19
1561	1996-07-21	"Sun"	"Evening"	"792"	7	9	2	18
1560	1996-07-20	"Sat"	"Midday"	"572"	5	7	2	14
1559	1996-07-19	"Fri"	"Evening"	"390"	3	9	0	12
1558	1996-07-18	"Thu"	"Midday"	"964"	9	6	4	19
1557	1996-07-17	"Wed"	"Evening"	"950"	9	5	0	14
1556	1996-07-16	"Tue"	"Midday"	"708"	7	0	8	15
1555	1996-07-15	"Mon"	"Evening"	"768"	7	6	8	21
1554	1996-07-14	"Sun"	"Midday"	"251"	2	5	1	8
1553	1996-07-13	"Sat"	"Evening"	"360"	3	6	0	9
1552	1996-07-12	"Fri"	"Midday"	"436"	4	3	6	13
1551	1996-07-11	"Thu"	"Evening"	"818"	8	1	8	17
1550	1996-07-10	"Wed"	"Midday"	"492"	4	9	2	15
1549	1996-07-09	"Tue"	"Evening"	"955"	9	5	5	19
1548	1996-07-08	"Mon"	"Midday"	"916"	9	1	6	16
1547	1996-07-07	"Sun"	"Evening"	"771"	7	7	1	15
1546	1996-07-06	"Sat"	"Midday"	"020"	0	2	0	2
1545	1996-07-05	"Fri"	"Evening"	"236"	2	3	6	11
1544	1996-07-04	"Thu"	"Midday"	"698"	6	9	8	23
1543	1996-07-03	"Wed"	"Evening"	"962"	9	6	2	17
1542	1996-07-02	"Tue"	"Midday"	"522"	5	2	2	9
1541	1996-07-01	"Mon"	"Evening"	"871"	8	7	1	16
1540	1996-06-30	"Sun"	"Midday"	"255"	2	5	5	12
1539	1996-06-29	"Sat"	"Evening"	"782"	7	8	2	17
1538	1996-06-28	"Fri"	"Midday"	"183"	1	8	3	12
1537	1996-06-27	"Thu"	"Evening"	"605"	6	0	5	11
1536	1996-06-26	"Wed"	"Midday"	"451"	4	5	1	10
1535	1996-06-25	"Tue"	"Evening"	"045"	0	4	5	9
1534	1996-06-24	"Mon"	"Midday"	"314"	3	1	4	8
1533	1996-06-23	"Sun"	"Evening"	"338"	3	3	8	14
1532	1996-06-22	"Sat"	"Midday"	"500"	5	0	0	5
1531	1996-06-21	"Fri"	"Evening"	"110"	1	1	0	2
1530	1996-06-20	"Thu"	"Midday"	"524"	5	2	4	11
1529	1996-06-19	"Wed"	"Evening"	"318"	3	1	8	12
1528	1996-06-18	"Tue"	"Midday"	"851"	8	5	1	14
1527	1996-06-17	"Mon"	"Evening"	"864"	8	6	4	18
1526	1996-06-16	"Sun"	"Midday"	"532"	5	3	2	10
1525	1996-06-15	"Sat"	"Evening"	"503"	5	0	3	8
1524	1996-06-14	"Fri"	"Midday"	"657"	6	5	7	18
1523	1996-06-13	"Thu"	"Evening"	"934"	9	3	4	16
1522	1996-06-12	"Wed"	"Midday"	"136"	1	3	6	10
1521	1996-06-11	"Tue"	"Evening"	"640"	6	4	0	10
1520	1996-06-10	"Mon"	"Midday"	"704"	7	0	4	11
1519	1996-06-09	"Sun"	"Evening"	"954"	9	5	4	18
1518	1996-06-08	"Sat"	"Midday"	"390"	3	9	0	12
1517	1996-06-07	"Fri"	"Evening"	"355"	3	5	5	13
1516	1996-06-06	"Thu"	"Midday"	"475"	4	7	5	16
1515	1996-06-05	"Wed"	"Evening"	"666"	6	6	6	18
1514	1996-06-04	"Tue"	"Midday"	"302"	3	0	2	5
1513	1996-06-03	"Mon"	"Evening"	"439"	4	3	9	16
1512	1996-06-02	"Sun"	"Midday"	"039"	0	3	9	12
1511	1996-06-01	"Sat"	"Evening"	"819"	8	1	9	18
1510	1996-05-31	"Fri"	"Midday"	"395"	3	9	5	17
1509	1996-05-30	"Thu"	"Evening"	"581"	5	8	1	14
1508	1996-05-29	"Wed"	"Midday"	"452"	4	5	2	11
1507	1996-05-28	"Tue"	"Evening"	"738"	7	3	8	18
1506	1996-05-27	"Mon"	"Midday"	"173"	1	7	3	11
1505	1996-05-26	"Sun"	"Evening"	"463"	4	6	3	13
1504	1996-05-25	"Sat"	"Midday"	"916"	9	1	6	16
1503	1996-05-24	"Fri"	"Evening"	"344"	3	4	4	11
1502	1996-05-23	"Thu"	"Midday"	"162"	1	6	2	9
1501	1996-05-22	"Wed"	"Evening"	"968"	9	6	8	23
1500	1996-05-21	"Tue"	"Midday"	"598"	5	9	8	22
1499	1996-05-20	"Mon"	"Evening"	"772"	7	7	2	16
1498	1996-05-19	"Sun"	"Midday"	"177"	1	7	7	15
1497	1996-05-18	"Sat"	"Evening"	"607"	6	0	7	13
1496	1996-05-17	"Fri"	"Midday"	"298"	2	9	8	19
1495	1996-05-16	"Thu"	"Evening"	"116"	1	1	6	8
1494	1996-05-15	"Wed"	"Midday"	"146"	1	4	6	11
1493	1996-05-14	"Tue"	"Evening"	"211"	2	1	1	4
1492	1996-05-13	"Mon"	"Midday"	"474"	4	7	4	15
1491	1996-05-12	"Sun"	"Evening"	"911"	9	1	1	11
1490	1996-05-11	"Sat"	"Midday"	"415"	4	1	5	10
1489	1996-05-10	"Fri"	"Evening"	"190"	1	9	0	10
1488	1996-05-09	"Thu"	"Midday"	"974"	9	7	4	20
1487	1996-05-08	"Wed"	"Evening"	"431"	4	3	1	8
1486	1996-05-07	"Tue"	"Midday"	"522"	5	2	2	9
1485	1996-05-06	"Mon"	"Evening"	"818"	8	1	8	17
1484	1996-05-05	"Sun"	"Midday"	"976"	9	7	6	22
1483	1996-05-04	"Sat"	"Evening"	"841"	8	4	1	13
1482	1996-05-03	"Fri"	"Midday"	"705"	7	0	5	12
1481	1996-05-02	"Thu"	"Evening"	"511"	5	1	1	7
1480	1996-05-01	"Wed"	"Midday"	"865"	8	6	5	19
1479	1996-04-30	"Tue"	"Evening"	"923"	9	2	3	14
1478	1996-04-29	"Mon"	"Midday"	"925"	9	2	5	16
1477	1996-04-28	"Sun"	"Evening"	"407"	4	0	7	11
1476	1996-04-27	"Sat"	"Midday"	"521"	5	2	1	8
1475	1996-04-26	"Fri"	"Evening"	"329"	3	2	9	14
1474	1996-04-25	"Thu"	"Midday"	"363"	3	6	3	12
1473	1996-04-24	"Wed"	"Evening"	"666"	6	6	6	18
1472	1996-04-23	"Tue"	"Midday"	"789"	7	8	9	24
1471	1996-04-22	"Mon"	"Evening"	"081"	0	8	1	9
1470	1996-04-21	"Sun"	"Midday"	"026"	0	2	6	8
1469	1996-04-20	"Sat"	"Evening"	"451"	4	5	1	10
1468	1996-04-19	"Fri"	"Midday"	"497"	4	9	7	20
1467	1996-04-18	"Thu"	"Evening"	"540"	5	4	0	9
1466	1996-04-17	"Wed"	"Midday"	"263"	2	6	3	11
1465	1996-04-16	"Tue"	"Evening"	"954"	9	5	4	18
1464	1996-04-15	"Mon"	"Midday"	"366"	3	6	6	15
1463	1996-04-14	"Sun"	"Evening"	"417"	4	1	7	12
1462	1996-04-13	"Sat"	"Midday"	"593"	5	9	3	17
1461	1996-04-12	"Fri"	"Evening"	"299"	2	9	9	20
1460	1996-04-11	"Thu"	"Midday"	"565"	5	6	5	16
1459	1996-04-10	"Wed"	"Evening"	"067"	0	6	7	13
1458	1996-04-09	"Tue"	"Midday"	"293"	2	9	3	14
1457	1996-04-08	"Mon"	"Evening"	"571"	5	7	1	13
1456	1996-04-07	"Sun"	"Midday"	"936"	9	3	6	18
1455	1996-04-06	"Sat"	"Evening"	"167"	1	6	7	14
1454	1996-04-05	"Fri"	"Midday"	"058"	0	5	8	13
1453	1996-04-04	"Thu"	"Evening"	"264"	2	6	4	12
1452	1996-04-03	"Wed"	"Midday"	"761"	7	6	1	14
1451	1996-04-02	"Tue"	"Evening"	"166"	1	6	6	13
1450	1996-04-01	"Mon"	"Midday"	"098"	0	9	8	17
1449	1996-03-31	"Sun"	"Evening"	"621"	6	2	1	9
1448	1996-03-30	"Sat"	"Midday"	"112"	1	1	2	4
1447	1996-03-29	"Fri"	"Evening"	"690"	6	9	0	15
1446	1996-03-28	"Thu"	"Midday"	"621"	6	2	1	9
1445	1996-03-27	"Wed"	"Evening"	"948"	9	4	8	21
1444	1996-03-26	"Tue"	"Midday"	"239"	2	3	9	14
1443	1996-03-25	"Mon"	"Evening"	"531"	5	3	1	9
1442	1996-03-24	"Sun"	"Midday"	"926"	9	2	6	17
1441	1996-03-23	"Sat"	"Evening"	"212"	2	1	2	5
1440	1996-03-22	"Fri"	"Midday"	"493"	4	9	3	16
1439	1996-03-21	"Thu"	"Evening"	"044"	0	4	4	8
1438	1996-03-20	"Wed"	"Midday"	"435"	4	3	5	12
1437	1996-03-19	"Tue"	"Evening"	"525"	5	2	5	12
1436	1996-03-18	"Mon"	"Midday"	"891"	8	9	1	18
1435	1996-03-17	"Sun"	"Evening"	"510"	5	1	0	6
1434	1996-03-16	"Sat"	"Midday"	"447"	4	4	7	15
1433	1996-03-15	"Fri"	"Evening"	"763"	7	6	3	16
1432	1996-03-14	"Thu"	"Midday"	"631"	6	3	1	10
1431	1996-03-13	"Wed"	"Evening"	"117"	1	1	7	9
1430	1996-03-12	"Tue"	"Midday"	"161"	1	6	1	8
1429	1996-03-11	"Mon"	"Evening"	"521"	5	2	1	8
1428	1996-03-10	"Sun"	"Midday"	"427"	4	2	7	13
1427	1996-03-09	"Sat"	"Evening"	"331"	3	3	1	7
1426	1996-03-08	"Fri"	"Midday"	"549"	5	4	9	18
1425	1996-03-07	"Thu"	"Evening"	"475"	4	7	5	16
1424	1996-03-06	"Wed"	"Midday"	"686"	6	8	6	20
1423	1996-03-05	"Tue"	"Evening"	"595"	5	9	5	19
1422	1996-03-04	"Mon"	"Midday"	"297"	2	9	7	18
1421	1996-03-03	"Sun"	"Evening"	"263"	2	6	3	11
1420	1996-03-02	"Sat"	"Midday"	"195"	1	9	5	15
1419	1996-03-01	"Fri"	"Evening"	"910"	9	1	0	10
1418	1996-02-29	"Thu"	"Midday"	"595"	5	9	5	19
1417	1996-02-28	"Wed"	"Evening"	"651"	6	5	1	12
1416	1996-02-27	"Tue"	"Midday"	"510"	5	1	0	6
1415	1996-02-26	"Mon"	"Evening"	"255"	2	5	5	12
1414	1996-02-25	"Sun"	"Midday"	"742"	7	4	2	13
1413	1996-02-24	"Sat"	"Evening"	"785"	7	8	5	20
1412	1996-02-23	"Fri"	"Midday"	"494"	4	9	4	17
1411	1996-02-22	"Thu"	"Evening"	"335"	3	3	5	11
1410	1996-02-21	"Wed"	"Midday"	"343"	3	4	3	10
1409	1996-02-20	"Tue"	"Evening"	"639"	6	3	9	18
1408	1996-02-19	"Mon"	"Midday"	"932"	9	3	2	14
1407	1996-02-18	"Sun"	"Evening"	"931"	9	3	1	13
1406	1996-02-17	"Sat"	"Midday"	"783"	7	8	3	18
1405	1996-02-16	"Fri"	"Evening"	"509"	5	0	9	14
1404	1996-02-15	"Thu"	"Midday"	"882"	8	8	2	18
1403	1996-02-14	"Wed"	"Evening"	"739"	7	3	9	19
1402	1996-02-13	"Tue"	"Midday"	"105"	1	0	5	6
1401	1996-02-12	"Mon"	"Evening"	"415"	4	1	5	10
1400	1996-02-11	"Sun"	"Midday"	"707"	7	0	7	14
1399	1996-02-10	"Sat"	"Evening"	"272"	2	7	2	11
1398	1996-02-09	"Fri"	"Midday"	"245"	2	4	5	11
1397	1996-02-08	"Thu"	"Evening"	"378"	3	7	8	18
1396	1996-02-07	"Wed"	"Midday"	"590"	5	9	0	14
1395	1996-02-06	"Tue"	"Evening"	"198"	1	9	8	18
1394	1996-02-05	"Mon"	"Midday"	"294"	2	9	4	15
1393	1996-02-04	"Sun"	"Evening"	"797"	7	9	7	23
1392	1996-02-03	"Sat"	"Midday"	"056"	0	5	6	11
1391	1996-02-02	"Fri"	"Evening"	"965"	9	6	5	20
1390	1996-02-01	"Thu"	"Midday"	"959"	9	5	9	23
1389	1996-01-31	"Wed"	"Evening"	"700"	7	0	0	7
1388	1996-01-30	"Tue"	"Midday"	"323"	3	2	3	8
1387	1996-01-29	"Mon"	"Evening"	"286"	2	8	6	16
1386	1996-01-28	"Sun"	"Midday"	"016"	0	1	6	7
1385	1996-01-27	"Sat"	"Evening"	"944"	9	4	4	17
1384	1996-01-26	"Fri"	"Midday"	"772"	7	7	2	16
1383	1996-01-25	"Thu"	"Evening"	"580"	5	8	0	13
1382	1996-01-24	"Wed"	"Midday"	"072"	0	7	2	9
1381	1996-01-23	"Tue"	"Evening"	"626"	6	2	6	14
1380	1996-01-22	"Mon"	"Midday"	"914"	9	1	4	14
1379	1996-01-21	"Sun"	"Evening"	"923"	9	2	3	14
1378	1996-01-20	"Sat"	"Midday"	"745"	7	4	5	16
1377	1996-01-19	"Fri"	"Evening"	"511"	5	1	1	7
1376	1996-01-18	"Thu"	"Midday"	"014"	0	1	4	5
1375	1996-01-17	"Wed"	"Evening"	"183"	1	8	3	12
1374	1996-01-16	"Tue"	"Midday"	"642"	6	4	2	12
1373	1996-01-15	"Mon"	"Evening"	"090"	0	9	0	9
1372	1996-01-14	"Sun"	"Midday"	"803"	8	0	3	11
1371	1996-01-13	"Sat"	"Evening"	"582"	5	8	2	15
1370	1996-01-12	"Fri"	"Midday"	"321"	3	2	1	6
1369	1996-01-11	"Thu"	"Evening"	"671"	6	7	1	14
1368	1996-01-10	"Wed"	"Midday"	"961"	9	6	1	16
1367	1996-01-09	"Tue"	"Evening"	"436"	4	3	6	13
1366	1996-01-08	"Mon"	"Midday"	"710"	7	1	0	8
1365	1996-01-07	"Sun"	"Evening"	"138"	1	3	8	12
1364	1996-01-06	"Sat"	"Midday"	"200"	2	0	0	2
1363	1996-01-05	"Fri"	"Evening"	"260"	2	6	0	8
1362	1996-01-04	"Thu"	"Midday"	"845"	8	4	5	17
1361	1996-01-03	"Wed"	"Evening"	"620"	6	2	0	8
1360	1996-01-02	"Tue"	"Midday"	"082"	0	8	2	10
1359	1996-01-01	"Mon"	"Evening"	"781"	7	8	1	16
1358	1995-12-31	"Sun"	"Midday"	"977"	9	7	7	23
1357	1995-12-30	"Sat"	"Evening"	"485"	4	8	5	17
1356	1995-12-29	"Fri"	"Midday"	"638"	6	3	8	17
1355	1995-12-28	"Thu"	"Evening"	"737"	7	3	7	17
1354	1995-12-27	"Wed"	"Midday"	"017"	0	1	7	8
1353	1995-12-26	"Tue"	"Evening"	"018"	0	1	8	9
1352	1995-12-25	"Mon"	"Midday"	"117"	1	1	7	9
1351	1995-12-24	"Sun"	"Evening"	"941"	9	4	1	14
1350	1995-12-23	"Sat"	"Midday"	"054"	0	5	4	9
1349	1995-12-22	"Fri"	"Evening"	"718"	7	1	8	16
1348	1995-12-21	"Thu"	"Midday"	"792"	7	9	2	18
1347	1995-12-20	"Wed"	"Evening"	"869"	8	6	9	23
1346	1995-12-19	"Tue"	"Midday"	"493"	4	9	3	16
1345	1995-12-18	"Mon"	"Evening"	"527"	5	2	7	14
1344	1995-12-17	"Sun"	"Midday"	"864"	8	6	4	18
1343	1995-12-16	"Sat"	"Evening"	"599"	5	9	9	23
1342	1995-12-15	"Fri"	"Midday"	"420"	4	2	0	6
1341	1995-12-14	"Thu"	"Evening"	"081"	0	8	1	9
1340	1995-12-13	"Wed"	"Midday"	"374"	3	7	4	14
1339	1995-12-12	"Tue"	"Evening"	"505"	5	0	5	10
1338	1995-12-11	"Mon"	"Midday"	"974"	9	7	4	20
1337	1995-12-10	"Sun"	"Evening"	"491"	4	9	1	14
1336	1995-12-09	"Sat"	"Midday"	"682"	6	8	2	16
1335	1995-12-08	"Fri"	"Evening"	"542"	5	4	2	11
1334	1995-12-07	"Thu"	"Midday"	"605"	6	0	5	11
1333	1995-12-06	"Wed"	"Evening"	"019"	0	1	9	10
1332	1995-12-05	"Tue"	"Midday"	"438"	4	3	8	15
1331	1995-12-04	"Mon"	"Evening"	"555"	5	5	5	15
1330	1995-12-03	"Sun"	"Midday"	"336"	3	3	6	12
1329	1995-12-02	"Sat"	"Evening"	"503"	5	0	3	8
1328	1995-12-01	"Fri"	"Midday"	"638"	6	3	8	17
1327	1995-11-30	"Thu"	"Evening"	"536"	5	3	6	14
1326	1995-11-29	"Wed"	"Midday"	"824"	8	2	4	14
1325	1995-11-28	"Tue"	"Evening"	"748"	7	4	8	19
1324	1995-11-27	"Mon"	"Midday"	"404"	4	0	4	8
1323	1995-11-26	"Sun"	"Evening"	"655"	6	5	5	16
1322	1995-11-25	"Sat"	"Midday"	"562"	5	6	2	13
1321	1995-11-24	"Fri"	"Evening"	"571"	5	7	1	13
1320	1995-11-23	"Thu"	"Midday"	"870"	8	7	0	15
1319	1995-11-22	"Wed"	"Evening"	"777"	7	7	7	21
1318	1995-11-21	"Tue"	"Midday"	"267"	2	6	7	15
1317	1995-11-20	"Mon"	"Evening"	"432"	4	3	2	9
1316	1995-11-19	"Sun"	"Midday"	"184"	1	8	4	13
1315	1995-11-18	"Sat"	"Evening"	"835"	8	3	5	16
1314	1995-11-17	"Fri"	"Midday"	"787"	7	8	7	22
1313	1995-11-16	"Thu"	"Evening"	"073"	0	7	3	10
1312	1995-11-15	"Wed"	"Midday"	"173"	1	7	3	11
1311	1995-11-14	"Tue"	"Evening"	"804"	8	0	4	12
1310	1995-11-13	"Mon"	"Midday"	"004"	0	0	4	4
1309	1995-11-12	"Sun"	"Evening"	"801"	8	0	1	9
1308	1995-11-11	"Sat"	"Midday"	"859"	8	5	9	22
1307	1995-11-10	"Fri"	"Evening"	"748"	7	4	8	19
1306	1995-11-09	"Thu"	"Midday"	"215"	2	1	5	8
1305	1995-11-08	"Wed"	"Evening"	"972"	9	7	2	18
1304	1995-11-07	"Tue"	"Midday"	"249"	2	4	9	15
1303	1995-11-06	"Mon"	"Evening"	"220"	2	2	0	4
1302	1995-11-05	"Sun"	"Midday"	"374"	3	7	4	14
1301	1995-11-04	"Sat"	"Evening"	"644"	6	4	4	14
1300	1995-11-03	"Fri"	"Midday"	"117"	1	1	7	9
1299	1995-11-02	"Thu"	"Evening"	"147"	1	4	7	12
1298	1995-11-01	"Wed"	"Midday"	"884"	8	8	4	20
1297	1995-10-31	"Tue"	"Evening"	"654"	6	5	4	15
1296	1995-10-30	"Mon"	"Midday"	"422"	4	2	2	8
1295	1995-10-29	"Sun"	"Evening"	"783"	7	8	3	18
1294	1995-10-28	"Sat"	"Midday"	"809"	8	0	9	17
1293	1995-10-27	"Fri"	"Evening"	"151"	1	5	1	7
1292	1995-10-26	"Thu"	"Midday"	"809"	8	0	9	17
1291	1995-10-25	"Wed"	"Evening"	"961"	9	6	1	16
1290	1995-10-24	"Tue"	"Midday"	"098"	0	9	8	17
1289	1995-10-23	"Mon"	"Evening"	"406"	4	0	6	10
1288	1995-10-22	"Sun"	"Midday"	"574"	5	7	4	16
1287	1995-10-21	"Sat"	"Evening"	"920"	9	2	0	11
1286	1995-10-20	"Fri"	"Midday"	"381"	3	8	1	12
1285	1995-10-19	"Thu"	"Evening"	"560"	5	6	0	11
1284	1995-10-18	"Wed"	"Midday"	"320"	3	2	0	5
1283	1995-10-17	"Tue"	"Evening"	"834"	8	3	4	15
1282	1995-10-16	"Mon"	"Midday"	"880"	8	8	0	16
1281	1995-10-15	"Sun"	"Evening"	"698"	6	9	8	23
1280	1995-10-14	"Sat"	"Midday"	"931"	9	3	1	13
1279	1995-10-13	"Fri"	"Evening"	"160"	1	6	0	7
1278	1995-10-12	"Thu"	"Midday"	"266"	2	6	6	14
1277	1995-10-11	"Wed"	"Evening"	"670"	6	7	0	13
1276	1995-10-10	"Tue"	"Midday"	"587"	5	8	7	20
1275	1995-10-09	"Mon"	"Evening"	"830"	8	3	0	11
1274	1995-10-08	"Sun"	"Midday"	"989"	9	8	9	26
1273	1995-10-07	"Sat"	"Evening"	"700"	7	0	0	7
1272	1995-10-06	"Fri"	"Midday"	"467"	4	6	7	17
1271	1995-10-05	"Thu"	"Evening"	"810"	8	1	0	9
1270	1995-10-04	"Wed"	"Midday"	"676"	6	7	6	19
1269	1995-10-03	"Tue"	"Evening"	"139"	1	3	9	13
1268	1995-10-02	"Mon"	"Midday"	"640"	6	4	0	10
1267	1995-10-01	"Sun"	"Evening"	"911"	9	1	1	11
1266	1995-09-30	"Sat"	"Midday"	"795"	7	9	5	21
1265	1995-09-29	"Fri"	"Evening"	"631"	6	3	1	10
1264	1995-09-28	"Thu"	"Midday"	"101"	1	0	1	2
1263	1995-09-27	"Wed"	"Evening"	"881"	8	8	1	17
1262	1995-09-26	"Tue"	"Midday"	"066"	0	6	6	12
1261	1995-09-25	"Mon"	"Evening"	"265"	2	6	5	13
1260	1995-09-24	"Sun"	"Midday"	"013"	0	1	3	4
1259	1995-09-23	"Sat"	"Evening"	"299"	2	9	9	20
1258	1995-09-22	"Fri"	"Midday"	"230"	2	3	0	5
1257	1995-09-21	"Thu"	"Evening"	"377"	3	7	7	17
1256	1995-09-20	"Wed"	"Midday"	"585"	5	8	5	18
1255	1995-09-19	"Tue"	"Evening"	"120"	1	2	0	3
1254	1995-09-18	"Mon"	"Midday"	"159"	1	5	9	15
1253	1995-09-17	"Sun"	"Evening"	"960"	9	6	0	15
1252	1995-09-16	"Sat"	"Midday"	"885"	8	8	5	21
1251	1995-09-15	"Fri"	"Evening"	"776"	7	7	6	20
1250	1995-09-14	"Thu"	"Midday"	"045"	0	4	5	9
1249	1995-09-13	"Wed"	"Evening"	"649"	6	4	9	19
1248	1995-09-12	"Tue"	"Midday"	"181"	1	8	1	10
1247	1995-09-11	"Mon"	"Evening"	"306"	3	0	6	9
1246	1995-09-10	"Sun"	"Midday"	"679"	6	7	9	22
1245	1995-09-09	"Sat"	"Evening"	"594"	5	9	4	18
1244	1995-09-08	"Fri"	"Midday"	"206"	2	0	6	8
1243	1995-09-07	"Thu"	"Evening"	"952"	9	5	2	16
1242	1995-09-06	"Wed"	"Midday"	"359"	3	5	9	17
1241	1995-09-05	"Tue"	"Evening"	"397"	3	9	7	19
1240	1995-09-04	"Mon"	"Midday"	"419"	4	1	9	14
1239	1995-09-03	"Sun"	"Evening"	"450"	4	5	0	9
1238	1995-09-02	"Sat"	"Midday"	"145"	1	4	5	10
1237	1995-09-01	"Fri"	"Evening"	"269"	2	6	9	17
1236	1995-08-31	"Thu"	"Midday"	"380"	3	8	0	11
1235	1995-08-30	"Wed"	"Evening"	"591"	5	9	1	15
1234	1995-08-29	"Tue"	"Midday"	"621"	6	2	1	9
1233	1995-08-28	"Mon"	"Evening"	"426"	4	2	6	12
1232	1995-08-27	"Sun"	"Midday"	"704"	7	0	4	11
1231	1995-08-26	"Sat"	"Evening"	"126"	1	2	6	9
1230	1995-08-25	"Fri"	"Midday"	"818"	8	1	8	17
1229	1995-08-24	"Thu"	"Evening"	"089"	0	8	9	17
1228	1995-08-23	"Wed"	"Midday"	"783"	7	8	3	18
1227	1995-08-22	"Tue"	"Evening"	"124"	1	2	4	7
1226	1995-08-21	"Mon"	"Midday"	"303"	3	0	3	6
1225	1995-08-20	"Sun"	"Evening"	"326"	3	2	6	11
1224	1995-08-19	"Sat"	"Midday"	"886"	8	8	6	22
1223	1995-08-18	"Fri"	"Evening"	"194"	1	9	4	14
1222	1995-08-17	"Thu"	"Midday"	"033"	0	3	3	6
1221	1995-08-16	"Wed"	"Evening"	"626"	6	2	6	14
1220	1995-08-15	"Tue"	"Midday"	"287"	2	8	7	17
1219	1995-08-14	"Mon"	"Evening"	"885"	8	8	5	21
1218	1995-08-13	"Sun"	"Midday"	"703"	7	0	3	10
1217	1995-08-12	"Sat"	"Evening"	"178"	1	7	8	16
1216	1995-08-11	"Fri"	"Midday"	"580"	5	8	0	13
1215	1995-08-10	"Thu"	"Evening"	"913"	9	1	3	13
1214	1995-08-09	"Wed"	"Midday"	"607"	6	0	7	13
1213	1995-08-08	"Tue"	"Evening"	"461"	4	6	1	11
1212	1995-08-07	"Mon"	"Midday"	"538"	5	3	8	16
1211	1995-08-06	"Sun"	"Evening"	"396"	3	9	6	18
1210	1995-08-05	"Sat"	"Midday"	"135"	1	3	5	9
1209	1995-08-04	"Fri"	"Evening"	"154"	1	5	4	10
1208	1995-08-03	"Thu"	"Midday"	"360"	3	6	0	9
1207	1995-08-02	"Wed"	"Evening"	"067"	0	6	7	13
1206	1995-08-01	"Tue"	"Midday"	"924"	9	2	4	15
1205	1995-07-31	"Mon"	"Evening"	"481"	4	8	1	13
1204	1995-07-30	"Sun"	"Midday"	"875"	8	7	5	20
1203	1995-07-29	"Sat"	"Evening"	"634"	6	3	4	13
1202	1995-07-28	"Fri"	"Midday"	"170"	1	7	0	8
1201	1995-07-27	"Thu"	"Evening"	"179"	1	7	9	17
1200	1995-07-26	"Wed"	"Midday"	"944"	9	4	4	17
1199	1995-07-25	"Tue"	"Evening"	"649"	6	4	9	19
1198	1995-07-24	"Mon"	"Midday"	"365"	3	6	5	14
1197	1995-07-23	"Sun"	"Evening"	"058"	0	5	8	13
1196	1995-07-22	"Sat"	"Midday"	"938"	9	3	8	20
1195	1995-07-21	"Fri"	"Evening"	"770"	7	7	0	14
1194	1995-07-20	"Thu"	"Midday"	"949"	9	4	9	22
1193	1995-07-19	"Wed"	"Evening"	"618"	6	1	8	15
1192	1995-07-18	"Tue"	"Midday"	"171"	1	7	1	9
1191	1995-07-17	"Mon"	"Evening"	"261"	2	6	1	9
1190	1995-07-16	"Sun"	"Midday"	"130"	1	3	0	4
1189	1995-07-15	"Sat"	"Evening"	"806"	8	0	6	14
1188	1995-07-14	"Fri"	"Midday"	"984"	9	8	4	21
1187	1995-07-13	"Thu"	"Evening"	"165"	1	6	5	12
1186	1995-07-12	"Wed"	"Midday"	"851"	8	5	1	14
1185	1995-07-11	"Tue"	"Evening"	"765"	7	6	5	18
1184	1995-07-10	"Mon"	"Midday"	"760"	7	6	0	13
1183	1995-07-09	"Sun"	"Evening"	"835"	8	3	5	16
1182	1995-07-08	"Sat"	"Midday"	"506"	5	0	6	11
1181	1995-07-07	"Fri"	"Evening"	"980"	9	8	0	17
1180	1995-07-06	"Thu"	"Midday"	"065"	0	6	5	11
1179	1995-07-05	"Wed"	"Evening"	"739"	7	3	9	19
1178	1995-07-04	"Tue"	"Midday"	"002"	0	0	2	2
1177	1995-07-03	"Mon"	"Evening"	"231"	2	3	1	6
1176	1995-07-02	"Sun"	"Midday"	"449"	4	4	9	17
1175	1995-07-01	"Sat"	"Evening"	"706"	7	0	6	13
1174	1995-06-30	"Fri"	"Midday"	"682"	6	8	2	16
1173	1995-06-29	"Thu"	"Evening"	"339"	3	3	9	15
1172	1995-06-28	"Wed"	"Midday"	"011"	0	1	1	2
1171	1995-06-27	"Tue"	"Evening"	"858"	8	5	8	21
1170	1995-06-26	"Mon"	"Midday"	"254"	2	5	4	11
1169	1995-06-25	"Sun"	"Evening"	"929"	9	2	9	20
1168	1995-06-24	"Sat"	"Midday"	"847"	8	4	7	19
1167	1995-06-23	"Fri"	"Evening"	"915"	9	1	5	15
1166	1995-06-22	"Thu"	"Midday"	"384"	3	8	4	15
1165	1995-06-21	"Wed"	"Evening"	"587"	5	8	7	20
1164	1995-06-20	"Tue"	"Midday"	"529"	5	2	9	16
1163	1995-06-19	"Mon"	"Evening"	"732"	7	3	2	12
1162	1995-06-18	"Sun"	"Midday"	"562"	5	6	2	13
1161	1995-06-17	"Sat"	"Evening"	"519"	5	1	9	15
1160	1995-06-16	"Fri"	"Midday"	"702"	7	0	2	9
1159	1995-06-15	"Thu"	"Evening"	"947"	9	4	7	20
1158	1995-06-14	"Wed"	"Midday"	"858"	8	5	8	21
1157	1995-06-13	"Tue"	"Evening"	"062"	0	6	2	8
1156	1995-06-12	"Mon"	"Midday"	"705"	7	0	5	12
1155	1995-06-11	"Sun"	"Evening"	"126"	1	2	6	9
1154	1995-06-10	"Sat"	"Midday"	"239"	2	3	9	14
1153	1995-06-09	"Fri"	"Evening"	"481"	4	8	1	13
1152	1995-06-08	"Thu"	"Midday"	"858"	8	5	8	21
1151	1995-06-07	"Wed"	"Evening"	"007"	0	0	7	7
1150	1995-06-06	"Tue"	"Midday"	"408"	4	0	8	12
1149	1995-06-05	"Mon"	"Evening"	"619"	6	1	9	16
1148	1995-06-04	"Sun"	"Midday"	"956"	9	5	6	20
1147	1995-06-03	"Sat"	"Evening"	"265"	2	6	5	13
1146	1995-06-02	"Fri"	"Midday"	"503"	5	0	3	8
1145	1995-06-01	"Thu"	"Evening"	"854"	8	5	4	17
1144	1995-05-31	"Wed"	"Midday"	"288"	2	8	8	18
1143	1995-05-30	"Tue"	"Evening"	"345"	3	4	5	12
1142	1995-05-29	"Mon"	"Midday"	"643"	6	4	3	13
1141	1995-05-28	"Sun"	"Evening"	"412"	4	1	2	7
1140	1995-05-27	"Sat"	"Midday"	"801"	8	0	1	9
1139	1995-05-26	"Fri"	"Evening"	"046"	0	4	6	10
1138	1995-05-25	"Thu"	"Midday"	"862"	8	6	2	16
1137	1995-05-24	"Wed"	"Evening"	"759"	7	5	9	21
1136	1995-05-23	"Tue"	"Midday"	"509"	5	0	9	14
1135	1995-05-22	"Mon"	"Evening"	"251"	2	5	1	8
1134	1995-05-21	"Sun"	"Midday"	"887"	8	8	7	23
1133	1995-05-20	"Sat"	"Evening"	"053"	0	5	3	8
1132	1995-05-19	"Fri"	"Midday"	"750"	7	5	0	12
1131	1995-05-18	"Thu"	"Evening"	"085"	0	8	5	13
1130	1995-05-17	"Wed"	"Midday"	"376"	3	7	6	16
1129	1995-05-16	"Tue"	"Evening"	"146"	1	4	6	11
1128	1995-05-15	"Mon"	"Midday"	"480"	4	8	0	12
1127	1995-05-14	"Sun"	"Evening"	"713"	7	1	3	11
1126	1995-05-13	"Sat"	"Midday"	"707"	7	0	7	14
1125	1995-05-12	"Fri"	"Evening"	"174"	1	7	4	12
1124	1995-05-11	"Thu"	"Midday"	"088"	0	8	8	16
1123	1995-05-10	"Wed"	"Evening"	"063"	0	6	3	9
1122	1995-05-09	"Tue"	"Midday"	"171"	1	7	1	9
1121	1995-05-08	"Mon"	"Evening"	"363"	3	6	3	12
1120	1995-05-07	"Sun"	"Midday"	"013"	0	1	3	4
1119	1995-05-06	"Sat"	"Evening"	"802"	8	0	2	10
1118	1995-05-05	"Fri"	"Midday"	"919"	9	1	9	19
1117	1995-05-04	"Thu"	"Evening"	"980"	9	8	0	17
1116	1995-05-03	"Wed"	"Midday"	"159"	1	5	9	15
1115	1995-05-02	"Tue"	"Evening"	"052"	0	5	2	7
1114	1995-05-01	"Mon"	"Midday"	"850"	8	5	0	13
1113	1995-04-30	"Sun"	"Evening"	"559"	5	5	9	19
1112	1995-04-29	"Sat"	"Midday"	"935"	9	3	5	17
1111	1995-04-28	"Fri"	"Evening"	"411"	4	1	1	6
1110	1995-04-27	"Thu"	"Midday"	"049"	0	4	9	13
1109	1995-04-26	"Wed"	"Evening"	"244"	2	4	4	10
1108	1995-04-25	"Tue"	"Midday"	"887"	8	8	7	23
1107	1995-04-24	"Mon"	"Evening"	"163"	1	6	3	10
1106	1995-04-23	"Sun"	"Midday"	"698"	6	9	8	23
1105	1995-04-22	"Sat"	"Evening"	"926"	9	2	6	17
1104	1995-04-21	"Fri"	"Midday"	"535"	5	3	5	13
1103	1995-04-20	"Thu"	"Evening"	"193"	1	9	3	13
1102	1995-04-19	"Wed"	"Midday"	"920"	9	2	0	11
1101	1995-04-18	"Tue"	"Evening"	"418"	4	1	8	13
1100	1995-04-17	"Mon"	"Midday"	"168"	1	6	8	15
1099	1995-04-16	"Sun"	"Evening"	"239"	2	3	9	14
1098	1995-04-15	"Sat"	"Midday"	"108"	1	0	8	9
1097	1995-04-14	"Fri"	"Evening"	"276"	2	7	6	15
1096	1995-04-13	"Thu"	"Midday"	"646"	6	4	6	16
1095	1995-04-12	"Wed"	"Evening"	"947"	9	4	7	20
1094	1995-04-11	"Tue"	"Midday"	"874"	8	7	4	19
1093	1995-04-10	"Mon"	"Evening"	"190"	1	9	0	10
1092	1995-04-09	"Sun"	"Midday"	"932"	9	3	2	14
1091	1995-04-08	"Sat"	"Evening"	"825"	8	2	5	15
1090	1995-04-07	"Fri"	"Midday"	"201"	2	0	1	3
1089	1995-04-06	"Thu"	"Evening"	"081"	0	8	1	9
1088	1995-04-05	"Wed"	"Midday"	"573"	5	7	3	15
1087	1995-04-04	"Tue"	"Evening"	"239"	2	3	9	14
1086	1995-04-03	"Mon"	"Midday"	"531"	5	3	1	9
1085	1995-04-02	"Sun"	"Evening"	"789"	7	8	9	24
1084	1995-04-01	"Sat"	"Midday"	"037"	0	3	7	10
1083	1995-03-31	"Fri"	"Evening"	"354"	3	5	4	12
1082	1995-03-30	"Thu"	"Midday"	"655"	6	5	5	16
1081	1995-03-29	"Wed"	"Evening"	"011"	0	1	1	2
1080	1995-03-28	"Tue"	"Midday"	"244"	2	4	4	10
1079	1995-03-27	"Mon"	"Evening"	"316"	3	1	6	10
1078	1995-03-26	"Sun"	"Midday"	"667"	6	6	7	19
1077	1995-03-25	"Sat"	"Evening"	"382"	3	8	2	13
1076	1995-03-24	"Fri"	"Midday"	"294"	2	9	4	15
1075	1995-03-23	"Thu"	"Evening"	"002"	0	0	2	2
1074	1995-03-22	"Wed"	"Midday"	"949"	9	4	9	22
1073	1995-03-21	"Tue"	"Evening"	"792"	7	9	2	18
1072	1995-03-20	"Mon"	"Midday"	"053"	0	5	3	8
1071	1995-03-19	"Sun"	"Evening"	"769"	7	6	9	22
1070	1995-03-18	"Sat"	"Midday"	"740"	7	4	0	11
1069	1995-03-17	"Fri"	"Evening"	"472"	4	7	2	13
1068	1995-03-16	"Thu"	"Midday"	"609"	6	0	9	15
1067	1995-03-15	"Wed"	"Evening"	"532"	5	3	2	10
1066	1995-03-14	"Tue"	"Midday"	"571"	5	7	1	13
1065	1995-03-13	"Mon"	"Evening"	"282"	2	8	2	12
1064	1995-03-12	"Sun"	"Midday"	"513"	5	1	3	9
1063	1995-03-11	"Sat"	"Evening"	"290"	2	9	0	11
1062	1995-03-10	"Fri"	"Midday"	"233"	2	3	3	8
1061	1995-03-09	"Thu"	"Evening"	"675"	6	7	5	18
1060	1995-03-08	"Wed"	"Midday"	"734"	7	3	4	14
1059	1995-03-07	"Tue"	"Evening"	"304"	3	0	4	7
1058	1995-03-06	"Mon"	"Midday"	"727"	7	2	7	16
1057	1995-03-05	"Sun"	"Evening"	"913"	9	1	3	13
1056	1995-03-04	"Sat"	"Midday"	"595"	5	9	5	19
1055	1995-03-03	"Fri"	"Evening"	"180"	1	8	0	9
1054	1995-03-02	"Thu"	"Midday"	"387"	3	8	7	18
1053	1995-03-01	"Wed"	"Evening"	"774"	7	7	4	18
1052	1995-02-28	"Tue"	"Midday"	"118"	1	1	8	10
1051	1995-02-27	"Mon"	"Evening"	"148"	1	4	8	13
1050	1995-02-26	"Sun"	"Midday"	"855"	8	5	5	18
1049	1995-02-25	"Sat"	"Evening"	"410"	4	1	0	5
1048	1995-02-24	"Fri"	"Midday"	"328"	3	2	8	13
1047	1995-02-23	"Thu"	"Evening"	"957"	9	5	7	21
1046	1995-02-22	"Wed"	"Midday"	"740"	7	4	0	11
1045	1995-02-21	"Tue"	"Evening"	"736"	7	3	6	16
1044	1995-02-20	"Mon"	"Midday"	"784"	7	8	4	19
1043	1995-02-19	"Sun"	"Evening"	"031"	0	3	1	4
1042	1995-02-18	"Sat"	"Midday"	"020"	0	2	0	2
1041	1995-02-17	"Fri"	"Evening"	"741"	7	4	1	12
1040	1995-02-16	"Thu"	"Midday"	"450"	4	5	0	9
1039	1995-02-15	"Wed"	"Evening"	"622"	6	2	2	10
1038	1995-02-14	"Tue"	"Midday"	"319"	3	1	9	13
1037	1995-02-13	"Mon"	"Evening"	"478"	4	7	8	19
1036	1995-02-12	"Sun"	"Midday"	"254"	2	5	4	11
1035	1995-02-11	"Sat"	"Evening"	"488"	4	8	8	20
1034	1995-02-10	"Fri"	"Midday"	"287"	2	8	7	17
1033	1995-02-09	"Thu"	"Evening"	"066"	0	6	6	12
1032	1995-02-08	"Wed"	"Midday"	"267"	2	6	7	15
1031	1995-02-07	"Tue"	"Evening"	"547"	5	4	7	16
1030	1995-02-06	"Mon"	"Midday"	"409"	4	0	9	13
1029	1995-02-05	"Sun"	"Evening"	"738"	7	3	8	18
1028	1995-02-04	"Sat"	"Midday"	"666"	6	6	6	18
1027	1995-02-03	"Fri"	"Evening"	"653"	6	5	3	14
1026	1995-02-02	"Thu"	"Midday"	"946"	9	4	6	19
1025	1995-02-01	"Wed"	"Evening"	"922"	9	2	2	13
1024	1995-01-31	"Tue"	"Midday"	"442"	4	4	2	10
1023	1995-01-30	"Mon"	"Evening"	"238"	2	3	8	13
1022	1995-01-29	"Sun"	"Midday"	"884"	8	8	4	20
1021	1995-01-28	"Sat"	"Evening"	"066"	0	6	6	12
1020	1995-01-27	"Fri"	"Midday"	"844"	8	4	4	16
1019	1995-01-26	"Thu"	"Evening"	"062"	0	6	2	8
1018	1995-01-25	"Wed"	"Midday"	"084"	0	8	4	12
1017	1995-01-24	"Tue"	"Evening"	"032"	0	3	2	5
1016	1995-01-23	"Mon"	"Midday"	"927"	9	2	7	18
1015	1995-01-22	"Sun"	"Evening"	"354"	3	5	4	12
1014	1995-01-21	"Sat"	"Midday"	"544"	5	4	4	13
1013	1995-01-20	"Fri"	"Evening"	"540"	5	4	0	9
1012	1995-01-19	"Thu"	"Midday"	"642"	6	4	2	12
1011	1995-01-18	"Wed"	"Evening"	"480"	4	8	0	12
1010	1995-01-17	"Tue"	"Midday"	"438"	4	3	8	15
1009	1995-01-16	"Mon"	"Evening"	"946"	9	4	6	19
1008	1995-01-15	"Sun"	"Midday"	"002"	0	0	2	2
1007	1995-01-14	"Sat"	"Evening"	"124"	1	2	4	7
1006	1995-01-13	"Fri"	"Midday"	"794"	7	9	4	20
1005	1995-01-12	"Thu"	"Evening"	"065"	0	6	5	11
1004	1995-01-11	"Wed"	"Midday"	"698"	6	9	8	23
1003	1995-01-10	"Tue"	"Evening"	"543"	5	4	3	12
1002	1995-01-09	"Mon"	"Midday"	"112"	1	1	2	4
1001	1995-01-08	"Sun"	"Evening"	"068"	0	6	8	14
1000	1995-01-07	"Sat"	"Midday"	"563"	5	6	3	14
999	1995-01-06	"Fri"	"Evening"	"247"	2	4	7	13
998	1995-01-05	"Thu"	"Midday"	"626"	6	2	6	14
997	1995-01-04	"Wed"	"Evening"	"913"	9	1	3	13
996	1995-01-03	"Tue"	"Midday"	"489"	4	8	9	21
995	1995-01-02	"Mon"	"Evening"	"040"	0	4	0	4
994	1995-01-01	"Sun"	"Midday"	"915"	9	1	5	15
993	1994-12-31	"Sat"	"Evening"	"489"	4	8	9	21
992	1994-12-30	"Fri"	"Midday"	"785"	7	8	5	20
991	1994-12-29	"Thu"	"Evening"	"035"	0	3	5	8
990	1994-12-28	"Wed"	"Midday"	"596"	5	9	6	20
989	1994-12-27	"Tue"	"Evening"	"602"	6	0	2	8
988	1994-12-26	"Mon"	"Midday"	"968"	9	6	8	23
987	1994-12-25	"Sun"	"Evening"	"942"	9	4	2	15
986	1994-12-24	"Sat"	"Midday"	"293"	2	9	3	14
985	1994-12-23	"Fri"	"Evening"	"744"	7	4	4	15
984	1994-12-22	"Thu"	"Midday"	"405"	4	0	5	9
983	1994-12-21	"Wed"	"Evening"	"068"	0	6	8	14
982	1994-12-20	"Tue"	"Midday"	"646"	6	4	6	16
981	1994-12-19	"Mon"	"Evening"	"003"	0	0	3	3
980	1994-12-18	"Sun"	"Midday"	"094"	0	9	4	13
979	1994-12-17	"Sat"	"Evening"	"123"	1	2	3	6
978	1994-12-16	"Fri"	"Midday"	"355"	3	5	5	13
977	1994-12-15	"Thu"	"Evening"	"488"	4	8	8	20
976	1994-12-14	"Wed"	"Midday"	"430"	4	3	0	7
975	1994-12-13	"Tue"	"Evening"	"579"	5	7	9	21
974	1994-12-12	"Mon"	"Midday"	"370"	3	7	0	10
973	1994-12-11	"Sun"	"Evening"	"191"	1	9	1	11
972	1994-12-10	"Sat"	"Midday"	"116"	1	1	6	8
971	1994-12-09	"Fri"	"Evening"	"697"	6	9	7	22
970	1994-12-08	"Thu"	"Midday"	"926"	9	2	6	17
969	1994-12-07	"Wed"	"Evening"	"399"	3	9	9	21
968	1994-12-06	"Tue"	"Midday"	"985"	9	8	5	22
967	1994-12-05	"Mon"	"Evening"	"197"	1	9	7	17
966	1994-12-04	"Sun"	"Midday"	"433"	4	3	3	10
965	1994-12-03	"Sat"	"Evening"	"525"	5	2	5	12
964	1994-12-02	"Fri"	"Midday"	"413"	4	1	3	8
963	1994-12-01	"Thu"	"Evening"	"779"	7	7	9	23
962	1994-11-30	"Wed"	"Midday"	"343"	3	4	3	10
961	1994-11-29	"Tue"	"Evening"	"648"	6	4	8	18
960	1994-11-28	"Mon"	"Midday"	"228"	2	2	8	12
959	1994-11-27	"Sun"	"Evening"	"363"	3	6	3	12
958	1994-11-26	"Sat"	"Midday"	"937"	9	3	7	19
957	1994-11-25	"Fri"	"Evening"	"851"	8	5	1	14
956	1994-11-24	"Thu"	"Midday"	"344"	3	4	4	11
955	1994-11-23	"Wed"	"Evening"	"092"	0	9	2	11
954	1994-11-22	"Tue"	"Midday"	"956"	9	5	6	20
953	1994-11-21	"Mon"	"Evening"	"664"	6	6	4	16
952	1994-11-20	"Sun"	"Midday"	"191"	1	9	1	11
951	1994-11-19	"Sat"	"Evening"	"315"	3	1	5	9
950	1994-11-18	"Fri"	"Midday"	"115"	1	1	5	7
949	1994-11-17	"Thu"	"Evening"	"148"	1	4	8	13
948	1994-11-16	"Wed"	"Midday"	"961"	9	6	1	16
947	1994-11-15	"Tue"	"Evening"	"482"	4	8	2	14
946	1994-11-14	"Mon"	"Midday"	"199"	1	9	9	19
945	1994-11-13	"Sun"	"Evening"	"829"	8	2	9	19
944	1994-11-12	"Sat"	"Midday"	"262"	2	6	2	10
943	1994-11-11	"Fri"	"Evening"	"495"	4	9	5	18
942	1994-11-10	"Thu"	"Midday"	"963"	9	6	3	18
941	1994-11-09	"Wed"	"Evening"	"205"	2	0	5	7
940	1994-11-08	"Tue"	"Midday"	"006"	0	0	6	6
939	1994-11-07	"Mon"	"Evening"	"946"	9	4	6	19
938	1994-11-06	"Sun"	"Midday"	"783"	7	8	3	18
937	1994-11-05	"Sat"	"Evening"	"099"	0	9	9	18
936	1994-11-04	"Fri"	"Midday"	"462"	4	6	2	12
935	1994-11-03	"Thu"	"Evening"	"869"	8	6	9	23
934	1994-11-02	"Wed"	"Midday"	"307"	3	0	7	10
933	1994-11-01	"Tue"	"Evening"	"162"	1	6	2	9
932	1994-10-31	"Mon"	"Midday"	"226"	2	2	6	10
931	1994-10-30	"Sun"	"Evening"	"742"	7	4	2	13
930	1994-10-29	"Sat"	"Midday"	"194"	1	9	4	14
929	1994-10-28	"Fri"	"Evening"	"368"	3	6	8	17
928	1994-10-27	"Thu"	"Midday"	"314"	3	1	4	8
927	1994-10-26	"Wed"	"Evening"	"378"	3	7	8	18
926	1994-10-25	"Tue"	"Midday"	"099"	0	9	9	18
925	1994-10-24	"Mon"	"Evening"	"797"	7	9	7	23
924	1994-10-23	"Sun"	"Midday"	"276"	2	7	6	15
923	1994-10-22	"Sat"	"Evening"	"387"	3	8	7	18
922	1994-10-21	"Fri"	"Midday"	"224"	2	2	4	8
921	1994-10-20	"Thu"	"Evening"	"241"	2	4	1	7
920	1994-10-19	"Wed"	"Midday"	"355"	3	5	5	13
919	1994-10-18	"Tue"	"Evening"	"104"	1	0	4	5
918	1994-10-17	"Mon"	"Midday"	"494"	4	9	4	17
917	1994-10-16	"Sun"	"Evening"	"186"	1	8	6	15
916	1994-10-15	"Sat"	"Midday"	"122"	1	2	2	5
915	1994-10-14	"Fri"	"Evening"	"458"	4	5	8	17
914	1994-10-13	"Thu"	"Midday"	"370"	3	7	0	10
913	1994-10-12	"Wed"	"Evening"	"274"	2	7	4	13
912	1994-10-11	"Tue"	"Midday"	"167"	1	6	7	14
911	1994-10-10	"Mon"	"Evening"	"314"	3	1	4	8
910	1994-10-09	"Sun"	"Midday"	"666"	6	6	6	18
909	1994-10-08	"Sat"	"Evening"	"253"	2	5	3	10
908	1994-10-07	"Fri"	"Midday"	"724"	7	2	4	13
907	1994-10-06	"Thu"	"Evening"	"950"	9	5	0	14
906	1994-10-05	"Wed"	"Midday"	"639"	6	3	9	18
905	1994-10-04	"Tue"	"Evening"	"460"	4	6	0	10
904	1994-10-03	"Mon"	"Midday"	"185"	1	8	5	14
903	1994-10-02	"Sun"	"Evening"	"572"	5	7	2	14
902	1994-10-01	"Sat"	"Midday"	"953"	9	5	3	17
901	1994-09-30	"Fri"	"Evening"	"404"	4	0	4	8
900	1994-09-29	"Thu"	"Midday"	"278"	2	7	8	17
899	1994-09-28	"Wed"	"Evening"	"046"	0	4	6	10
898	1994-09-27	"Tue"	"Midday"	"321"	3	2	1	6
897	1994-09-26	"Mon"	"Evening"	"821"	8	2	1	11
896	1994-09-25	"Sun"	"Midday"	"970"	9	7	0	16
895	1994-09-24	"Sat"	"Evening"	"665"	6	6	5	17
894	1994-09-23	"Fri"	"Midday"	"594"	5	9	4	18
893	1994-09-22	"Thu"	"Evening"	"615"	6	1	5	12
892	1994-09-21	"Wed"	"Midday"	"277"	2	7	7	16
891	1994-09-20	"Tue"	"Evening"	"504"	5	0	4	9
890	1994-09-19	"Mon"	"Midday"	"030"	0	3	0	3
889	1994-09-18	"Sun"	"Evening"	"275"	2	7	5	14
888	1994-09-17	"Sat"	"Midday"	"108"	1	0	8	9
887	1994-09-16	"Fri"	"Evening"	"460"	4	6	0	10
886	1994-09-15	"Thu"	"Midday"	"540"	5	4	0	9
885	1994-09-14	"Wed"	"Evening"	"225"	2	2	5	9
884	1994-09-13	"Tue"	"Midday"	"435"	4	3	5	12
883	1994-09-12	"Mon"	"Evening"	"488"	4	8	8	20
882	1994-09-11	"Sun"	"Midday"	"725"	7	2	5	14
881	1994-09-10	"Sat"	"Evening"	"899"	8	9	9	26
880	1994-09-09	"Fri"	"Midday"	"647"	6	4	7	17
879	1994-09-08	"Thu"	"Evening"	"823"	8	2	3	13
878	1994-09-07	"Wed"	"Midday"	"923"	9	2	3	14
877	1994-09-06	"Tue"	"Evening"	"700"	7	0	0	7
876	1994-09-05	"Mon"	"Midday"	"581"	5	8	1	14
875	1994-09-04	"Sun"	"Evening"	"249"	2	4	9	15
874	1994-09-03	"Sat"	"Midday"	"697"	6	9	7	22
873	1994-09-02	"Fri"	"Evening"	"367"	3	6	7	16
872	1994-09-01	"Thu"	"Midday"	"147"	1	4	7	12
871	1994-08-31	"Wed"	"Evening"	"092"	0	9	2	11
870	1994-08-30	"Tue"	"Midday"	"113"	1	1	3	5
869	1994-08-29	"Mon"	"Evening"	"497"	4	9	7	20
868	1994-08-28	"Sun"	"Midday"	"042"	0	4	2	6
867	1994-08-27	"Sat"	"Evening"	"297"	2	9	7	18
866	1994-08-26	"Fri"	"Midday"	"694"	6	9	4	19
865	1994-08-25	"Thu"	"Evening"	"710"	7	1	0	8
864	1994-08-24	"Wed"	"Midday"	"441"	4	4	1	9
863	1994-08-23	"Tue"	"Evening"	"271"	2	7	1	10
862	1994-08-22	"Mon"	"Midday"	"355"	3	5	5	13
861	1994-08-21	"Sun"	"Evening"	"830"	8	3	0	11
860	1994-08-20	"Sat"	"Midday"	"278"	2	7	8	17
859	1994-08-19	"Fri"	"Evening"	"568"	5	6	8	19
858	1994-08-18	"Thu"	"Midday"	"024"	0	2	4	6
857	1994-08-17	"Wed"	"Evening"	"453"	4	5	3	12
856	1994-08-16	"Tue"	"Midday"	"967"	9	6	7	22
855	1994-08-15	"Mon"	"Evening"	"609"	6	0	9	15
854	1994-08-14	"Sun"	"Midday"	"024"	0	2	4	6
853	1994-08-13	"Sat"	"Evening"	"952"	9	5	2	16
852	1994-08-12	"Fri"	"Midday"	"830"	8	3	0	11
851	1994-08-11	"Thu"	"Evening"	"330"	3	3	0	6
850	1994-08-10	"Wed"	"Midday"	"189"	1	8	9	18
849	1994-08-09	"Tue"	"Evening"	"424"	4	2	4	10
848	1994-08-08	"Mon"	"Midday"	"773"	7	7	3	17
847	1994-08-07	"Sun"	"Evening"	"012"	0	1	2	3
846	1994-08-06	"Sat"	"Midday"	"088"	0	8	8	16
845	1994-08-05	"Fri"	"Evening"	"431"	4	3	1	8
844	1994-08-04	"Thu"	"Midday"	"670"	6	7	0	13
843	1994-08-03	"Wed"	"Evening"	"867"	8	6	7	21
842	1994-08-02	"Tue"	"Midday"	"750"	7	5	0	12
841	1994-08-01	"Mon"	"Evening"	"276"	2	7	6	15
840	1994-07-31	"Sun"	"Midday"	"909"	9	0	9	18
839	1994-07-30	"Sat"	"Evening"	"669"	6	6	9	21
838	1994-07-29	"Fri"	"Midday"	"238"	2	3	8	13
837	1994-07-28	"Thu"	"Evening"	"785"	7	8	5	20
836	1994-07-27	"Wed"	"Midday"	"371"	3	7	1	11
835	1994-07-26	"Tue"	"Evening"	"929"	9	2	9	20
834	1994-07-25	"Mon"	"Midday"	"039"	0	3	9	12
833	1994-07-24	"Sun"	"Evening"	"882"	8	8	2	18
832	1994-07-23	"Sat"	"Midday"	"237"	2	3	7	12
831	1994-07-22	"Fri"	"Evening"	"227"	2	2	7	11
830	1994-07-21	"Thu"	"Midday"	"569"	5	6	9	20
829	1994-07-20	"Wed"	"Evening"	"489"	4	8	9	21
828	1994-07-19	"Tue"	"Midday"	"438"	4	3	8	15
827	1994-07-18	"Mon"	"Evening"	"961"	9	6	1	16
826	1994-07-17	"Sun"	"Midday"	"691"	6	9	1	16
825	1994-07-16	"Sat"	"Evening"	"171"	1	7	1	9
824	1994-07-15	"Fri"	"Midday"	"325"	3	2	5	10
823	1994-07-14	"Thu"	"Evening"	"015"	0	1	5	6
822	1994-07-13	"Wed"	"Midday"	"832"	8	3	2	13
821	1994-07-12	"Tue"	"Evening"	"073"	0	7	3	10
820	1994-07-11	"Mon"	"Midday"	"777"	7	7	7	21
819	1994-07-10	"Sun"	"Evening"	"611"	6	1	1	8
818	1994-07-09	"Sat"	"Midday"	"498"	4	9	8	21
817	1994-07-08	"Fri"	"Evening"	"165"	1	6	5	12
816	1994-07-07	"Thu"	"Midday"	"424"	4	2	4	10
815	1994-07-06	"Wed"	"Evening"	"549"	5	4	9	18
814	1994-07-05	"Tue"	"Midday"	"321"	3	2	1	6
813	1994-07-04	"Mon"	"Evening"	"681"	6	8	1	15
812	1994-07-03	"Sun"	"Midday"	"424"	4	2	4	10
811	1994-07-02	"Sat"	"Evening"	"644"	6	4	4	14
810	1994-07-01	"Fri"	"Midday"	"003"	0	0	3	3
809	1994-06-30	"Thu"	"Evening"	"505"	5	0	5	10
808	1994-06-29	"Wed"	"Midday"	"669"	6	6	9	21
807	1994-06-28	"Tue"	"Evening"	"217"	2	1	7	10
806	1994-06-27	"Mon"	"Midday"	"994"	9	9	4	22
805	1994-06-26	"Sun"	"Evening"	"662"	6	6	2	14
804	1994-06-25	"Sat"	"Midday"	"474"	4	7	4	15
803	1994-06-24	"Fri"	"Evening"	"888"	8	8	8	24
802	1994-06-23	"Thu"	"Midday"	"610"	6	1	0	7
801	1994-06-22	"Wed"	"Evening"	"492"	4	9	2	15
800	1994-06-21	"Tue"	"Midday"	"590"	5	9	0	14
799	1994-06-20	"Mon"	"Evening"	"776"	7	7	6	20
798	1994-06-19	"Sun"	"Midday"	"000"	0	0	0	0
797	1994-06-18	"Sat"	"Evening"	"656"	6	5	6	17
796	1994-06-17	"Fri"	"Midday"	"578"	5	7	8	20
795	1994-06-16	"Thu"	"Evening"	"978"	9	7	8	24
794	1994-06-15	"Wed"	"Midday"	"346"	3	4	6	13
793	1994-06-14	"Tue"	"Evening"	"834"	8	3	4	15
792	1994-06-13	"Mon"	"Midday"	"299"	2	9	9	20
791	1994-06-12	"Sun"	"Evening"	"363"	3	6	3	12
790	1994-06-11	"Sat"	"Midday"	"556"	5	5	6	16
789	1994-06-10	"Fri"	"Evening"	"643"	6	4	3	13
788	1994-06-09	"Thu"	"Midday"	"435"	4	3	5	12
787	1994-06-08	"Wed"	"Evening"	"273"	2	7	3	12
786	1994-06-07	"Tue"	"Midday"	"265"	2	6	5	13
785	1994-06-06	"Mon"	"Evening"	"029"	0	2	9	11
784	1994-06-05	"Sun"	"Midday"	"393"	3	9	3	15
783	1994-06-04	"Sat"	"Evening"	"293"	2	9	3	14
782	1994-06-03	"Fri"	"Midday"	"761"	7	6	1	14
781	1994-06-02	"Thu"	"Evening"	"980"	9	8	0	17
780	1994-06-01	"Wed"	"Midday"	"605"	6	0	5	11
779	1994-05-31	"Tue"	"Evening"	"278"	2	7	8	17
778	1994-05-30	"Mon"	"Midday"	"177"	1	7	7	15
777	1994-05-29	"Sun"	"Evening"	"732"	7	3	2	12
776	1994-05-28	"Sat"	"Midday"	"012"	0	1	2	3
775	1994-05-27	"Fri"	"Evening"	"580"	5	8	0	13
774	1994-05-26	"Thu"	"Midday"	"695"	6	9	5	20
773	1994-05-25	"Wed"	"Evening"	"356"	3	5	6	14
772	1994-05-24	"Tue"	"Midday"	"068"	0	6	8	14
771	1994-05-23	"Mon"	"Evening"	"880"	8	8	0	16
770	1994-05-22	"Sun"	"Midday"	"750"	7	5	0	12
769	1994-05-21	"Sat"	"Evening"	"607"	6	0	7	13
768	1994-05-20	"Fri"	"Midday"	"552"	5	5	2	12
767	1994-05-19	"Thu"	"Evening"	"035"	0	3	5	8
766	1994-05-18	"Wed"	"Midday"	"252"	2	5	2	9
765	1994-05-17	"Tue"	"Evening"	"014"	0	1	4	5
764	1994-05-16	"Mon"	"Midday"	"008"	0	0	8	8
763	1994-05-15	"Sun"	"Evening"	"231"	2	3	1	6
762	1994-05-14	"Sat"	"Midday"	"043"	0	4	3	7
761	1994-05-13	"Fri"	"Evening"	"578"	5	7	8	20
760	1994-05-12	"Thu"	"Midday"	"009"	0	0	9	9
759	1994-05-11	"Wed"	"Evening"	"219"	2	1	9	12
758	1994-05-10	"Tue"	"Midday"	"465"	4	6	5	15
757	1994-05-09	"Mon"	"Evening"	"310"	3	1	0	4
756	1994-05-08	"Sun"	"Midday"	"724"	7	2	4	13
755	1994-05-07	"Sat"	"Evening"	"543"	5	4	3	12
754	1994-05-06	"Fri"	"Midday"	"025"	0	2	5	7
753	1994-05-05	"Thu"	"Evening"	"133"	1	3	3	7
752	1994-05-04	"Wed"	"Midday"	"696"	6	9	6	21
751	1994-05-03	"Tue"	"Evening"	"926"	9	2	6	17
750	1994-05-02	"Mon"	"Midday"	"598"	5	9	8	22
749	1994-05-01	"Sun"	"Evening"	"790"	7	9	0	16
748	1994-04-30	"Sat"	"Midday"	"022"	0	2	2	4
747	1994-04-29	"Fri"	"Evening"	"927"	9	2	7	18
746	1994-04-28	"Thu"	"Midday"	"107"	1	0	7	8
745	1994-04-27	"Wed"	"Evening"	"492"	4	9	2	15
744	1994-04-26	"Tue"	"Midday"	"932"	9	3	2	14
743	1994-04-25	"Mon"	"Evening"	"619"	6	1	9	16
742	1994-04-24	"Sun"	"Midday"	"871"	8	7	1	16
741	1994-04-23	"Sat"	"Evening"	"407"	4	0	7	11
740	1994-04-22	"Fri"	"Midday"	"267"	2	6	7	15
739	1994-04-21	"Thu"	"Evening"	"420"	4	2	0	6
738	1994-04-20	"Wed"	"Midday"	"905"	9	0	5	14
737	1994-04-19	"Tue"	"Evening"	"112"	1	1	2	4
736	1994-04-18	"Mon"	"Midday"	"806"	8	0	6	14
735	1994-04-17	"Sun"	"Evening"	"524"	5	2	4	11
734	1994-04-16	"Sat"	"Midday"	"679"	6	7	9	22
733	1994-04-15	"Fri"	"Evening"	"245"	2	4	5	11
732	1994-04-14	"Thu"	"Midday"	"241"	2	4	1	7
731	1994-04-13	"Wed"	"Evening"	"907"	9	0	7	16
730	1994-04-12	"Tue"	"Midday"	"265"	2	6	5	13
729	1994-04-11	"Mon"	"Evening"	"655"	6	5	5	16
728	1994-04-10	"Sun"	"Midday"	"377"	3	7	7	17
727	1994-04-09	"Sat"	"Evening"	"869"	8	6	9	23
726	1994-04-08	"Fri"	"Midday"	"664"	6	6	4	16
725	1994-04-07	"Thu"	"Evening"	"413"	4	1	3	8
724	1994-04-06	"Wed"	"Midday"	"639"	6	3	9	18
723	1994-04-05	"Tue"	"Evening"	"745"	7	4	5	16
722	1994-04-04	"Mon"	"Midday"	"366"	3	6	6	15
721	1994-04-03	"Sun"	"Evening"	"294"	2	9	4	15
720	1994-04-02	"Sat"	"Midday"	"645"	6	4	5	15
719	1994-04-01	"Fri"	"Evening"	"097"	0	9	7	16
718	1994-03-31	"Thu"	"Midday"	"474"	4	7	4	15
717	1994-03-30	"Wed"	"Evening"	"741"	7	4	1	12
716	1994-03-29	"Tue"	"Midday"	"016"	0	1	6	7
715	1994-03-28	"Mon"	"Evening"	"122"	1	2	2	5
714	1994-03-27	"Sun"	"Midday"	"612"	6	1	2	9
713	1994-03-26	"Sat"	"Evening"	"792"	7	9	2	18
712	1994-03-25	"Fri"	"Midday"	"970"	9	7	0	16
711	1994-03-24	"Thu"	"Evening"	"823"	8	2	3	13
710	1994-03-23	"Wed"	"Midday"	"646"	6	4	6	16
709	1994-03-22	"Tue"	"Evening"	"287"	2	8	7	17
708	1994-03-21	"Mon"	"Midday"	"413"	4	1	3	8
707	1994-03-20	"Sun"	"Evening"	"851"	8	5	1	14
706	1994-03-19	"Sat"	"Midday"	"126"	1	2	6	9
705	1994-03-18	"Fri"	"Evening"	"360"	3	6	0	9
704	1994-03-17	"Thu"	"Midday"	"528"	5	2	8	15
703	1994-03-16	"Wed"	"Evening"	"025"	0	2	5	7
702	1994-03-15	"Tue"	"Midday"	"207"	2	0	7	9
701	1994-03-14	"Mon"	"Evening"	"150"	1	5	0	6
700	1994-03-13	"Sun"	"Midday"	"634"	6	3	4	13
699	1994-03-12	"Sat"	"Evening"	"964"	9	6	4	19
698	1994-03-11	"Fri"	"Midday"	"798"	7	9	8	24
697	1994-03-10	"Thu"	"Evening"	"540"	5	4	0	9
696	1994-03-09	"Wed"	"Midday"	"788"	7	8	8	23
695	1994-03-08	"Tue"	"Evening"	"074"	0	7	4	11
694	1994-03-07	"Mon"	"Midday"	"405"	4	0	5	9
693	1994-03-06	"Sun"	"Evening"	"438"	4	3	8	15
692	1994-03-05	"Sat"	"Midday"	"189"	1	8	9	18
691	1994-03-04	"Fri"	"Evening"	"560"	5	6	0	11
690	1994-03-03	"Thu"	"Midday"	"345"	3	4	5	12
689	1994-03-02	"Wed"	"Evening"	"389"	3	8	9	20
688	1994-03-01	"Tue"	"Midday"	"464"	4	6	4	14
687	1994-02-28	"Mon"	"Evening"	"670"	6	7	0	13
686	1994-02-27	"Sun"	"Midday"	"176"	1	7	6	14
685	1994-02-26	"Sat"	"Evening"	"714"	7	1	4	12
684	1994-02-25	"Fri"	"Midday"	"410"	4	1	0	5
683	1994-02-24	"Thu"	"Evening"	"401"	4	0	1	5
682	1994-02-23	"Wed"	"Midday"	"578"	5	7	8	20
681	1994-02-22	"Tue"	"Evening"	"379"	3	7	9	19
680	1994-02-21	"Mon"	"Midday"	"194"	1	9	4	14
679	1994-02-20	"Sun"	"Evening"	"500"	5	0	0	5
678	1994-02-19	"Sat"	"Midday"	"836"	8	3	6	17
677	1994-02-18	"Fri"	"Evening"	"344"	3	4	4	11
676	1994-02-17	"Thu"	"Midday"	"720"	7	2	0	9
675	1994-02-16	"Wed"	"Evening"	"229"	2	2	9	13
674	1994-02-15	"Tue"	"Midday"	"504"	5	0	4	9
673	1994-02-14	"Mon"	"Evening"	"389"	3	8	9	20
672	1994-02-13	"Sun"	"Midday"	"589"	5	8	9	22
671	1994-02-12	"Sat"	"Evening"	"973"	9	7	3	19
670	1994-02-11	"Fri"	"Midday"	"490"	4	9	0	13
669	1994-02-10	"Thu"	"Evening"	"484"	4	8	4	16
668	1994-02-09	"Wed"	"Midday"	"650"	6	5	0	11
667	1994-02-08	"Tue"	"Evening"	"470"	4	7	0	11
666	1994-02-07	"Mon"	"Midday"	"449"	4	4	9	17
665	1994-02-06	"Sun"	"Evening"	"232"	2	3	2	7
664	1994-02-05	"Sat"	"Midday"	"689"	6	8	9	23
663	1994-02-04	"Fri"	"Evening"	"923"	9	2	3	14
662	1994-02-03	"Thu"	"Midday"	"712"	7	1	2	10
661	1994-02-02	"Wed"	"Evening"	"302"	3	0	2	5
660	1994-02-01	"Tue"	"Midday"	"718"	7	1	8	16
659	1994-01-31	"Mon"	"Evening"	"187"	1	8	7	16
658	1994-01-30	"Sun"	"Midday"	"112"	1	1	2	4
657	1994-01-29	"Sat"	"Evening"	"072"	0	7	2	9
656	1994-01-28	"Fri"	"Midday"	"572"	5	7	2	14
655	1994-01-27	"Thu"	"Evening"	"332"	3	3	2	8
654	1994-01-26	"Wed"	"Midday"	"239"	2	3	9	14
653	1994-01-25	"Tue"	"Evening"	"361"	3	6	1	10
652	1994-01-24	"Mon"	"Midday"	"481"	4	8	1	13
651	1994-01-23	"Sun"	"Evening"	"529"	5	2	9	16
650	1994-01-22	"Sat"	"Midday"	"598"	5	9	8	22
649	1994-01-21	"Fri"	"Evening"	"556"	5	5	6	16
648	1994-01-20	"Thu"	"Midday"	"505"	5	0	5	10
647	1994-01-19	"Wed"	"Evening"	"452"	4	5	2	11
646	1994-01-18	"Tue"	"Midday"	"169"	1	6	9	16
645	1994-01-17	"Mon"	"Evening"	"081"	0	8	1	9
644	1994-01-16	"Sun"	"Midday"	"980"	9	8	0	17
643	1994-01-15	"Sat"	"Evening"	"156"	1	5	6	12
642	1994-01-14	"Fri"	"Midday"	"737"	7	3	7	17
641	1994-01-13	"Thu"	"Evening"	"683"	6	8	3	17
640	1994-01-12	"Wed"	"Midday"	"728"	7	2	8	17
639	1994-01-11	"Tue"	"Evening"	"924"	9	2	4	15
638	1994-01-10	"Mon"	"Midday"	"843"	8	4	3	15
637	1994-01-09	"Sun"	"Evening"	"161"	1	6	1	8
636	1994-01-08	"Sat"	"Midday"	"924"	9	2	4	15
635	1994-01-07	"Fri"	"Evening"	"055"	0	5	5	10
634	1994-01-06	"Thu"	"Midday"	"078"	0	7	8	15
633	1994-01-05	"Wed"	"Evening"	"305"	3	0	5	8
632	1994-01-04	"Tue"	"Midday"	"317"	3	1	7	11
631	1994-01-03	"Mon"	"Evening"	"661"	6	6	1	13
630	1994-01-02	"Sun"	"Midday"	"532"	5	3	2	10
629	1994-01-01	"Sat"	"Evening"	"995"	9	9	5	23
628	1993-12-31	"Fri"	"Midday"	"313"	3	1	3	7
627	1993-12-30	"Thu"	"Evening"	"673"	6	7	3	16
626	1993-12-29	"Wed"	"Midday"	"418"	4	1	8	13
625	1993-12-28	"Tue"	"Evening"	"427"	4	2	7	13
624	1993-12-27	"Mon"	"Midday"	"495"	4	9	5	18
623	1993-12-26	"Sun"	"Evening"	"517"	5	1	7	13
622	1993-12-25	"Sat"	"Midday"	"912"	9	1	2	12
621	1993-12-24	"Fri"	"Evening"	"460"	4	6	0	10
620	1993-12-23	"Thu"	"Midday"	"853"	8	5	3	16
619	1993-12-22	"Wed"	"Evening"	"217"	2	1	7	10
618	1993-12-21	"Tue"	"Midday"	"245"	2	4	5	11
617	1993-12-20	"Mon"	"Evening"	"910"	9	1	0	10
616	1993-12-19	"Sun"	"Midday"	"411"	4	1	1	6
615	1993-12-18	"Sat"	"Evening"	"292"	2	9	2	13
614	1993-12-17	"Fri"	"Midday"	"114"	1	1	4	6
613	1993-12-16	"Thu"	"Evening"	"903"	9	0	3	12
612	1993-12-15	"Wed"	"Midday"	"071"	0	7	1	8
611	1993-12-14	"Tue"	"Evening"	"896"	8	9	6	23
610	1993-12-13	"Mon"	"Midday"	"279"	2	7	9	18
609	1993-12-12	"Sun"	"Evening"	"741"	7	4	1	12
608	1993-12-11	"Sat"	"Midday"	"879"	8	7	9	24
607	1993-12-10	"Fri"	"Evening"	"539"	5	3	9	17
606	1993-12-09	"Thu"	"Midday"	"201"	2	0	1	3
605	1993-12-08	"Wed"	"Evening"	"913"	9	1	3	13
604	1993-12-07	"Tue"	"Midday"	"750"	7	5	0	12
603	1993-12-06	"Mon"	"Evening"	"279"	2	7	9	18
602	1993-12-05	"Sun"	"Midday"	"434"	4	3	4	11
601	1993-12-04	"Sat"	"Evening"	"460"	4	6	0	10
600	1993-12-03	"Fri"	"Midday"	"110"	1	1	0	2
599	1993-12-02	"Thu"	"Evening"	"100"	1	0	0	1
598	1993-12-01	"Wed"	"Midday"	"463"	4	6	3	13
597	1993-11-30	"Tue"	"Evening"	"238"	2	3	8	13
596	1993-11-29	"Mon"	"Midday"	"783"	7	8	3	18
595	1993-11-28	"Sun"	"Evening"	"884"	8	8	4	20
594	1993-11-27	"Sat"	"Midday"	"706"	7	0	6	13
593	1993-11-26	"Fri"	"Evening"	"285"	2	8	5	15
592	1993-11-25	"Thu"	"Midday"	"292"	2	9	2	13
591	1993-11-24	"Wed"	"Evening"	"118"	1	1	8	10
590	1993-11-23	"Tue"	"Midday"	"750"	7	5	0	12
589	1993-11-22	"Mon"	"Evening"	"200"	2	0	0	2
588	1993-11-21	"Sun"	"Midday"	"584"	5	8	4	17
587	1993-11-20	"Sat"	"Evening"	"131"	1	3	1	5
586	1993-11-19	"Fri"	"Midday"	"392"	3	9	2	14
585	1993-11-18	"Thu"	"Evening"	"672"	6	7	2	15
584	1993-11-17	"Wed"	"Midday"	"707"	7	0	7	14
583	1993-11-16	"Tue"	"Evening"	"408"	4	0	8	12
582	1993-11-15	"Mon"	"Midday"	"458"	4	5	8	17
581	1993-11-14	"Sun"	"Evening"	"997"	9	9	7	25
580	1993-11-13	"Sat"	"Midday"	"439"	4	3	9	16
579	1993-11-12	"Fri"	"Evening"	"908"	9	0	8	17
578	1993-11-11	"Thu"	"Midday"	"060"	0	6	0	6
577	1993-11-10	"Wed"	"Evening"	"824"	8	2	4	14
576	1993-11-09	"Tue"	"Midday"	"067"	0	6	7	13
575	1993-11-08	"Mon"	"Evening"	"101"	1	0	1	2
574	1993-11-07	"Sun"	"Midday"	"561"	5	6	1	12
573	1993-11-06	"Sat"	"Evening"	"101"	1	0	1	2
572	1993-11-05	"Fri"	"Midday"	"467"	4	6	7	17
571	1993-11-04	"Thu"	"Evening"	"451"	4	5	1	10
570	1993-11-03	"Wed"	"Midday"	"636"	6	3	6	15
569	1993-11-02	"Tue"	"Evening"	"450"	4	5	0	9
568	1993-11-01	"Mon"	"Midday"	"918"	9	1	8	18
567	1993-10-31	"Sun"	"Evening"	"623"	6	2	3	11
566	1993-10-30	"Sat"	"Midday"	"118"	1	1	8	10
565	1993-10-29	"Fri"	"Evening"	"750"	7	5	0	12
564	1993-10-28	"Thu"	"Midday"	"126"	1	2	6	9
563	1993-10-27	"Wed"	"Evening"	"304"	3	0	4	7
562	1993-10-26	"Tue"	"Midday"	"852"	8	5	2	15
561	1993-10-25	"Mon"	"Evening"	"697"	6	9	7	22
560	1993-10-24	"Sun"	"Midday"	"326"	3	2	6	11
559	1993-10-23	"Sat"	"Evening"	"954"	9	5	4	18
558	1993-10-22	"Fri"	"Midday"	"387"	3	8	7	18
557	1993-10-21	"Thu"	"Evening"	"071"	0	7	1	8
556	1993-10-20	"Wed"	"Midday"	"727"	7	2	7	16
555	1993-10-19	"Tue"	"Evening"	"702"	7	0	2	9
554	1993-10-18	"Mon"	"Midday"	"992"	9	9	2	20
553	1993-10-17	"Sun"	"Evening"	"391"	3	9	1	13
552	1993-10-16	"Sat"	"Midday"	"039"	0	3	9	12
551	1993-10-15	"Fri"	"Evening"	"536"	5	3	6	14
550	1993-10-14	"Thu"	"Midday"	"538"	5	3	8	16
549	1993-10-13	"Wed"	"Evening"	"928"	9	2	8	19
548	1993-10-12	"Tue"	"Midday"	"239"	2	3	9	14
547	1993-10-11	"Mon"	"Evening"	"332"	3	3	2	8
546	1993-10-10	"Sun"	"Midday"	"621"	6	2	1	9
545	1993-10-09	"Sat"	"Evening"	"807"	8	0	7	15
544	1993-10-08	"Fri"	"Midday"	"305"	3	0	5	8
543	1993-10-07	"Thu"	"Evening"	"048"	0	4	8	12
542	1993-10-06	"Wed"	"Midday"	"435"	4	3	5	12
541	1993-10-05	"Tue"	"Evening"	"462"	4	6	2	12
540	1993-10-04	"Mon"	"Midday"	"837"	8	3	7	18
539	1993-10-03	"Sun"	"Evening"	"149"	1	4	9	14
538	1993-10-02	"Sat"	"Midday"	"997"	9	9	7	25
537	1993-10-01	"Fri"	"Evening"	"921"	9	2	1	12
536	1993-09-30	"Thu"	"Midday"	"519"	5	1	9	15
535	1993-09-29	"Wed"	"Evening"	"009"	0	0	9	9
534	1993-09-28	"Tue"	"Midday"	"209"	2	0	9	11
533	1993-09-27	"Mon"	"Evening"	"737"	7	3	7	17
532	1993-09-26	"Sun"	"Midday"	"174"	1	7	4	12
531	1993-09-25	"Sat"	"Evening"	"068"	0	6	8	14
530	1993-09-24	"Fri"	"Midday"	"895"	8	9	5	22
529	1993-09-23	"Thu"	"Evening"	"494"	4	9	4	17
528	1993-09-22	"Wed"	"Midday"	"360"	3	6	0	9
527	1993-09-21	"Tue"	"Evening"	"720"	7	2	0	9
526	1993-09-20	"Mon"	"Midday"	"512"	5	1	2	8
525	1993-09-19	"Sun"	"Evening"	"913"	9	1	3	13
524	1993-09-18	"Sat"	"Midday"	"773"	7	7	3	17
523	1993-09-17	"Fri"	"Evening"	"022"	0	2	2	4
522	1993-09-16	"Thu"	"Midday"	"948"	9	4	8	21
521	1993-09-15	"Wed"	"Evening"	"464"	4	6	4	14
520	1993-09-14	"Tue"	"Midday"	"628"	6	2	8	16
519	1993-09-13	"Mon"	"Evening"	"470"	4	7	0	11
518	1993-09-12	"Sun"	"Midday"	"908"	9	0	8	17
517	1993-09-11	"Sat"	"Evening"	"312"	3	1	2	6
516	1993-09-10	"Fri"	"Midday"	"408"	4	0	8	12
515	1993-09-09	"Thu"	"Evening"	"648"	6	4	8	18
514	1993-09-08	"Wed"	"Midday"	"183"	1	8	3	12
513	1993-09-07	"Tue"	"Evening"	"750"	7	5	0	12
512	1993-09-06	"Mon"	"Midday"	"057"	0	5	7	12
511	1993-09-05	"Sun"	"Evening"	"592"	5	9	2	16
510	1993-09-04	"Sat"	"Midday"	"587"	5	8	7	20
509	1993-09-03	"Fri"	"Evening"	"796"	7	9	6	22
508	1993-09-02	"Thu"	"Midday"	"941"	9	4	1	14
507	1993-09-01	"Wed"	"Evening"	"905"	9	0	5	14
506	1993-08-31	"Tue"	"Midday"	"901"	9	0	1	10
505	1993-08-30	"Mon"	"Evening"	"670"	6	7	0	13
504	1993-08-29	"Sun"	"Midday"	"426"	4	2	6	12
503	1993-08-28	"Sat"	"Evening"	"900"	9	0	0	9
502	1993-08-27	"Fri"	"Midday"	"479"	4	7	9	20
501	1993-08-26	"Thu"	"Evening"	"468"	4	6	8	18
500	1993-08-25	"Wed"	"Midday"	"695"	6	9	5	20
499	1993-08-24	"Tue"	"Evening"	"027"	0	2	7	9
498	1993-08-23	"Mon"	"Midday"	"683"	6	8	3	17
497	1993-08-22	"Sun"	"Evening"	"805"	8	0	5	13
496	1993-08-21	"Sat"	"Midday"	"203"	2	0	3	5
495	1993-08-20	"Fri"	"Evening"	"496"	4	9	6	19
494	1993-08-19	"Thu"	"Midday"	"934"	9	3	4	16
493	1993-08-18	"Wed"	"Evening"	"856"	8	5	6	19
492	1993-08-17	"Tue"	"Midday"	"805"	8	0	5	13
491	1993-08-16	"Mon"	"Evening"	"692"	6	9	2	17
490	1993-08-15	"Sun"	"Midday"	"341"	3	4	1	8
489	1993-08-14	"Sat"	"Evening"	"251"	2	5	1	8
488	1993-08-13	"Fri"	"Midday"	"481"	4	8	1	13
487	1993-08-12	"Thu"	"Evening"	"989"	9	8	9	26
486	1993-08-11	"Wed"	"Midday"	"115"	1	1	5	7
485	1993-08-10	"Tue"	"Evening"	"942"	9	4	2	15
484	1993-08-09	"Mon"	"Midday"	"284"	2	8	4	14
483	1993-08-08	"Sun"	"Evening"	"452"	4	5	2	11
482	1993-08-07	"Sat"	"Midday"	"555"	5	5	5	15
481	1993-08-06	"Fri"	"Evening"	"644"	6	4	4	14
480	1993-08-05	"Thu"	"Midday"	"746"	7	4	6	17
479	1993-08-04	"Wed"	"Evening"	"340"	3	4	0	7
478	1993-08-03	"Tue"	"Midday"	"417"	4	1	7	12
477	1993-08-02	"Mon"	"Evening"	"029"	0	2	9	11
476	1993-08-01	"Sun"	"Midday"	"448"	4	4	8	16
475	1993-07-31	"Sat"	"Evening"	"953"	9	5	3	17
474	1993-07-30	"Fri"	"Midday"	"361"	3	6	1	10
473	1993-07-29	"Thu"	"Evening"	"757"	7	5	7	19
472	1993-07-28	"Wed"	"Midday"	"103"	1	0	3	4
471	1993-07-27	"Tue"	"Evening"	"086"	0	8	6	14
470	1993-07-26	"Mon"	"Midday"	"892"	8	9	2	19
469	1993-07-25	"Sun"	"Evening"	"579"	5	7	9	21
468	1993-07-24	"Sat"	"Midday"	"233"	2	3	3	8
467	1993-07-23	"Fri"	"Evening"	"739"	7	3	9	19
466	1993-07-22	"Thu"	"Midday"	"475"	4	7	5	16
465	1993-07-21	"Wed"	"Evening"	"655"	6	5	5	16
464	1993-07-20	"Tue"	"Midday"	"208"	2	0	8	10
463	1993-07-19	"Mon"	"Evening"	"145"	1	4	5	10
462	1993-07-18	"Sun"	"Midday"	"089"	0	8	9	17
461	1993-07-17	"Sat"	"Evening"	"078"	0	7	8	15
460	1993-07-16	"Fri"	"Midday"	"292"	2	9	2	13
459	1993-07-15	"Thu"	"Evening"	"850"	8	5	0	13
458	1993-07-14	"Wed"	"Midday"	"350"	3	5	0	8
457	1993-07-13	"Tue"	"Evening"	"458"	4	5	8	17
456	1993-07-12	"Mon"	"Midday"	"108"	1	0	8	9
455	1993-07-11	"Sun"	"Evening"	"313"	3	1	3	7
454	1993-07-10	"Sat"	"Midday"	"736"	7	3	6	16
453	1993-07-09	"Fri"	"Evening"	"903"	9	0	3	12
452	1993-07-08	"Thu"	"Midday"	"878"	8	7	8	23
451	1993-07-07	"Wed"	"Evening"	"990"	9	9	0	18
450	1993-07-06	"Tue"	"Midday"	"415"	4	1	5	10
449	1993-07-05	"Mon"	"Evening"	"390"	3	9	0	12
448	1993-07-04	"Sun"	"Midday"	"572"	5	7	2	14
447	1993-07-03	"Sat"	"Evening"	"786"	7	8	6	21
446	1993-07-02	"Fri"	"Midday"	"071"	0	7	1	8
445	1993-07-01	"Thu"	"Evening"	"806"	8	0	6	14
444	1993-06-30	"Wed"	"Midday"	"041"	0	4	1	5
443	1993-06-29	"Tue"	"Evening"	"292"	2	9	2	13
442	1993-06-28	"Mon"	"Midday"	"295"	2	9	5	16
441	1993-06-27	"Sun"	"Evening"	"859"	8	5	9	22
440	1993-06-26	"Sat"	"Midday"	"426"	4	2	6	12
439	1993-06-25	"Fri"	"Evening"	"796"	7	9	6	22
438	1993-06-24	"Thu"	"Midday"	"592"	5	9	2	16
437	1993-06-23	"Wed"	"Evening"	"547"	5	4	7	16
436	1993-06-22	"Tue"	"Midday"	"841"	8	4	1	13
435	1993-06-21	"Mon"	"Evening"	"668"	6	6	8	20
434	1993-06-20	"Sun"	"Midday"	"632"	6	3	2	11
433	1993-06-19	"Sat"	"Evening"	"940"	9	4	0	13
432	1993-06-18	"Fri"	"Midday"	"844"	8	4	4	16
431	1993-06-17	"Thu"	"Evening"	"917"	9	1	7	17
430	1993-06-16	"Wed"	"Midday"	"681"	6	8	1	15
429	1993-06-15	"Tue"	"Evening"	"003"	0	0	3	3
428	1993-06-14	"Mon"	"Midday"	"404"	4	0	4	8
427	1993-06-13	"Sun"	"Evening"	"581"	5	8	1	14
426	1993-06-12	"Sat"	"Midday"	"736"	7	3	6	16
425	1993-06-11	"Fri"	"Evening"	"993"	9	9	3	21
424	1993-06-10	"Thu"	"Midday"	"650"	6	5	0	11
423	1993-06-09	"Wed"	"Evening"	"199"	1	9	9	19
422	1993-06-08	"Tue"	"Midday"	"459"	4	5	9	18
421	1993-06-07	"Mon"	"Evening"	"403"	4	0	3	7
420	1993-06-06	"Sun"	"Midday"	"349"	3	4	9	16
419	1993-06-05	"Sat"	"Evening"	"323"	3	2	3	8
418	1993-06-04	"Fri"	"Midday"	"178"	1	7	8	16
417	1993-06-03	"Thu"	"Evening"	"061"	0	6	1	7
416	1993-06-02	"Wed"	"Midday"	"824"	8	2	4	14
415	1993-06-01	"Tue"	"Evening"	"921"	9	2	1	12
414	1993-05-31	"Mon"	"Midday"	"819"	8	1	9	18
413	1993-05-30	"Sun"	"Evening"	"010"	0	1	0	1
412	1993-05-29	"Sat"	"Midday"	"483"	4	8	3	15
411	1993-05-28	"Fri"	"Evening"	"874"	8	7	4	19
410	1993-05-27	"Thu"	"Midday"	"917"	9	1	7	17
409	1993-05-26	"Wed"	"Evening"	"801"	8	0	1	9
408	1993-05-25	"Tue"	"Midday"	"120"	1	2	0	3
407	1993-05-24	"Mon"	"Evening"	"905"	9	0	5	14
406	1993-05-23	"Sun"	"Midday"	"069"	0	6	9	15
405	1993-05-22	"Sat"	"Evening"	"114"	1	1	4	6
404	1993-05-21	"Fri"	"Midday"	"935"	9	3	5	17
403	1993-05-20	"Thu"	"Evening"	"671"	6	7	1	14
402	1993-05-19	"Wed"	"Midday"	"530"	5	3	0	8
401	1993-05-18	"Tue"	"Evening"	"833"	8	3	3	14
400	1993-05-17	"Mon"	"Midday"	"027"	0	2	7	9
399	1993-05-16	"Sun"	"Evening"	"736"	7	3	6	16
398	1993-05-15	"Sat"	"Midday"	"963"	9	6	3	18
397	1993-05-14	"Fri"	"Evening"	"672"	6	7	2	15
396	1993-05-13	"Thu"	"Midday"	"163"	1	6	3	10
395	1993-05-12	"Wed"	"Evening"	"012"	0	1	2	3
394	1993-05-11	"Tue"	"Midday"	"793"	7	9	3	19
393	1993-05-10	"Mon"	"Evening"	"286"	2	8	6	16
392	1993-05-09	"Sun"	"Midday"	"031"	0	3	1	4
391	1993-05-08	"Sat"	"Evening"	"251"	2	5	1	8
390	1993-05-07	"Fri"	"Midday"	"276"	2	7	6	15
389	1993-05-06	"Thu"	"Evening"	"841"	8	4	1	13
388	1993-05-05	"Wed"	"Midday"	"394"	3	9	4	16
387	1993-05-04	"Tue"	"Evening"	"274"	2	7	4	13
386	1993-05-03	"Mon"	"Midday"	"519"	5	1	9	15
385	1993-05-02	"Sun"	"Evening"	"283"	2	8	3	13
384	1993-05-01	"Sat"	"Midday"	"392"	3	9	2	14
383	1993-04-30	"Fri"	"Evening"	"421"	4	2	1	7
382	1993-04-29	"Thu"	"Midday"	"270"	2	7	0	9
381	1993-04-28	"Wed"	"Evening"	"046"	0	4	6	10
380	1993-04-27	"Tue"	"Midday"	"321"	3	2	1	6
379	1993-04-26	"Mon"	"Evening"	"001"	0	0	1	1
378	1993-04-25	"Sun"	"Midday"	"963"	9	6	3	18
377	1993-04-24	"Sat"	"Evening"	"857"	8	5	7	20
376	1993-04-23	"Fri"	"Midday"	"243"	2	4	3	9
375	1993-04-22	"Thu"	"Evening"	"279"	2	7	9	18
374	1993-04-21	"Wed"	"Midday"	"829"	8	2	9	19
373	1993-04-20	"Tue"	"Evening"	"001"	0	0	1	1
372	1993-04-19	"Mon"	"Midday"	"769"	7	6	9	22
371	1993-04-18	"Sun"	"Evening"	"283"	2	8	3	13
370	1993-04-17	"Sat"	"Midday"	"446"	4	4	6	14
369	1993-04-16	"Fri"	"Evening"	"372"	3	7	2	12
368	1993-04-15	"Thu"	"Midday"	"226"	2	2	6	10
367	1993-04-14	"Wed"	"Evening"	"947"	9	4	7	20
366	1993-04-13	"Tue"	"Midday"	"687"	6	8	7	21
365	1993-04-12	"Mon"	"Evening"	"322"	3	2	2	7
364	1993-04-11	"Sun"	"Midday"	"243"	2	4	3	9
363	1993-04-10	"Sat"	"Evening"	"070"	0	7	0	7
362	1993-04-09	"Fri"	"Midday"	"802"	8	0	2	10
361	1993-04-08	"Thu"	"Evening"	"427"	4	2	7	13
360	1993-04-07	"Wed"	"Midday"	"747"	7	4	7	18
359	1993-04-06	"Tue"	"Evening"	"715"	7	1	5	13
358	1993-04-05	"Mon"	"Midday"	"716"	7	1	6	14
357	1993-04-04	"Sun"	"Evening"	"894"	8	9	4	21
356	1993-04-03	"Sat"	"Midday"	"086"	0	8	6	14
355	1993-04-02	"Fri"	"Evening"	"193"	1	9	3	13
354	1993-04-01	"Thu"	"Midday"	"862"	8	6	2	16
353	1993-03-31	"Wed"	"Evening"	"976"	9	7	6	22
352	1993-03-30	"Tue"	"Midday"	"049"	0	4	9	13
351	1993-03-29	"Mon"	"Evening"	"141"	1	4	1	6
350	1993-03-28	"Sun"	"Midday"	"248"	2	4	8	14
349	1993-03-27	"Sat"	"Evening"	"601"	6	0	1	7
348	1993-03-26	"Fri"	"Midday"	"777"	7	7	7	21
347	1993-03-25	"Thu"	"Evening"	"410"	4	1	0	5
346	1993-03-24	"Wed"	"Midday"	"755"	7	5	5	17
345	1993-03-23	"Tue"	"Evening"	"112"	1	1	2	4
344	1993-03-22	"Mon"	"Midday"	"707"	7	0	7	14
343	1993-03-21	"Sun"	"Evening"	"387"	3	8	7	18
342	1993-03-20	"Sat"	"Midday"	"111"	1	1	1	3
341	1993-03-19	"Fri"	"Evening"	"732"	7	3	2	12
340	1993-03-18	"Thu"	"Midday"	"773"	7	7	3	17
339	1993-03-17	"Wed"	"Evening"	"774"	7	7	4	18
338	1993-03-16	"Tue"	"Midday"	"807"	8	0	7	15
337	1993-03-15	"Mon"	"Evening"	"132"	1	3	2	6
336	1993-03-14	"Sun"	"Midday"	"454"	4	5	4	13
335	1993-03-13	"Sat"	"Evening"	"817"	8	1	7	16
334	1993-03-12	"Fri"	"Midday"	"539"	5	3	9	17
333	1993-03-11	"Thu"	"Evening"	"459"	4	5	9	18
332	1993-03-10	"Wed"	"Midday"	"211"	2	1	1	4
331	1993-03-09	"Tue"	"Evening"	"589"	5	8	9	22
330	1993-03-08	"Mon"	"Midday"	"264"	2	6	4	12
329	1993-03-07	"Sun"	"Evening"	"766"	7	6	6	19
328	1993-03-06	"Sat"	"Midday"	"147"	1	4	7	12
327	1993-03-05	"Fri"	"Evening"	"168"	1	6	8	15
326	1993-03-04	"Thu"	"Midday"	"432"	4	3	2	9
325	1993-03-03	"Wed"	"Evening"	"135"	1	3	5	9
324	1993-03-02	"Tue"	"Midday"	"848"	8	4	8	20
323	1993-03-01	"Mon"	"Evening"	"358"	3	5	8	16
322	1993-02-28	"Sun"	"Midday"	"040"	0	4	0	4
321	1993-02-27	"Sat"	"Evening"	"124"	1	2	4	7
320	1993-02-26	"Fri"	"Midday"	"168"	1	6	8	15
319	1993-02-25	"Thu"	"Evening"	"081"	0	8	1	9
318	1993-02-24	"Wed"	"Midday"	"773"	7	7	3	17
317	1993-02-23	"Tue"	"Evening"	"113"	1	1	3	5
316	1993-02-22	"Mon"	"Midday"	"438"	4	3	8	15
315	1993-02-21	"Sun"	"Evening"	"115"	1	1	5	7
314	1993-02-20	"Sat"	"Midday"	"130"	1	3	0	4
313	1993-02-19	"Fri"	"Evening"	"441"	4	4	1	9
312	1993-02-18	"Thu"	"Midday"	"563"	5	6	3	14
311	1993-02-17	"Wed"	"Evening"	"337"	3	3	7	13
310	1993-02-16	"Tue"	"Midday"	"930"	9	3	0	12
309	1993-02-15	"Mon"	"Evening"	"328"	3	2	8	13
308	1993-02-14	"Sun"	"Midday"	"219"	2	1	9	12
307	1993-02-13	"Sat"	"Evening"	"491"	4	9	1	14
306	1993-02-12	"Fri"	"Midday"	"923"	9	2	3	14
305	1993-02-11	"Thu"	"Evening"	"749"	7	4	9	20
304	1993-02-10	"Wed"	"Midday"	"428"	4	2	8	14
303	1993-02-09	"Tue"	"Evening"	"146"	1	4	6	11
302	1993-02-08	"Mon"	"Midday"	"508"	5	0	8	13
301	1993-02-07	"Sun"	"Evening"	"683"	6	8	3	17
300	1993-02-06	"Sat"	"Midday"	"617"	6	1	7	14
299	1993-02-05	"Fri"	"Evening"	"975"	9	7	5	21
298	1993-02-04	"Thu"	"Midday"	"030"	0	3	0	3
297	1993-02-03	"Wed"	"Evening"	"441"	4	4	1	9
296	1993-02-02	"Tue"	"Midday"	"639"	6	3	9	18
295	1993-02-01	"Mon"	"Evening"	"192"	1	9	2	12
294	1993-01-31	"Sun"	"Midday"	"349"	3	4	9	16
293	1993-01-30	"Sat"	"Evening"	"695"	6	9	5	20
292	1993-01-29	"Fri"	"Midday"	"414"	4	1	4	9
291	1993-01-28	"Thu"	"Evening"	"626"	6	2	6	14
290	1993-01-27	"Wed"	"Midday"	"582"	5	8	2	15
289	1993-01-26	"Tue"	"Evening"	"916"	9	1	6	16
288	1993-01-25	"Mon"	"Midday"	"087"	0	8	7	15
287	1993-01-24	"Sun"	"Evening"	"376"	3	7	6	16
286	1993-01-23	"Sat"	"Midday"	"209"	2	0	9	11
285	1993-01-22	"Fri"	"Evening"	"842"	8	4	2	14
284	1993-01-21	"Thu"	"Midday"	"662"	6	6	2	14
283	1993-01-20	"Wed"	"Evening"	"000"	0	0	0	0
282	1993-01-19	"Tue"	"Midday"	"398"	3	9	8	20
281	1993-01-18	"Mon"	"Evening"	"568"	5	6	8	19
280	1993-01-17	"Sun"	"Midday"	"561"	5	6	1	12
279	1993-01-16	"Sat"	"Evening"	"631"	6	3	1	10
278	1993-01-15	"Fri"	"Midday"	"122"	1	2	2	5
277	1993-01-14	"Thu"	"Evening"	"573"	5	7	3	15
276	1993-01-13	"Wed"	"Midday"	"367"	3	6	7	16
275	1993-01-12	"Tue"	"Evening"	"446"	4	4	6	14
274	1993-01-11	"Mon"	"Midday"	"213"	2	1	3	6
273	1993-01-10	"Sun"	"Evening"	"332"	3	3	2	8
272	1993-01-09	"Sat"	"Midday"	"374"	3	7	4	14
271	1993-01-08	"Fri"	"Evening"	"399"	3	9	9	21
270	1993-01-07	"Thu"	"Midday"	"156"	1	5	6	12
269	1993-01-06	"Wed"	"Evening"	"913"	9	1	3	13
268	1993-01-05	"Tue"	"Midday"	"020"	0	2	0	2
267	1993-01-04	"Mon"	"Evening"	"462"	4	6	2	12
266	1993-01-03	"Sun"	"Midday"	"240"	2	4	0	6
265	1993-01-02	"Sat"	"Evening"	"641"	6	4	1	11
264	1993-01-01	"Fri"	"Midday"	"148"	1	4	8	13
263	1992-12-31	"Thu"	"Evening"	"004"	0	0	4	4
262	1992-12-30	"Wed"	"Midday"	"100"	1	0	0	1
261	1992-12-29	"Tue"	"Evening"	"420"	4	2	0	6
260	1992-12-28	"Mon"	"Midday"	"681"	6	8	1	15
259	1992-12-27	"Sun"	"Evening"	"061"	0	6	1	7
258	1992-12-26	"Sat"	"Midday"	"461"	4	6	1	11
257	1992-12-25	"Fri"	"Evening"	"053"	0	5	3	8
256	1992-12-24	"Thu"	"Midday"	"417"	4	1	7	12
255	1992-12-23	"Wed"	"Evening"	"993"	9	9	3	21
254	1992-12-22	"Tue"	"Midday"	"998"	9	9	8	26
253	1992-12-21	"Mon"	"Evening"	"447"	4	4	7	15
252	1992-12-20	"Sun"	"Midday"	"280"	2	8	0	10
251	1992-12-19	"Sat"	"Evening"	"921"	9	2	1	12
250	1992-12-18	"Fri"	"Midday"	"686"	6	8	6	20
249	1992-12-17	"Thu"	"Evening"	"344"	3	4	4	11
248	1992-12-16	"Wed"	"Midday"	"239"	2	3	9	14
247	1992-12-15	"Tue"	"Evening"	"292"	2	9	2	13
246	1992-12-14	"Mon"	"Midday"	"655"	6	5	5	16
245	1992-12-13	"Sun"	"Evening"	"109"	1	0	9	10
244	1992-12-12	"Sat"	"Midday"	"685"	6	8	5	19
243	1992-12-11	"Fri"	"Evening"	"524"	5	2	4	11
242	1992-12-10	"Thu"	"Midday"	"319"	3	1	9	13
241	1992-12-09	"Wed"	"Evening"	"158"	1	5	8	14
240	1992-12-08	"Tue"	"Midday"	"375"	3	7	5	15
239	1992-12-07	"Mon"	"Evening"	"922"	9	2	2	13
238	1992-12-06	"Sun"	"Midday"	"112"	1	1	2	4
237	1992-12-05	"Sat"	"Evening"	"590"	5	9	0	14
236	1992-12-04	"Fri"	"Midday"	"789"	7	8	9	24
235	1992-12-03	"Thu"	"Evening"	"851"	8	5	1	14
234	1992-12-02	"Wed"	"Midday"	"849"	8	4	9	21
233	1992-12-01	"Tue"	"Evening"	"715"	7	1	5	13
232	1992-11-30	"Mon"	"Midday"	"720"	7	2	0	9
231	1992-11-29	"Sun"	"Evening"	"273"	2	7	3	12
230	1992-11-28	"Sat"	"Midday"	"279"	2	7	9	18
229	1992-11-27	"Fri"	"Evening"	"297"	2	9	7	18
228	1992-11-26	"Thu"	"Midday"	"723"	7	2	3	12
227	1992-11-25	"Wed"	"Evening"	"477"	4	7	7	18
226	1992-11-24	"Tue"	"Midday"	"810"	8	1	0	9
225	1992-11-23	"Mon"	"Evening"	"685"	6	8	5	19
224	1992-11-22	"Sun"	"Midday"	"235"	2	3	5	10
223	1992-11-21	"Sat"	"Evening"	"425"	4	2	5	11
222	1992-11-20	"Fri"	"Midday"	"167"	1	6	7	14
221	1992-11-19	"Thu"	"Evening"	"105"	1	0	5	6
220	1992-11-18	"Wed"	"Midday"	"085"	0	8	5	13
219	1992-11-17	"Tue"	"Evening"	"213"	2	1	3	6
218	1992-11-16	"Mon"	"Midday"	"824"	8	2	4	14
217	1992-11-15	"Sun"	"Evening"	"068"	0	6	8	14
216	1992-11-14	"Sat"	"Midday"	"739"	7	3	9	19
215	1992-11-13	"Fri"	"Evening"	"889"	8	8	9	25
214	1992-11-12	"Thu"	"Midday"	"680"	6	8	0	14
213	1992-11-11	"Wed"	"Evening"	"116"	1	1	6	8
212	1992-11-10	"Tue"	"Midday"	"875"	8	7	5	20
211	1992-11-09	"Mon"	"Evening"	"638"	6	3	8	17
210	1992-11-08	"Sun"	"Midday"	"932"	9	3	2	14
209	1992-11-07	"Sat"	"Evening"	"339"	3	3	9	15
208	1992-11-06	"Fri"	"Midday"	"083"	0	8	3	11
207	1992-11-05	"Thu"	"Evening"	"235"	2	3	5	10
206	1992-11-04	"Wed"	"Midday"	"312"	3	1	2	6
205	1992-11-03	"Tue"	"Evening"	"277"	2	7	7	16
204	1992-11-02	"Mon"	"Midday"	"089"	0	8	9	17
203	1992-11-01	"Sun"	"Evening"	"320"	3	2	0	5
202	1992-10-31	"Sat"	"Midday"	"142"	1	4	2	7
201	1992-10-30	"Fri"	"Evening"	"600"	6	0	0	6
200	1992-10-29	"Thu"	"Midday"	"056"	0	5	6	11
199	1992-10-28	"Wed"	"Evening"	"266"	2	6	6	14
198	1992-10-27	"Tue"	"Midday"	"358"	3	5	8	16
197	1992-10-26	"Mon"	"Evening"	"851"	8	5	1	14
196	1992-10-25	"Sun"	"Midday"	"139"	1	3	9	13
195	1992-10-24	"Sat"	"Evening"	"148"	1	4	8	13
194	1992-10-23	"Fri"	"Midday"	"065"	0	6	5	11
193	1992-10-22	"Thu"	"Evening"	"772"	7	7	2	16
192	1992-10-21	"Wed"	"Midday"	"797"	7	9	7	23
191	1992-10-20	"Tue"	"Evening"	"073"	0	7	3	10
190	1992-10-19	"Mon"	"Midday"	"339"	3	3	9	15
189	1992-10-18	"Sun"	"Evening"	"580"	5	8	0	13
188	1992-10-17	"Sat"	"Midday"	"655"	6	5	5	16
187	1992-10-16	"Fri"	"Evening"	"757"	7	5	7	19
186	1992-10-15	"Thu"	"Midday"	"635"	6	3	5	14
185	1992-10-14	"Wed"	"Evening"	"094"	0	9	4	13
184	1992-10-13	"Tue"	"Midday"	"293"	2	9	3	14
183	1992-10-12	"Mon"	"Evening"	"696"	6	9	6	21
182	1992-10-11	"Sun"	"Midday"	"938"	9	3	8	20
181	1992-10-10	"Sat"	"Evening"	"408"	4	0	8	12
180	1992-10-09	"Fri"	"Midday"	"909"	9	0	9	18
179	1992-10-08	"Thu"	"Evening"	"518"	5	1	8	14
178	1992-10-07	"Wed"	"Midday"	"525"	5	2	5	12
177	1992-10-06	"Tue"	"Evening"	"305"	3	0	5	8
176	1992-10-05	"Mon"	"Midday"	"749"	7	4	9	20
175	1992-10-04	"Sun"	"Evening"	"825"	8	2	5	15
174	1992-10-03	"Sat"	"Midday"	"992"	9	9	2	20
173	1992-10-02	"Fri"	"Evening"	"790"	7	9	0	16
172	1992-10-01	"Thu"	"Midday"	"654"	6	5	4	15
171	1992-09-30	"Wed"	"Evening"	"332"	3	3	2	8
170	1992-09-29	"Tue"	"Midday"	"698"	6	9	8	23
169	1992-09-28	"Mon"	"Evening"	"844"	8	4	4	16
168	1992-09-27	"Sun"	"Midday"	"436"	4	3	6	13
167	1992-09-26	"Sat"	"Evening"	"527"	5	2	7	14
166	1992-09-25	"Fri"	"Midday"	"438"	4	3	8	15
165	1992-09-24	"Thu"	"Evening"	"397"	3	9	7	19
164	1992-09-23	"Wed"	"Midday"	"966"	9	6	6	21
163	1992-09-22	"Tue"	"Evening"	"449"	4	4	9	17
162	1992-09-21	"Mon"	"Midday"	"177"	1	7	7	15
161	1992-09-20	"Sun"	"Evening"	"460"	4	6	0	10
160	1992-09-19	"Sat"	"Midday"	"284"	2	8	4	14
159	1992-09-18	"Fri"	"Evening"	"360"	3	6	0	9
158	1992-09-17	"Thu"	"Midday"	"625"	6	2	5	13
157	1992-09-16	"Wed"	"Evening"	"932"	9	3	2	14
156	1992-09-15	"Tue"	"Midday"	"207"	2	0	7	9
155	1992-09-14	"Mon"	"Evening"	"010"	0	1	0	1
154	1992-09-13	"Sun"	"Midday"	"855"	8	5	5	18
153	1992-09-12	"Sat"	"Evening"	"543"	5	4	3	12
152	1992-09-11	"Fri"	"Midday"	"629"	6	2	9	17
151	1992-09-10	"Thu"	"Evening"	"630"	6	3	0	9
150	1992-09-09	"Wed"	"Midday"	"944"	9	4	4	17
149	1992-09-08	"Tue"	"Evening"	"658"	6	5	8	19
148	1992-09-07	"Mon"	"Midday"	"258"	2	5	8	15
147	1992-09-06	"Sun"	"Evening"	"106"	1	0	6	7
146	1992-09-05	"Sat"	"Midday"	"645"	6	4	5	15
145	1992-09-04	"Fri"	"Evening"	"452"	4	5	2	11
144	1992-09-03	"Thu"	"Midday"	"131"	1	3	1	5
143	1992-09-02	"Wed"	"Evening"	"268"	2	6	8	16
142	1992-09-01	"Tue"	"Midday"	"412"	4	1	2	7
141	1992-08-31	"Mon"	"Evening"	"224"	2	2	4	8
140	1992-08-30	"Sun"	"Midday"	"612"	6	1	2	9
139	1992-08-29	"Sat"	"Evening"	"544"	5	4	4	13
138	1992-08-28	"Fri"	"Midday"	"331"	3	3	1	7
137	1992-08-27	"Thu"	"Evening"	"334"	3	3	4	10
136	1992-08-26	"Wed"	"Midday"	"886"	8	8	6	22
135	1992-08-25	"Tue"	"Evening"	"480"	4	8	0	12
134	1992-08-24	"Mon"	"Midday"	"097"	0	9	7	16
133	1992-08-23	"Sun"	"Evening"	"672"	6	7	2	15
132	1992-08-22	"Sat"	"Midday"	"019"	0	1	9	10
131	1992-08-21	"Fri"	"Evening"	"152"	1	5	2	8
130	1992-08-20	"Thu"	"Midday"	"707"	7	0	7	14
129	1992-08-19	"Wed"	"Evening"	"364"	3	6	4	13
128	1992-08-18	"Tue"	"Midday"	"808"	8	0	8	16
127	1992-08-17	"Mon"	"Evening"	"324"	3	2	4	9
126	1992-08-16	"Sun"	"Midday"	"566"	5	6	6	17
125	1992-08-15	"Sat"	"Evening"	"925"	9	2	5	16
124	1992-08-14	"Fri"	"Midday"	"112"	1	1	2	4
123	1992-08-13	"Thu"	"Evening"	"961"	9	6	1	16
122	1992-08-12	"Wed"	"Midday"	"125"	1	2	5	8
121	1992-08-11	"Tue"	"Evening"	"974"	9	7	4	20
120	1992-08-10	"Mon"	"Midday"	"888"	8	8	8	24
119	1992-08-09	"Sun"	"Evening"	"331"	3	3	1	7
118	1992-08-08	"Sat"	"Midday"	"019"	0	1	9	10
117	1992-08-07	"Fri"	"Evening"	"372"	3	7	2	12
116	1992-08-06	"Thu"	"Midday"	"146"	1	4	6	11
115	1992-08-05	"Wed"	"Evening"	"787"	7	8	7	22
114	1992-08-04	"Tue"	"Midday"	"044"	0	4	4	8
113	1992-08-03	"Mon"	"Evening"	"963"	9	6	3	18
112	1992-08-02	"Sun"	"Midday"	"939"	9	3	9	21
111	1992-08-01	"Sat"	"Evening"	"468"	4	6	8	18
110	1992-07-31	"Fri"	"Midday"	"131"	1	3	1	5
109	1992-07-30	"Thu"	"Evening"	"042"	0	4	2	6
108	1992-07-29	"Wed"	"Midday"	"196"	1	9	6	16
107	1992-07-28	"Tue"	"Evening"	"175"	1	7	5	13
106	1992-07-27	"Mon"	"Midday"	"466"	4	6	6	16
105	1992-07-26	"Sun"	"Evening"	"466"	4	6	6	16
104	1992-07-25	"Sat"	"Midday"	"633"	6	3	3	12
103	1992-07-24	"Fri"	"Evening"	"985"	9	8	5	22
102	1992-07-23	"Thu"	"Midday"	"192"	1	9	2	12
101	1992-07-22	"Wed"	"Evening"	"044"	0	4	4	8
100	1992-07-21	"Tue"	"Midday"	"788"	7	8	8	23
99	1992-07-20	"Mon"	"Evening"	"614"	6	1	4	11
98	1992-07-19	"Sun"	"Midday"	"003"	0	0	3	3
97	1992-07-18	"Sat"	"Evening"	"617"	6	1	7	14
96	1992-07-17	"Fri"	"Midday"	"425"	4	2	5	11
95	1992-07-16	"Thu"	"Evening"	"391"	3	9	1	13
94	1992-07-15	"Wed"	"Midday"	"835"	8	3	5	16
93	1992-07-14	"Tue"	"Evening"	"746"	7	4	6	17
92	1992-07-13	"Mon"	"Midday"	"869"	8	6	9	23
91	1992-07-12	"Sun"	"Evening"	"177"	1	7	7	15
90	1992-07-11	"Sat"	"Midday"	"948"	9	4	8	21
89	1992-07-10	"Fri"	"Evening"	"468"	4	6	8	18
88	1992-07-09	"Thu"	"Midday"	"805"	8	0	5	13
87	1992-07-08	"Wed"	"Evening"	"064"	0	6	4	10
86	1992-07-07	"Tue"	"Midday"	"205"	2	0	5	7
85	1992-07-06	"Mon"	"Evening"	"811"	8	1	1	10
84	1992-07-05	"Sun"	"Midday"	"416"	4	1	6	11
83	1992-07-04	"Sat"	"Evening"	"093"	0	9	3	12
82	1992-07-03	"Fri"	"Midday"	"579"	5	7	9	21
81	1992-07-02	"Thu"	"Evening"	"585"	5	8	5	18
80	1992-07-01	"Wed"	"Midday"	"542"	5	4	2	11
79	1992-06-30	"Tue"	"Evening"	"112"	1	1	2	4
78	1992-06-29	"Mon"	"Midday"	"100"	1	0	0	1
77	1992-06-28	"Sun"	"Evening"	"468"	4	6	8	18
76	1992-06-27	"Sat"	"Midday"	"871"	8	7	1	16
75	1992-06-26	"Fri"	"Evening"	"196"	1	9	6	16
74	1992-06-25	"Thu"	"Midday"	"235"	2	3	5	10
73	1992-06-24	"Wed"	"Evening"	"734"	7	3	4	14
72	1992-06-23	"Tue"	"Midday"	"526"	5	2	6	13
71	1992-06-22	"Mon"	"Evening"	"574"	5	7	4	16
70	1992-06-21	"Sun"	"Midday"	"489"	4	8	9	21
69	1992-06-20	"Sat"	"Evening"	"874"	8	7	4	19
68	1992-06-19	"Fri"	"Midday"	"503"	5	0	3	8
67	1992-06-18	"Thu"	"Evening"	"238"	2	3	8	13
66	1992-06-17	"Wed"	"Midday"	"622"	6	2	2	10
65	1992-06-16	"Tue"	"Evening"	"961"	9	6	1	16
64	1992-06-15	"Mon"	"Midday"	"673"	6	7	3	16
63	1992-06-14	"Sun"	"Evening"	"218"	2	1	8	11
62	1992-06-13	"Sat"	"Midday"	"361"	3	6	1	10
61	1992-06-12	"Fri"	"Evening"	"303"	3	0	3	6
60	1992-06-11	"Thu"	"Midday"	"932"	9	3	2	14
59	1992-06-10	"Wed"	"Evening"	"875"	8	7	5	20
58	1992-06-09	"Tue"	"Midday"	"714"	7	1	4	12
57	1992-06-08	"Mon"	"Evening"	"843"	8	4	3	15
56	1992-06-07	"Sun"	"Midday"	"068"	0	6	8	14
55	1992-06-06	"Sat"	"Evening"	"599"	5	9	9	23
54	1992-06-05	"Fri"	"Midday"	"251"	2	5	1	8
53	1992-06-04	"Thu"	"Evening"	"936"	9	3	6	18
52	1992-06-03	"Wed"	"Midday"	"238"	2	3	8	13
51	1992-06-02	"Tue"	"Evening"	"089"	0	8	9	17
50	1992-06-01	"Mon"	"Midday"	"266"	2	6	6	14
49	1992-05-31	"Sun"	"Evening"	"429"	4	2	9	15
48	1992-05-30	"Sat"	"Midday"	"633"	6	3	3	12
47	1992-05-29	"Fri"	"Evening"	"260"	2	6	0	8
46	1992-05-28	"Thu"	"Midday"	"461"	4	6	1	11
45	1992-05-27	"Wed"	"Evening"	"516"	5	1	6	12
44	1992-05-26	"Tue"	"Midday"	"009"	0	0	9	9
43	1992-05-25	"Mon"	"Evening"	"857"	8	5	7	20
42	1992-05-24	"Sun"	"Midday"	"843"	8	4	3	15
41	1992-05-23	"Sat"	"Evening"	"469"	4	6	9	19
40	1992-05-22	"Fri"	"Midday"	"776"	7	7	6	20
39	1992-05-21	"Thu"	"Evening"	"341"	3	4	1	8
38	1992-05-20	"Wed"	"Midday"	"666"	6	6	6	18
37	1992-05-19	"Tue"	"Evening"	"525"	5	2	5	12
36	1992-05-18	"Mon"	"Midday"	"276"	2	7	6	15
35	1992-05-17	"Sun"	"Evening"	"871"	8	7	1	16
34	1992-05-16	"Sat"	"Midday"	"982"	9	8	2	19
33	1992-05-15	"Fri"	"Evening"	"461"	4	6	1	11
32	1992-05-14	"Thu"	"Midday"	"499"	4	9	9	22
31	1992-05-13	"Wed"	"Evening"	"979"	9	7	9	25
30	1992-05-12	"Tue"	"Midday"	"576"	5	7	6	18
29	1992-05-11	"Mon"	"Evening"	"077"	0	7	7	14
28	1992-05-10	"Sun"	"Midday"	"892"	8	9	2	19
27	1992-05-09	"Sat"	"Evening"	"096"	0	9	6	15
26	1992-05-08	"Fri"	"Midday"	"457"	4	5	7	16
25	1992-05-07	"Thu"	"Evening"	"582"	5	8	2	15
24	1992-05-06	"Wed"	"Midday"	"525"	5	2	5	12
23	1992-05-05	"Tue"	"Evening"	"803"	8	0	3	11
22	1992-05-04	"Mon"	"Midday"	"563"	5	6	3	14
21	1992-05-03	"Sun"	"Evening"	"052"	0	5	2	7
20	1992-05-02	"Sat"	"Midday"	"224"	2	2	4	8
19	1992-05-01	"Fri"	"Evening"	"859"	8	5	9	22
18	1992-04-30	"Thu"	"Midday"	"811"	8	1	1	10
17	1992-04-29	"Wed"	"Evening"	"430"	4	3	0	7
16	1992-04-28	"Tue"	"Midday"	"628"	6	2	8	16
15	1992-04-27	"Mon"	"Evening"	"247"	2	4	7	13
14	1992-04-26	"Sun"	"Midday"	"798"	7	9	8	24
13	1992-04-25	"Sat"	"Evening"	"257"	2	5	7	14
12	1992-04-24	"Fri"	"Midday"	"936"	9	3	6	18
11	1992-04-23	"Thu"	"Evening"	"900"	9	0	0	9
10	1992-04-22	"Wed"	"Midday"	"573"	5	7	3	15
9	1992-04-21	"Tue"	"Evening"	"960"	9	6	0	15
8	1992-04-20	"Mon"	"Midday"	"008"	0	0	8	8
7	1992-04-19	"Sun"	"Evening"	"763"	7	6	3	16
6	1992-04-18	"Sat"	"Midday"	"788"	7	8	8	23
5	1992-04-17	"Fri"	"Evening"	"091"	0	9	1	10
4	1992-04-16	"Thu"	"Midday"	"067"	0	6	7	13
3	1992-04-15	"Wed"	"Evening"	"074"	0	7	4	11
2	1992-04-14	"Tue"	"Midday"	"809"	8	0	9	17
1	1992-04-13	"Mon"	"Evening"	"195"	1	9	5	15
